FileName,ESV_corrected,ESC_corrected_frame,EDV_corrected,EDV_corrected_frame,PixelDifference,TotalFrames
0X100009310A3BD7FC.avi,854,61,1744,46,890,2
0X1002E8FBACD08477.avi,960,18,1593,3,633,2
0X1005D03EED19C65B.avi,728,35,1166,24,438,2
0X10075961BC11C88E.avi,997,108,1445,91,448,2
0X10094BA0A028EAC3.avi,2077,156,2514,137,437,2
0X100CF05D141FF143.avi,1117,148,1719,132,602,2
0X100E3B8D3280BEC5.avi,1273,38,1657,25,384,2
0X100E491B3CD58DE2.avi,1403,75,1739,49,336,2
0X100F044876B98F90.avi,972,72,1622,56,650,2
0X101026B90DAE7E95.avi,1589,62,2180,45,591,2
0X1012703CDC1436FE.avi,2092,172,2765,154,673,2
0X1013E8A4864781B.avi,520,46,828,35,308,2
0X1018521A3BC5CDBA.avi,1021,57,1583,42,562,2
0X101C388397F66EDB.avi,1373,62,2272,46,899,2
0X101CFC9C5351DCBE.avi,1415,73,2107,59,692,2
0X101E654AF3FC07A8.avi,641,132,1088,109,447,2
0X10267ADF2E644E0.avi,902,172,1566,150,664,2
0X102AE9C68B2C46DA.avi,895,63,1222,48,327,2
0X102C51641C321436.avi,1471,15,2149,0,678,2
0X102CFB07F752AAE6.avi,1369,184,1926,163,557,2
0X102DD1B9BE03716.avi,1552,71,2316,52,764,2
0X102E453603FA1440.avi,1332,60,2433,46,1101,2
0X102E94908346DE1D.avi,1069,138,1421,116,352,2
0X102F3D4CD5E10801.avi,1414,22,2042,0,628,2
0X10365E52F01510B4.avi,1242,36,1929,28,687,2
0X1039108E17193B1C.avi,1558,79,2426,60,868,2
0X1039B49145DF4F25.avi,875,57,1318,40,443,2
0X103A55B2546EF36E.avi,1305,186,1967,166,662,2
0X103BE163257D663A.avi,918,69,1330,47,412,2
0X1040C376CF369A01.avi,806,64,1303,52,497,2
0X1040D64234D3E916.avi,1148,108,1919,90,771,2
0X1043D3D352972862.avi,1154,113,1584,91,430,2
0X1045F1B5A0A5EA54.avi,1036,73,1399,57,363,2
0X104D2C3D60AE3DE8.avi,1903,163,3391,145,1488,2
0X105039B849CDB1CD.avi,1197,73,1951,55,754,2
0X10516E63208D8EA1.avi,1279,66,1944,51,665,2
0X1055D6B76E5D7556.avi,818,90,1206,75,388,2
0X10569E00E4DFFF7D.avi,609,53,1261,36,652,2
0X1059077339EF0869.avi,1122,116,1863,90,741,2
0X105B9EF57DE45DCB.avi,1747,121,2411,106,664,2
0X105CDF495F9A9A43.avi,1219,89,1826,71,607,2
0X105D400DBDB7A1FA.avi,1456,96,2303,78,847,2
0X105E0E36E611D657.avi,1708,86,2375,69,667,2
0X10623D3AF96AC271.avi,1905,52,3868,34,1963,2
0X1062E316DF137FDB.avi,768,140,1327,123,559,2
0X10648BFB1458861.avi,1585,39,2164,30,579,2
0X106766224781FAE2.avi,1036,65,1579,47,543,2
0X106A8FDB8A83534B.avi,1012,72,1681,60,669,2
0X106B384BEED608E3.avi,1123,83,1980,68,857,2
0X106E73F4961CC47B.avi,992,104,1581,88,589,2
0X106EA7D9DEC59EA9.avi,1332,110,1887,96,555,2
0X106FE6CF624D4C8C.avi,1331,74,2056,55,725,2
0X1070ABA581A9A255.avi,1008,58,1533,41,525,2
0X107458C8895A9AC9.avi,905,110,1350,96,445,2
0X1082BF2A3762D881.avi,1490,67,1913,44,423,2
0X1088B755BC61AF23.avi,768,52,1396,42,628,2
0X108B163EEADDDABC.avi,1150,55,1759,40,609,2
0X108B4B26B48E417B.avi,889,76,1228,65,339,2
0X1093398DC18FB3B3.avi,1808,75,3160,53,1352,2
0X1096572D64654BBD.avi,809,93,1139,76,330,2
0X1098A9CCA66A5DD0.avi,1125,53,1650,38,525,2
0X109D27B0A540F9F6.avi,974,64,1470,51,496,2
0X10A28877E97DF540.avi,1327,87,2242,69,915,2
0X10A5FC19152B50A5.avi,1355,125,2327,112,972,2
0X10A8ADB48536C3D5.avi,1939,97,2178,88,239,2
0X10A9B17E26220232.avi,950,80,1591,61,641,2
0X10ABB3401FC5EC2D.avi,1119,71,1932,51,813,2
0X10AD385C206C85C.avi,946,145,1196,133,250,2
0X10B04432B90E5AC2.avi,1120,83,1692,66,572,2
0X10B063E16BA7BEE3.avi,1767,107,2153,96,386,2
0X10B13E581B12A53C.avi,799,53,1225,39,426,2
0X10B7505562B0A702.avi,1183,77,1784,61,601,2
0X10BC6AA53115AA06.avi,1516,61,2282,42,766,2
0X10BD75A3203C3BB9.avi,1185,66,1778,50,593,2
0X10BDFD27E27D56A9.avi,1048,20,1570,1,522,2
0X10BFDDD409BA5A7A.avi,1066,57,1735,43,669,2
0X10C2D4AA0721C0FB.avi,1200,166,1984,149,784,2
0X10C3E084B3ABE52A.avi,1109,20,1722,4,613,2
0X10C4823DD13E1869.avi,1969,67,3039,49,1070,2
0X10C53B6D1D01A54A.avi,1735,112,2877,91,1142,2
0X10CA19FBE6D26A71.avi,1227,70,2011,53,784,2
0X10D11D93FB71B19C.avi,1497,118,2524,103,1027,2
0X10D1B5DDEBC0E3C8.avi,1204,41,1740,31,536,2
0X10D278E3FD2DE072.avi,1100,99,1920,82,820,2
0X10D5F8CF0EB124.avi,1628,132,1878,110,250,2
0X10D734CBEB6ECB81.avi,1001,13,1267,5,266,2
0X10D8F5659B144070.avi,869,71,1178,57,309,2
0X10DEF75CF6DC6B84.avi,1276,134,1913,116,637,2
0X10E197789006C3D5.avi,1115,126,1886,111,771,2
0X10E47D630E15DE12.avi,2279,108,2833,87,554,2
0X10E57E24DBA5788.avi,2040,61,2392,45,352,2
0X10E60C3C123CAEB8.avi,919,85,1484,58,565,2
0X10EFC1D17C7FB199.avi,837,195,1212,179,375,2
0X10F04F8DFB86BAEE.avi,1521,62,2014,43,493,2
0X10F6FD4A9C6A458E.avi,1560,66,2785,46,1225,2
0X10FCACE551DE0CEB.avi,872,68,1534,50,662,2
0X11000DD0D10B399F.avi,1025,71,1599,57,574,2
0X1100A0AA0BDBAE92.avi,976,68,1427,49,451,2
0X1106795368C7DE44.avi,1534,49,2447,38,913,2
0X1108EED6EC60971E.avi,1087,70,1789,51,702,2
0X110A2E1C465B1B53.avi,1092,119,1754,103,662,2
0X11109B2A42A4C76E.avi,1835,135,2563,123,728,2
0X11116A740B44446A.avi,1340,112,1994,94,654,2
0X1112442D58D48C79.avi,1431,72,2423,61,992,2
0X11199500C4901088.avi,1174,19,1600,3,426,2
0X111D3734D84AA8B8.avi,1208,125,1885,109,677,2
0X111E2E3AD9EB4317.avi,1612,19,2758,4,1146,2
0X111EDA8A1E44169C.avi,966,110,1446,97,480,2
0X1123724D7C9FAF61.avi,900,59,1343,42,443,2
0X1124D3D938A98B7B.avi,1177,72,1838,58,661,2
0X112505A983BB4D8E.avi,764,114,1214,101,450,2
0X112668E4C7655E1A.avi,749,93,1125,76,376,2
0X112862331B7E140E.avi,1674,58,3013,37,1339,2
0X1128628F2CE14FF4.avi,1143,108,1424,87,281,2
0X1129FFF0D45D7EFF.avi,2006,69,3306,53,1300,2
0X112B93363FA20D8B.avi,1146,49,1571,31,425,2
0X112D0A3D2ACB8800.avi,1672,149,2774,128,1102,2
0X112E05F05062753E.avi,1508,64,2228,44,720,2
0X112EF236E1F676E4.avi,1669,87,2609,64,940,2
0X112F1A9C7DF4A5F2.avi,1560,146,2547,121,987,2
0X11303E45952732BD.avi,1319,113,1928,88,609,2
0X113195610E41EF2.avi,1112,70,1702,54,590,2
0X1131FB2A374D34F5.avi,1051,86,1531,59,480,2
0X1134CC5B50757EEF.avi,1498,78,2161,64,663,2
0X113E6AD75AB62781.avi,1040,133,1397,121,357,2
0X113E9F83E605C0F5.avi,928,59,1438,50,510,2
0X113F9B4D1F9FA03.avi,1355,75,2041,56,686,2
0X1143688D7F946644.avi,1402,67,2326,53,924,2
0X11445CEF92745462.avi,716,66,1143,51,427,2
0X114B58E6B34E55F1.avi,1243,92,1576,81,333,2
0X114DED900F0C2D7D.avi,2356,72,2803,61,447,2
0X1150BD0249677E8F.avi,979,63,1591,43,612,2
0X1151059A7824211.avi,991,72,1580,51,589,2
0X1151F27F45E9644F.avi,603,202,1091,185,488,2
0X11537FCF989575BB.avi,3261,71,5201,51,1940,2
0X1154F8CD483D5CD5.avi,1601,100,2373,78,772,2
0X115841DA5E9DC64D.avi,1167,49,1765,34,598,2
0X1161B02E0B2DBB94.avi,932,18,1582,1,650,2
0X11648EA1AD4AE177.avi,520,55,967,38,447,2
0X1167650B8BEFF863.avi,827,123,1387,111,560,2
0X11679CCF8428C87.avi,2054,56,2404,40,350,2
0X116D6A1EFDD8E226.avi,932,56,1423,40,491,2
0X11751D404DAD3313.avi,2225,117,3034,96,809,2
0X117CAE6A13AA3F5.avi,1036,132,1660,115,624,2
0X117F243A9D657663.avi,1157,111,1698,97,541,2
0X117FFBEE3018EEF.avi,1135,47,1427,37,292,2
0X1185DA5AB0D9BE6A.avi,980,66,1391,54,411,2
0X11861625D2695B1F.avi,1251,61,2228,47,977,2
0X118EF5AEED2E28EC.avi,1451,48,2171,33,720,2
0X119154A48FDF0A82.avi,1034,77,1542,55,508,2
0X1192B98E520E87C8.avi,861,102,1298,75,437,2
0X119C98019EFAA0F4.avi,1084,69,1897,48,813,2
0X11A07A83B21CFE1E.avi,1137,111,1880,96,743,2
0X11A3165A8DC20F2D.avi,933,85,1253,72,320,2
0X11A3EC0D91F0CD3B.avi,1057,55,1700,42,643,2
0X11B01A59D74693C4.avi,1384,21,1998,2,614,2
0X11B7D2EE96990A8D.avi,1127,54,1669,35,542,2
0X11BACBBF79E25D1E.avi,1147,34,1747,25,600,2
0X11BC6C9DEA4C94C7.avi,1138,170,1771,156,633,2
0X11BDF610427B903F.avi,1265,58,1863,42,598,2
0X11BE656DE80C9CF2.avi,1199,97,1877,75,678,2
0X11C1412786BCBB50.avi,1441,85,1706,68,265,2
0X11C5F414FDFFA6FE.avi,746,27,1447,18,701,2
0X11C89001BEF939E2.avi,1742,78,2305,65,563,2
0X11C9572ABEDC9715.avi,1301,101,1920,86,619,2
0X11CC3D00A37FE7DF.avi,1152,148,1677,137,525,2
0X11D525180CDD1ECD.avi,964,59,1212,41,248,2
0X11D53502D38B208F.avi,775,69,1258,59,483,2
0X11DA79F89EE37D3B.avi,800,89,1367,76,567,2
0X11DD5C8CC2A4D225.avi,2274,52,3876,37,1602,2
0X11DF3DEE0B2544FE.avi,1401,110,1864,93,463,2
0X11E0A9338456F4AA.avi,990,155,1457,143,467,2
0X11E371F35DEBE8B4.avi,1023,67,1610,49,587,2
0X11E3FA2DD4ADD675.avi,2033,54,2397,40,364,2
0X11F088FA228B2BE8.avi,1263,75,1940,56,677,2
0X11F7628563B5B391.avi,1367,129,2141,114,774,2
0X11F798A4F0181ACF.avi,875,77,1523,59,648,2
0X12006C9A54BEED76.avi,1050,48,1696,34,646,2
0X1205884E675E58B9.avi,834,70,1416,57,582,2
0X120CAF5F957C906C.avi,1357,64,1825,42,468,2
0X120E33CFA2D0FF00.avi,1289,126,2061,108,772,2
0X1210DA53C9475EBF.avi,1916,166,2892,151,976,2
0X1212FB5C4E7021B8.avi,1847,55,2634,39,787,2
0X12143BF23189A122.avi,961,61,1532,47,571,2
0X12185F79407DF986.avi,1413,67,1971,51,558,2
0X121968806D66B71F.avi,842,50,1345,38,503,2
0X1219DA80A35E3B5F.avi,1779,84,2994,67,1215,2
0X121ED339D11C4F6B.avi,962,74,1601,62,639,2
0X1220B4C71FD9D82.avi,800,14,1521,1,721,2
0X1222EAE9D581E210.avi,1342,57,2343,35,1001,2
0X1225C19111629C6F.avi,1309,105,2162,89,853,2
0X1227CDDF6A114129.avi,661,66,1410,51,749,2
0X123B2FFEBC042304.avi,1210,118,2073,101,863,2
0X123BE57301362DA4.avi,1110,49,1692,38,582,2
0X123D5FE0A5DC7E1D.avi,1011,52,1465,35,454,2
0X123F96492CB893D6.avi,1652,87,2416,72,764,2
0X124030F8B3C1A5AF.avi,1087,22,1686,42,599,2
0X12430512E2BBCD55.avi,577,50,859,38,282,2
0X124823D11EF8E321.avi,1882,88,3019,72,1137,2
0X12508E9DD1BA59B5.avi,930,107,1691,89,761,2
0X125C10BA973D3B07.avi,1775,59,2059,41,284,2
0X12628F033A56EB6F.avi,1025,16,1683,2,658,2
0X1262A9E08289B606.avi,1378,73,2391,58,1013,2
0X1264B4000299A44A.avi,829,14,1350,3,521,2
0X126C02C8B984672B.avi,1372,92,2336,74,964,2
0X126D2362E5A0A3E2.avi,1062,100,1677,86,615,2
0X12743BE18328C2CB.avi,992,143,1544,126,552,2
0X12746954583128D.avi,920,142,1563,126,643,2
0X1274EA614B0388C1.avi,1379,16,1565,0,186,2
0X1276054526651444.avi,2137,65,2951,49,814,2
0X127779E8265AE7DF.avi,2722,172,3911,150,1189,2
0X127A2C51D192532D.avi,1170,59,1724,42,554,2
0X127D3AEEA73EDE76.avi,887,73,1447,64,560,2
0X127F452F06A3EE97.avi,991,109,1400,91,409,2
0X12807854DFA9CC01.avi,976,54,1517,40,541,2
0X128786C169B3ADAE.avi,1080,16,1888,0,808,2
0X128C3C2C3A7496CB.avi,1506,75,1741,62,235,2
0X129133A90A61A59D.avi,2564,84,2973,66,409,2
0X129682A2ECCD415.avi,601,42,1072,33,471,2
0X1297B85A51C2B20A.avi,1141,65,1817,49,676,2
0X129C303CC617D208.avi,2552,63,3035,42,483,2
0X129CDFF3A684DDB9.avi,1613,54,1952,38,339,2
0X129ED481CEECBD9.avi,1297,67,2006,49,709,2
0X12A72A2C6FF4C400.avi,985,92,1602,72,617,2
0X12AD71F42865D2A.avi,2043,128,2681,108,638,2
0X12B41FA5409312FE.avi,1407,179,2084,151,677,2
0X12B468050091669.avi,1272,72,1932,53,660,2
0X12B70D2902C13E73.avi,1568,82,2619,55,1051,2
0X12B79C738400F3.avi,1290,61,2327,47,1037,2
0X12B890B1E2E14CC4.avi,2097,17,3394,1,1297,2
0X12B9FFDEA456E877.avi,988,63,1546,46,558,2
0X12BAD5FBFC3E4F2A.avi,1124,114,1729,97,605,2
0X12C17194EECA74B4.avi,1373,43,2106,31,733,2
0X12C75A801CBD284A.avi,1357,78,2012,67,655,2
0X12CC84ACC62427C1.avi,1474,49,2328,37,854,2
0X12CF33089E2618A8.avi,846,63,1274,31,428,2
0X12D510DA18959EE3.avi,936,80,1341,67,405,2
0X12D56DAF10A98037.avi,840,55,1411,37,571,2
0X12D7CFBEBDF0EAAF.avi,831,53,1328,38,497,2
0X12DAF7D942F818A0.avi,1502,123,2409,102,907,2
0X12DC39D816351E0D.avi,1132,66,1527,57,395,2
0X12F2890C7AEA52E8.avi,1131,39,1517,23,386,2
0X12F3277B0A6EE866.avi,597,172,999,154,402,2
0X12F3CF2F58EC699B.avi,1024,147,1612,133,588,2
0X12F535C804FC3F13.avi,945,155,1511,141,566,2
0X13031FC2687E954D.avi,1835,25,3140,3,1305,2
0X1303B567B01D9D71.avi,932,120,1485,107,553,2
0X13078849A6B5C581.avi,1131,20,1772,0,641,2
0X130914FFD198255E.avi,1273,139,2091,120,818,2
0X130ABC17C55FD6B5.avi,1316,59,2055,46,739,2
0X130B57359B0E6F00.avi,1088,173,1765,157,677,2
0X130E96B8AB4EC4DF.avi,935,21,1658,3,723,2
0X131AEF344C28F4B2.avi,1023,143,1644,122,621,2
0X131EE16CE9512E4E.avi,1245,85,2023,131,778,2
0X132A335840604190.avi,1363,63,2177,44,814,2
0X132C1E8DBB715D1D.avi,676,55,1035,44,359,2
0X132E461F48559F6B.avi,1050,89,1886,72,836,2
0X1335F88662E38FD5.avi,2141,113,3300,97,1159,2
0X1337E8945A141439.avi,1737,87,2407,73,670,2
0X13381981E598316E.avi,1478,132,2437,116,959,2
0X1339B9E81946F0E8.avi,883,82,1485,61,602,2
0X133BD3C195F9EA2.avi,1610,65,2584,46,974,2
0X133C22A8F4C643C.avi,1495,141,1861,129,366,2
0X133F1774D5859CF4.avi,714,150,1201,134,487,2
0X133F50BB99C6E09.avi,1043,55,1567,42,524,2
0X13408BBC062D7EF8.avi,1512,85,2412,79,900,2
0X13419AC126FD7685.avi,1390,50,2385,32,995,2
0X1345D6698FB8834D.avi,2690,86,4073,65,1383,2
0X13491A03D3184C5A.avi,1683,75,2224,57,541,2
0X134A337D9B4C1948.avi,1658,57,1942,45,284,2
0X134CE85850028C74.avi,1250,110,2107,92,857,2
0X1351FD090B93589F.avi,938,45,1482,29,544,2
0X135A31260870D960.avi,997,162,1697,144,700,2
0X135AADB11C76E482.avi,1086,99,1909,86,823,2
0X13621A689D1114C3.avi,1132,81,1913,65,781,2
0X1364306109381555.avi,1779,78,1960,57,181,2
0X136492E67BFF8CB3.avi,2778,112,4503,95,1725,2
0X136601DC3725F327.avi,988,112,1517,95,529,2
0X1366FB9F3F37807D.avi,1036,114,1544,103,508,2
0X13682394806BB587.avi,1794,55,2784,40,990,2
0X1369E49954F0EAEC.avi,1329,62,1941,46,612,2
0X13745EE94756A394.avi,1109,113,1744,97,635,2
0X13881965FA7312E.avi,729,105,1045,93,316,2
0X13888ED03221D0D4.avi,1015,139,1513,126,498,2
0X138BF0FABD298C5.avi,1450,194,2196,175,746,2
0X1390B905E366F035.avi,1047,50,1438,35,391,2
0X139DEEAD6326D6C5.avi,1065,62,1738,47,673,2
0X13A3E602CCA508D6.avi,994,151,1516,127,522,2
0X13A4AE3152A4D752.avi,1484,76,2058,64,574,2
0X13A5B3EF1C1004FC.avi,2199,53,3917,38,1718,2
0X13A5F88444B588E0.avi,551,49,743,37,192,2
0X13ACF1360A23F50F.avi,1214,56,2045,40,831,2
0X13AF8C4530219270.avi,1618,19,2582,2,964,2
0X13B0A1DABEDA5EDF.avi,1176,73,1970,60,794,2
0X13B4430D1930FF80.avi,1235,65,1939,49,704,2
0X13B5EC7F42AF217.avi,1078,131,1653,119,575,2
0X13B783ADFB252C8.avi,670,62,1060,81,390,2
0X13B8F91C9C8074AF.avi,1078,19,1566,0,488,2
0X13B98D39BC103032.avi,1153,83,1946,68,793,2
0X13BD3AC66BD12220.avi,1000,53,1605,37,605,2
0X13BF1C6E527440F.avi,1310,72,2034,58,724,2
0X13BF81440466675F.avi,1227,113,1940,96,713,2
0X13C061D2FD255419.avi,2313,65,2951,48,638,2
0X13C1FEB745C8B810.avi,1552,21,3325,0,1773,2
0X13C378D617ABCBEF.avi,918,53,1413,35,495,2
0X13C611744D86E729.avi,1677,66,2238,51,561,2
0X13C7281794656150.avi,1209,70,2187,52,978,2
0X13CAF66BDD4EBEA0.avi,919,101,1217,87,298,2
0X13CE2039E2D706A.avi,2129,76,2445,56,316,2
0X13CE28139B5F8E2D.avi,1386,71,2091,53,705,2
0X13CF32153B3B30B7.avi,1318,115,2035,101,717,2
0X13CFD73EA4694798.avi,3197,59,3519,41,322,2
0X13D0DD096DFED1C7.avi,950,69,1432,51,482,2
0X13D1459C51B5C32E.avi,1101,25,1338,43,237,2
0X13D6BC74D088CACA.avi,1505,80,2282,70,777,2
0X13D875B7A4A97001.avi,1524,21,2431,0,907,2
0X13D9B0A4BC16701D.avi,699,84,1152,70,453,2
0X13DEAEAFDF1338AD.avi,764,122,1126,111,362,2
0X13E043A35E3EB490.avi,994,97,1503,80,509,2
0X13E260DF39629AC9.avi,1232,161,1646,143,414,2
0X13E488CF5C7C934C.avi,961,35,1450,23,489,2
0X13E9B31F9C5D5660.avi,1313,146,2083,129,770,2
0X13EA5DE4962B3822.avi,2497,198,3890,162,1393,2
0X13ECF4B877219D8B.avi,986,16,1629,1,643,2
0X13EFD6BF683801F.avi,971,106,1246,91,275,2
0X13F04450E6B7D249.avi,1716,56,2576,39,860,2
0X13F0F314138CE831.avi,703,168,999,150,296,2
0X13F52A775D9F62D0.avi,1516,79,2018,66,502,2
0X13F7CAB4C719ACA3.avi,1135,17,1520,6,385,2
0X14017B26554F7A5E.avi,940,116,1714,101,774,2
0X140A0F27BE9116F5.avi,1308,91,1786,74,478,2
0X140AAFB14918E8A4.avi,1362,47,2278,38,916,2
0X140D4A2F475712FA.avi,1225,66,1938,49,713,2
0X141103C96A34DA6C.avi,2128,237,3293,212,1165,2
0X1412F3A856C40C82.avi,1074,39,1839,28,765,2
0X141E714781DEE463.avi,2313,48,3352,35,1039,2
0X142C9C144BF16FAE.avi,1212,142,1869,123,657,2
0X142CA9754A01C189.avi,1128,111,1617,95,489,2
0X142D95A439C28FD0.avi,879,127,1370,114,491,2
0X142EFADA9AF9DC99.avi,1167,177,1861,157,694,2
0X1430480BD524AA15.avi,759,148,1261,114,502,2
0X143952B6F3131E88.avi,752,41,1213,28,461,2
0X1439627ADB475793.avi,1609,152,2696,136,1087,2
0X143B72A804BC7AE7.avi,761,57,1239,40,478,2
0X143D9B52A85BF561.avi,1373,111,2076,91,703,2
0X143DC0C8FB089A18.avi,2590,19,3043,0,453,2
0X1441AEEF1315F95F.avi,1014,22,1793,3,779,2
0X1444E316F0AD1ECD.avi,1691,132,2531,114,840,2
0X14458B9410D73E11.avi,988,17,1563,2,575,2
0X144DF7C585233D4C.avi,1599,66,2347,51,748,2
0X1453F1CB3615D8E6.avi,1579,60,2368,46,789,2
0X14586BA47B83C598.avi,1352,106,2268,86,916,2
0X145985C5A34EFCC.avi,1008,141,1710,124,702,2
0X1459E82A63876D49.avi,1718,140,2901,122,1183,2
0X146617301504663D.avi,929,188,1552,165,623,2
0X1469FC68080F968F.avi,988,53,1734,39,746,2
0X146DFEE92CCEC4E2.avi,1038,100,1727,86,689,2
0X146FA81A1880E0DB.avi,1243,56,2072,39,829,2
0X148536C2B06F8C88.avi,1002,20,1519,3,517,2
0X148B59B7E2DE8071.avi,2041,150,3354,131,1313,2
0X148BFBF596042FF5.avi,759,214,1136,196,377,2
0X148FD32A15B26865.avi,1717,122,2406,105,689,2
0X148FFCBF4D0C398F.avi,1208,150,2062,128,854,2
0X1494CF8E521C3FEF.avi,1570,107,1948,92,378,2
0X1498806542CEE367.avi,1203,27,1683,15,480,2
0X1499CC196E57EFB.avi,1016,152,1657,136,641,2
0X149C551B9CC4DED.avi,758,127,1308,116,550,2
0X149CE42387608CEC.avi,933,121,1340,106,407,2
0X149D7652015AA236.avi,1008,93,1545,78,537,2
0X149DCE7F77B408F4.avi,845,72,1337,54,492,2
0X14A6F87817547A95.avi,961,49,1736,36,775,2
0X14A943AC8D162D36.avi,1987,100,3092,82,1105,2
0X14A96DC7D16968CA.avi,1123,55,1905,41,782,2
0X14AD611ACCAD1161.avi,1038,48,1689,33,651,2
0X14AE436F61819521.avi,1403,49,2029,33,626,2
0X14B62F1593336331.avi,773,124,1236,105,463,2
0X14B9AD04DC394090.avi,1422,143,2217,118,795,2
0X14BF7A33B6A3FAC4.avi,715,40,1086,27,371,2
0X14BFDFE46468D601.avi,1403,175,1954,157,551,2
0X14C05BE120AEAFA3.avi,944,66,1712,47,768,2
0X14C5B3A3DFECAC76.avi,1290,127,2028,109,738,2
0X14C8F7E6EBDBC708.avi,1050,123,1994,104,944,2
0X14C8FE5C30084CB3.avi,887,122,1451,106,564,2
0X14C9558E01709E65.avi,1490,64,2431,49,941,2
0X14CA2B7814B1B9EF.avi,1037,97,1587,81,550,2
0X14CDF03D85703540.avi,2455,176,3790,138,1335,2
0X14CFCEAD6539D3DC.avi,1169,125,1916,111,747,2
0X14D50036EAB69EA.avi,1096,82,1642,71,546,2
0X14D6CCAC550E278B.avi,552,151,982,134,430,2
0X14DDD7911ED612B8.avi,847,197,1238,180,391,2
0X14E954E2A0878925.avi,1202,43,1554,30,352,2
0X14E98112C64DA88B.avi,2225,118,2644,100,419,2
0X14EAF6EAE837F32D.avi,580,94,918,84,338,2
0X14F0C15097590562.avi,867,71,1367,52,500,2
0X14F4B815A5210B8A.avi,806,54,1343,39,537,2
0X14F639B3E0EC3A72.avi,1102,83,1827,64,725,2
0X14F7F25545E76A73.avi,1040,65,1613,46,573,2
0X14FC5096F3E4145D.avi,1163,67,1974,49,811,2
0X14FC7EEB6ACFE0BF.avi,1354,69,1893,46,539,2
0X1502E38D5D99E2E4.avi,734,68,1005,51,271,2
0X15031D084B3EEC96.avi,615,83,1040,69,425,2
0X150D2E5A2E09ADC.avi,1202,12,1461,1,259,2
0X1512DC6CBD8EA12A.avi,1254,56,1414,44,160,2
0X15146FB55B5697A0.avi,1779,88,2500,69,721,2
0X15213080EC9FA05.avi,927,70,1374,53,447,2
0X15260A2D31648922.avi,1336,64,2049,47,713,2
0X152F36A552DD2930.avi,867,119,1368,106,501,2
0X152F4B797A15C43F.avi,2564,99,3131,85,567,2
0X1531B80C56297FD2.avi,988,129,1517,110,529,2
0X153A76426320A57B.avi,1729,113,1936,98,207,2
0X153F6AD036CBC30B.avi,2142,51,2340,32,198,2
0X1545ED054E5CE01D.avi,1384,56,2376,42,992,2
0X154827D058D6A9D0.avi,808,179,1371,158,563,2
0X154A3BABDF5193B6.avi,1393,76,2119,55,726,2
0X154B75E4EF6184AE.avi,1040,17,1478,2,438,2
0X15505C1D0357A434.avi,3150,307,3715,272,565,2
0X1556825C5295368F.avi,981,100,1657,86,676,2
0X155A7771ACB14472.avi,1495,79,2268,62,773,2
0X155E07DE20CF09F5.avi,1009,72,1983,54,974,2
0X1563E9D9834E5A52.avi,1418,121,1892,100,474,2
0X1564DE8D0D40F195.avi,1180,62,1829,45,649,2
0X15672D90E3EC7303.avi,1162,130,1779,112,617,2
0X156A170A2372A74D.avi,1030,53,1797,36,767,2
0X156B1DF0112EDD64.avi,1963,75,3036,55,1073,2
0X156F3A66548E593A.avi,905,159,1612,143,707,2
0X1572A0615437CE09.avi,808,69,1330,60,522,2
0X157528EBA14B2EB6.avi,1236,58,1916,42,680,2
0X1578E7D18F51EBBA.avi,1370,18,2336,51,966,2
0X157AC89BC2BB953E.avi,1670,65,1890,47,220,2
0X157BF8C4D154D45D.avi,1370,92,1633,63,263,2
0X158518565B5C46D8.avi,1117,79,1777,61,660,2
0X15861B0853DB6E4D.avi,1099,189,1788,168,689,2
0X158B03C45BB55DAC.avi,1838,98,3112,81,1274,2
0X158C469B8C462A10.avi,2793,61,3573,46,780,2
0X1592A79667250EA1.avi,1262,67,2102,49,840,2
0X159307C65686B64D.avi,1133,141,1710,128,577,2
0X1597DA4581B6F4AD.avi,827,63,1445,39,618,2
0X1599E3BC17BB6A01.avi,995,50,1749,36,754,2
0X159BDA520C61736A.avi,742,62,1193,43,451,2
0X15A62E3A92DFFF7.avi,1566,60,2422,44,856,2
0X15A89931D5E83C23.avi,1097,182,1319,163,222,2
0X15A912A3822431A9.avi,1574,15,2504,1,930,2
0X15AA1BAFC9C0CCB2.avi,2174,94,2705,68,531,2
0X15ACD275B96CDD05.avi,1243,79,2142,59,899,2
0X15B26FE0D3CD6E0F.avi,1217,93,1834,68,617,2
0X15B2A840A070DCC9.avi,1024,67,1555,48,531,2
0X15B6905E8EC410FA.avi,2675,103,3223,88,548,2
0X15B980AC8A6B5EF1.avi,1168,52,1868,36,700,2
0X15BA82A1F6BF8B6.avi,1707,114,2637,100,930,2
0X15BE180F1CCF0F3B.avi,859,52,1336,39,477,2
0X15C0D7DBFF8E4FC8.avi,1276,67,1608,48,332,2
0X15C4831F7DDCA462.avi,1249,19,2019,3,770,2
0X15C85161F8F9A55B.avi,851,18,1316,3,465,2
0X15C904A855E4FF2B.avi,1425,62,2408,45,983,2
0X15CBECA136CF18CD.avi,950,75,1312,55,362,2
0X15CC2CDE8C2CD542.avi,1194,80,1769,66,575,2
0X15CC6C50F1763B61.avi,1761,60,2495,41,734,2
0X15D24A43FD766AB9.avi,1017,75,1700,58,683,2
0X15D27BEDBDC09AA0.avi,1637,64,2040,46,403,2
0X15D82D31755657.avi,995,70,1604,57,609,2
0X15D8B127660F649C.avi,897,54,1417,42,520,2
0X15D9F9EC9BA764E7.avi,1714,104,3088,93,1374,2
0X15DA8D60960ABB2B.avi,1274,71,1773,53,499,2
0X15DC7EFD8DB3D0A6.avi,1129,53,1362,38,233,2
0X15DF6B9DA16DAD07.avi,1184,58,1900,42,716,2
0X15E22119724FDD7D.avi,973,111,1756,95,783,2
0X15E8BE2AE8C05C88.avi,2293,72,3193,52,900,2
0X15E987778BEC99D5.avi,1376,130,2125,113,749,2
0X15E9928F7242538E.avi,1576,62,2553,42,977,2
0X15F1317B1354152B.avi,1002,64,1623,49,621,2
0X15F216DB6201C0F.avi,851,105,1413,86,562,2
0X15FFEB32E5D2ECF2.avi,931,43,1342,32,411,2
0X1603C982E33D045E.avi,841,51,1353,36,512,2
0X160563B6A541752C.avi,860,97,1325,86,465,2
0X160C233C08E7E8DE.avi,1519,64,2467,49,948,2
0X160DBDFED541D2D9.avi,1515,72,2094,61,579,2
0X160E1BD0E636CC69.avi,1813,63,2461,46,648,2
0X160FFE14D950D4C0.avi,1434,61,2350,43,916,2
0X1611B3A479A63A01.avi,1427,84,2232,65,805,2
0X16134D6B554889A.avi,1809,62,2987,40,1178,2
0X16139FAA2B68E8FD.avi,1097,66,1715,50,618,2
0X16148C355E993321.avi,1933,83,2250,67,317,2
0X1616791A7190BBA0.avi,1867,59,2623,42,756,2
0X1619E4697D8673B4.avi,1255,64,1814,42,559,2
0X1622EDE923576CF4.avi,1135,81,1765,67,630,2
0X1623BBE488F0EC89.avi,1351,64,1901,47,550,2
0X162DC693CC98C01F.avi,1533,88,2039,73,506,2
0X1631C52C25D15DEE.avi,1432,17,1988,1,556,2
0X163A374094D066E8.avi,1526,112,2616,143,1090,2
0X163D02E41A3A93D.avi,989,47,1108,40,119,2
0X163EBCB6784FC30B.avi,1162,58,1796,41,634,2
0X163FFB185E479D0C.avi,1786,101,2888,88,1102,2
0X164D9C71CC801B34.avi,1771,60,2167,40,396,2
0X164E6F5DA8503204.avi,1192,66,1744,47,552,2
0X1653CEFBC9986D9F.avi,844,74,1293,60,449,2
0X1655D3F044EB6BB2.avi,668,206,1050,195,382,2
0X1655F3F4D2943C1D.avi,856,76,1280,58,424,2
0X16562EC4F3B6646B.avi,1042,94,1605,82,563,2
0X1659FD6165A50811.avi,1004,64,1582,46,578,2
0X165D339CF0773DFD.avi,968,53,1359,41,391,2
0X165EC58045A8A8BF.avi,1170,84,1876,66,706,2
0X166087A5E749713A.avi,1184,132,1500,119,316,2
0X166A033F6DC02086.avi,778,96,1069,77,291,2
0X166B0D5A9407635F.avi,1416,62,2189,44,773,2
0X166B717BBC2ECADA.avi,864,88,1210,78,346,2
0X166BF85033848E4E.avi,1649,46,1759,33,110,2
0X166F42C7B9DD12C.avi,1263,74,2118,59,855,2
0X1674C7C6F8A8B313.avi,1466,26,2375,3,909,2
0X16763AF254837506.avi,1177,109,1792,90,615,2
0X16765E1EDC5E93BE.avi,1343,93,1640,78,297,2
0X1677A8B7AAA975A1.avi,931,92,1598,76,667,2
0X167EC6F7A8986FED.avi,1683,67,2155,51,472,2
0X167F487F9DF04A97.avi,949,113,1609,98,660,2
0X168065C1F6FCF27C.avi,2077,72,2564,58,487,2
0X1685EEE356F42581.avi,871,130,1385,116,514,2
0X16862634E89FB736.avi,903,96,1503,82,600,2
0X1689802F6D3093D2.avi,1280,105,2048,90,768,2
0X16902A1B1A139923.avi,739,39,1342,30,603,2
0X169062AB1FF38E72.avi,1133,141,1850,112,717,2
0X1694973B204EAB.avi,962,158,1533,145,571,2
0X16967BF5B2546925.avi,1333,145,1676,127,343,2
0X169B747DFB6D2415.avi,1186,76,1888,61,702,2
0X169BC7341D79E051.avi,1289,73,1929,60,640,2
0X169D3A3AC16C2CE2.avi,1074,105,1611,89,537,2
0X16A017AC10918091.avi,1194,109,1517,92,323,2
0X16A129DE47B81909.avi,959,82,1475,69,516,2
0X16A6CEDE7F61E211.avi,897,145,1422,131,525,2
0X16A9F4D08E4677A1.avi,1701,68,2920,51,1219,2
0X16ACC4514A457BBA.avi,907,72,1424,56,517,2
0X16AF26F9A372EEDE.avi,1649,118,2494,99,845,2
0X16B28DDAC5D81FDF.avi,882,84,1330,65,448,2
0X16B2D41C50E4082C.avi,656,70,1038,56,382,2
0X16B5A10BF77BE425.avi,1275,26,2049,53,774,2
0X16B76AB7F9D95270.avi,1035,53,1589,39,554,2
0X16B85222D7B28245.avi,2196,97,2525,79,329,2
0X16BB1F509B1D9721.avi,1336,61,2137,47,801,2
0X16CEA7710E200570.avi,1029,67,1821,47,792,2
0X16CFBE094453AA79.avi,1378,115,2233,97,855,2
0X16CFE39107BFF8A7.avi,785,43,1194,34,409,2
0X16D883017E8A7734.avi,913,119,1419,100,506,2
0X16F87B98A2C09E62.avi,845,59,1203,39,358,2
0X16FA4A372C724D22.avi,788,61,1230,46,442,2
0X16FB5FF81284B942.avi,1186,17,1551,1,365,2
0X16FBD79EE1C8DA26.avi,872,98,1492,87,620,2
0X16FC9AA0AD5D8136.avi,1788,68,1946,47,158,2
0X16FE5AFA8320ACD3.avi,2489,52,3273,33,784,2
0X1702B6CCB7E8812B.avi,1280,50,1939,36,659,2
0X1702CEEC44104760.avi,2172,71,2527,57,355,2
0X17057442E198A967.avi,1330,78,1977,63,647,2
0X17098CFCB688AD91.avi,1163,65,1992,48,829,2
0X170AA34F7E4EFB6B.avi,1236,75,2045,54,809,2
0X170DDD15D26D5F83.avi,951,62,1314,44,363,2
0X170F2698C1A90A77.avi,1786,80,2730,58,944,2
0X1711A2ED181823F0.avi,1314,55,2002,39,688,2
0X17174AB357750B03.avi,1030,53,1632,38,602,2
0X17190A139A853180.avi,2645,130,3936,111,1291,2
0X17197B4B5AE30CC7.avi,1350,132,2128,115,778,2
0X171A7C9E7E1129D.avi,1287,71,1585,53,298,2
0X171A888D1B17304F.avi,920,174,1678,157,758,2
0X171B390B95FD0FAE.avi,1107,91,1819,77,712,2
0X171B52ED0054DF49.avi,1523,151,2454,127,931,2
0X171C87FA9E52210F.avi,1263,66,1552,48,289,2
0X171C9D28B996267E.avi,1209,131,1535,115,326,2
0X171CF9695943319A.avi,1267,63,2043,42,776,2
0X171FD888481D524D.avi,1229,118,2039,100,810,2
0X1725C38816FAAED5.avi,972,75,1490,56,518,2
0X17270F0DF580E06B.avi,1667,122,3035,100,1368,2
0X172821226E303BA6.avi,1048,155,1759,133,711,2
0X17294454521A97BB.avi,1324,17,2109,1,785,2
0X1729DA199F862403.avi,590,158,1004,140,414,2
0X172CA389F7A02EEF.avi,1871,179,2863,161,992,2
0X172D986B9780F9DE.avi,1149,69,1676,53,527,2
0X172F640B239CBFCA.avi,1311,124,2219,105,908,2
0X172FE96C1B43E4CF.avi,1462,50,1616,35,154,2
0X17344D3535D790EF.avi,1022,60,1833,41,811,2
0X173A0C055813A634.avi,1251,122,2023,101,772,2
0X173D74409C3E5652.avi,1318,54,1468,39,150,2
0X174090E59512E733.avi,1582,134,2324,113,742,2
0X17458D83D9F9B188.avi,1721,66,2667,42,946,2
0X174A9943AB689618.avi,1322,11,1551,1,229,2
0X174ADA9A145CAD74.avi,920,111,1461,90,541,2
0X174D0098F99A290E.avi,1296,55,1836,38,540,2
0X174E853B58F29959.avi,2423,102,4038,88,1615,2
0X175303C2D48B91CA.avi,1003,48,1523,34,520,2
0X1756A6A345D31CB3.avi,1419,47,1633,31,214,2
0X1760612A101EA2EB.avi,567,120,980,102,413,2
0X176394EB0FCFBD35.avi,1328,105,2072,84,744,2
0X1763FB53ABCFB176.avi,1090,126,1660,107,570,2
0X176B5602BC2BF57B.avi,588,76,1006,59,418,2
0X176C1E76AD804467.avi,1574,168,2444,153,870,2
0X1770B6D3A7C462B6.avi,1757,74,2948,56,1191,2
0X1770D3F5C2EA5142.avi,1002,65,1323,48,321,2
0X17734E8CA72A687A.avi,940,54,1556,42,616,2
0X1779C609E2B8B8C6.avi,623,102,1085,85,462,2
0X1779FEC3D7DEA8C2.avi,1570,64,1967,48,397,2
0X178269A4C18FC6B.avi,1102,101,1756,85,654,2
0X17828CD670289D36.avi,935,16,1491,2,556,2
0X17859AAFF455F6DF.avi,1170,162,1719,139,549,2
0X1786055C7E6EFCE6.avi,1624,48,2178,32,554,2
0X17865EC85AD080B0.avi,1290,77,2212,57,922,2
0X178A34206F5D376E.avi,1800,19,2899,2,1099,2
0X178DE58CE0367682.avi,1094,123,1649,103,555,2
0X178DF5359B89AD06.avi,1043,46,1312,29,269,2
0X17918422FAD01F20.avi,1150,56,1871,42,721,2
0X1793039C294208A0.avi,1889,104,2513,83,624,2
0X1798604CE5F68C34.avi,951,75,1552,63,601,2
0X179A9ADE4B5A5B88.avi,1522,76,2300,61,778,2
0X179B579A585FF160.avi,1940,21,2594,1,654,2
0X179BA5C70ACC402D.avi,1444,68,2368,52,924,2
0X179C10878AAE691E.avi,757,149,1125,137,368,2
0X179CFD0E04B039FB.avi,1694,74,2231,57,537,2
0X179D5051F8526C08.avi,2050,53,2241,32,191,2
0X17A28F565B51B841.avi,2134,179,2805,163,671,2
0X17A339D2A6706C11.avi,1033,14,1647,0,614,2
0X17A44C8A2D0EE533.avi,1560,58,2332,41,772,2
0X17A5854FEC963F9A.avi,1122,68,1781,50,659,2
0X17A59B0D289D4643.avi,1025,60,1487,46,462,2
0X17A9A432333A840F.avi,1357,69,1540,53,183,2
0X17A9DF475F90B6C6.avi,2036,75,2979,64,943,2
0X17AA98EC842092E3.avi,1776,50,2345,38,569,2
0X17ADB25B1E90B6C.avi,2146,66,3312,48,1166,2
0X17AE431AF06F53AB.avi,732,76,1026,64,294,2
0X17AF6DB1F62C771C.avi,1076,114,1665,90,589,2
0X17B3AF86CDF82B5C.avi,1111,95,1592,70,481,2
0X17BA5ABF4E82034B.avi,1270,34,2515,25,1245,2
0X17BC4EF4BF83368B.avi,1524,124,1873,101,349,2
0X17C42DA572378352.avi,1291,55,2230,40,939,2
0X17C5541071D4E52E.avi,763,49,1261,39,498,2
0X17C6F77ABE9266AF.avi,1171,62,1933,45,762,2
0X17CA14AB3CB05770.avi,1286,60,2203,40,917,2
0X17CAFC6BB1CA2DE.avi,1102,66,2013,50,911,2
0X17D229C79845F458.avi,1229,106,1850,95,621,2
0X17D6DA5B33D4069C.avi,2060,17,2698,4,638,2
0X17D958175C4CE2F3.avi,970,141,1483,126,513,2
0X17DA9A44189C6A38.avi,1507,88,2560,73,1053,2
0X17E230402D71C497.avi,1079,65,1705,48,626,2
0X17E51BF21235E28B.avi,1033,83,1580,68,547,2
0X17E5929A007B9E32.avi,1155,50,1842,36,687,2
0X17E6608AC5511D03.avi,1502,78,1924,63,422,2
0X17E6B8EDDD62F739.avi,1608,123,2509,108,901,2
0X17E8971B356D72C7.avi,876,57,1402,40,526,2
0X17EFE782884D63BA.avi,1770,55,3013,41,1243,2
0X17F142F80B72740D.avi,780,56,1298,42,518,2
0X17F29C21E6144BAB.avi,1190,50,1877,36,687,2
0X17F6D551F5734D8B.avi,2628,84,3303,66,675,2
0X17F7CCE4FCD76726.avi,1018,40,1527,31,509,2
0X17F940E1C4298D7.avi,1029,35,1548,16,519,2
0X17FA348140E338F7.avi,641,55,1011,38,370,2
0X17FD9808C073BC07.avi,1981,123,3628,103,1647,2
0X17FE6C8963488DAC.avi,862,125,1362,112,500,2
0X18039FAD713F594F.avi,961,111,1567,101,606,2
0X180951979820CA64.avi,1362,99,2330,78,968,2
0X18111FDA1FD455D5.avi,943,18,1453,3,510,2
0X1815E6741A8B2CFA.avi,867,72,1430,56,563,2
0X1818FF06D5E762A8.avi,919,14,1395,4,476,2
0X181A0445205F1D79.avi,1395,151,2105,134,710,2
0X182114B9EB84D61B.avi,987,96,1281,84,294,2
0X18247588296B45DF.avi,789,20,1148,3,359,2
0X182717968AF362F0.avi,1507,163,2174,144,667,2
0X18277456188D3B13.avi,1898,207,2616,191,718,2
0X18353D8F5AB7B324.avi,1323,124,2338,105,1015,2
0X18354FFCDBCF9EBB.avi,1162,67,2010,52,848,2
0X183BECFC41F9E3E0.avi,841,100,1278,81,437,2
0X183FA1CAAEA9C545.avi,2071,28,2161,33,90,2
0X1840607E4AF92B3E.avi,1042,98,1525,80,483,2
0X184173B598997780.avi,909,16,1560,1,651,2
0X184432EACE258EBF.avi,1394,72,2226,52,832,2
0X1847DC558AF3C423.avi,1335,97,1650,79,315,2
0X1847E925CBCEB6CE.avi,1570,22,1788,5,218,2
0X184B997FF61BB28B.avi,1927,66,2457,48,530,2
0X184DEB337FF5AB9.avi,923,86,1649,69,726,2
0X184E4A64C93BE06.avi,699,81,1058,64,359,2
0X184ECC87D1A8A226.avi,1612,234,2245,209,633,2
0X1855EB02B676DC2.avi,1159,119,1897,97,738,2
0X185672E7C8FF1212.avi,2134,14,2822,4,688,2
0X18579C8EAEFC2713.avi,1099,105,1747,88,648,2
0X1858AFC9464E1463.avi,2720,69,3154,59,434,2
0X185A9362099F3094.avi,890,52,1424,42,534,2
0X185D65EA647B5C61.avi,1246,70,2085,54,839,2
0X18610C37F29E80E4.avi,751,148,1269,134,518,2
0X1865C8A28648E2F0.avi,1192,81,1902,65,710,2
0X1865E116F085C53D.avi,1376,43,1545,32,169,2
0X186FC3D4ED309B9E.avi,802,13,1583,1,781,2
0X1870E70784D77469.avi,1055,156,1673,140,618,2
0X1871B1379385763C.avi,3193,120,3970,103,777,2
0X1874F566992B7FF6.avi,802,70,1135,52,333,2
0X18752855DF343E36.avi,1651,22,1876,6,225,2
0X1876806A464A0093.avi,2733,72,3279,55,546,2
0X1878080DBC95E7FC.avi,1261,121,2008,110,747,2
0X187B0E5DB0E285DD.avi,1128,152,1713,132,585,2
0X187EFDFCE3BEA77C.avi,915,76,1420,56,505,2
0X1880CD40F8586DBC.avi,1855,58,2863,42,1008,2
0X1883BBE20F1DC05D.avi,1569,80,2711,66,1142,2
0X18888A4FEDCAC3AA.avi,1095,66,1779,49,684,2
0X188AFC939CDA11FC.avi,1031,58,1802,38,771,2
0X18916084CE523264.avi,593,122,1159,109,566,2
0X1891E25994F489B9.avi,791,85,1246,70,455,2
0X18923DCFDE784034.avi,1101,71,1666,51,565,2
0X18989A4754914D96.avi,1208,13,2137,2,929,2
0X189B31C02B819CB9.avi,1031,62,1657,45,626,2
0X18A306D062D926FB.avi,718,26,1244,3,526,2
0X18A467C9DDA7707A.avi,1439,96,2186,81,747,2
0X18A4DD625B52E53E.avi,1281,115,2006,96,725,2
0X18A69B7961D01D28.avi,769,53,1173,38,404,2
0X18AB58EA130B3A90.avi,845,133,1464,121,619,2
0X18B3A9EB362299CF.avi,1270,136,1760,119,490,2
0X18B4FD6B23A94C8A.avi,1134,19,1715,3,581,2
0X18B8CD7AD450F707.avi,776,69,1219,56,443,2
0X18B8E705314BF4C0.avi,1329,52,2009,34,680,2
0X18BA5512BE5D6FFA.avi,1762,74,2662,56,900,2
0X18BFFDF053671070.avi,1154,66,1903,50,749,2
0X18C24CABDF058431.avi,977,101,1524,81,547,2
0X18C67769235E4C58.avi,766,55,1216,37,450,2
0X18C711A3AC175647.avi,2106,126,2663,106,557,2
0X18CB62C594EB4DDC.avi,1025,15,1604,4,579,2
0X18CE4A36AE88A585.avi,1402,118,2083,101,681,2
0X18D009E44F62FDA3.avi,1186,68,1783,52,597,2
0X18D12F1D70B64D0C.avi,2079,107,2973,88,894,2
0X18D2B28FBD7DD266.avi,1401,101,2472,73,1071,2
0X18D52232BF832BA.avi,927,44,1547,33,620,2
0X18DA846E9699358F.avi,1372,52,2113,36,741,2
0X18DF4351AAEEF3C9.avi,587,59,1008,45,421,2
0X18E7B26CAD98175.avi,1607,170,2668,153,1061,2
0X18EAA8BD773D0B43.avi,921,82,1540,60,619,2
0X18EF8F4C9A35641.avi,984,69,1548,54,564,2
0X18FC2192952D0349.avi,2004,73,3198,56,1194,2
0X19001827BA355232.avi,674,103,950,85,276,2
0X1902FC225A954D67.avi,1150,45,1715,34,565,2
0X190403EC57259998.avi,1154,68,2071,53,917,2
0X1904DC1BFE26592F.avi,1722,67,2309,48,587,2
0X1905CFC5951B4F7F.avi,1700,199,1947,184,247,2
0X19063156A3F3C14E.avi,1194,72,1944,52,750,2
0X1915042866B81B09.avi,1061,57,1623,41,562,2
0X19152A7A3ABDFFBB.avi,1102,114,1845,82,743,2
0X19163DCC129B0134.avi,1119,86,1450,71,331,2
0X1917BD1A03DD500B.avi,915,20,1352,3,437,2
0X191A73CA019BCD1B.avi,1328,56,2068,39,740,2
0X191F4BD1E4262B78.avi,1211,98,1789,84,578,2
0X1922FC3605A29BD7.avi,813,59,1292,42,479,2
0X192BF0F7E30FAEE2.avi,999,85,1525,71,526,2
0X192E809348BF4D86.avi,891,40,1475,28,584,2
0X19325CFA88842F2E.avi,739,80,1351,62,612,2
0X1933C9D846A59DB1.avi,1277,156,1597,134,320,2
0X19359F9246BB8A33.avi,1101,75,1871,58,770,2
0X1936B58B8E1F0305.avi,1283,76,1987,61,704,2
0X193DAE2D1CE519CE.avi,2059,88,3037,71,978,2
0X193E071BCB23C9C3.avi,1015,110,1395,97,380,2
0X19467C739783524D.avi,1237,153,2108,133,871,2
0X19480FDA24A00E4A.avi,1008,60,1658,43,650,2
0X1956F412DA2FE4C6.avi,1570,110,2526,95,956,2
0X1959D1C10DEB5749.avi,1248,73,1957,59,709,2
0X195D3B45D8A0DB2D.avi,688,84,1109,69,421,2
0X195F60292B968F31.avi,1328,87,2287,68,959,2
0X196186BDD71D1431.avi,1053,80,1887,58,834,2
0X19618B8C8B4DF34B.avi,1194,17,2123,0,929,2
0X1965872D32B60581.avi,1025,58,1555,43,530,2
0X19661E4F455D7F61.avi,945,123,1616,106,671,2
0X19681D039967D016.avi,1502,67,2210,49,708,2
0X196C052551A4CABB.avi,1333,68,2071,52,738,2
0X196DC930B3905A7.avi,1669,89,1970,72,301,2
0X196F26E35CDAC977.avi,797,70,1291,49,494,2
0X197084FCEC4148B9.avi,835,15,1283,0,448,2
0X1972FA470600C81E.avi,2059,77,2963,63,904,2
0X197911F5F8F8E21C.avi,1391,142,2003,132,612,2
0X197DF6A1F73E7DFC.avi,926,26,1279,19,353,2
0X197E4CD40A2201F5.avi,1448,66,2173,50,725,2
0X19816523D8096AC8.avi,1198,122,1886,107,688,2
0X19840511812269C2.avi,1522,63,2227,44,705,2
0X1985B619CF9BF669.avi,1220,122,1854,102,634,2
0X19900411C55CBC8.avi,1789,120,2592,103,803,2
0X1993275B5FC115CF.avi,1814,15,2405,0,591,2
0X199715475BB10B69.avi,1097,100,1738,83,641,2
0X1999533C6100442C.avi,810,52,1296,33,486,2
0X199FB3987429A7B1.avi,1066,100,1787,72,721,2
0X19A2CB675FA38526.avi,1445,87,2324,72,879,2
0X19A7A51DBF1CFEC6.avi,1259,135,1767,112,508,2
0X19AC153896677B58.avi,1364,46,2252,32,888,2
0X19AC1E6345765C03.avi,1974,18,2359,0,385,2
0X19ACDC7E0119034A.avi,856,16,1375,2,519,2
0X19AD6B318F7CEFFD.avi,1289,158,2114,143,825,2
0X19B044F932C6BC6C.avi,1098,71,1845,53,747,2
0X19B8983673C64F6E.avi,1242,62,1710,51,468,2
0X19B9109694DE642.avi,741,11,1110,27,369,2
0X19BC228D5D5F58.avi,1372,137,2199,117,827,2
0X19BCCFDA31770A23.avi,1380,52,2316,38,936,2
0X19BDD7CE32887463.avi,1418,67,1831,47,413,2
0X19C391E6D353A95E.avi,1338,118,2029,99,691,2
0X19C41F308D6663A1.avi,1072,111,1801,94,729,2
0X19C438542B668FA.avi,1002,104,1670,84,668,2
0X19CA4A53B93AFB3E.avi,1146,19,1774,0,628,2
0X19D448273C0BF59F.avi,1335,92,1944,72,609,2
0X19D929CBB3056FCE.avi,983,110,1763,93,780,2
0X19DDDD5F1F429BA0.avi,1531,39,2164,28,633,2
0X19DF9461CA5F498F.avi,949,68,1618,50,669,2
0X19E240FFEFEBBD.avi,1187,52,2052,36,865,2
0X19E42A10F0077B9F.avi,2948,58,3396,45,448,2
0X19E6ED76090F947D.avi,1886,17,2235,0,349,2
0X19E76D0B6EF68709.avi,1251,68,1615,52,364,2
0X19E82707BBBA6452.avi,948,132,1378,112,430,2
0X19EA5CB11FC1BC78.avi,907,50,1541,37,634,2
0X19EC4368A6646DE8.avi,869,49,1351,36,482,2
0X19EDAE3C1312197A.avi,1823,96,3347,83,1524,2
0X19EE8D8054A106AF.avi,1096,74,1861,53,765,2
0X19EEE7F19EFB69DF.avi,1475,56,1799,42,324,2
0X19F05146FAAACB83.avi,995,140,1736,123,741,2
0X19F169BA719D9E9F.avi,1128,121,2250,99,1122,2
0X19F41F4CC412632E.avi,1042,58,1723,48,681,2
0X19F5F732B9ED2EC7.avi,1193,75,1717,54,524,2
0X19FD06A9BF46A803.avi,1398,51,2027,30,629,2
0X1A030EFDD45062FA.avi,1153,70,1514,52,361,2
0X1A05829AEDF6C65.avi,1164,24,1985,3,821,2
0X1A05DFFFCAFB253B.avi,1192,68,1990,48,798,2
0X1A09BE7969DA1508.avi,1462,124,2562,110,1100,2
0X1A0A263B22CCD966.avi,735,83,1215,72,480,2
0X1A1891A9F821324E.avi,996,140,1759,124,763,2
0X1A193199E812B948.avi,1052,65,1801,50,749,2
0X1A193A8138F4DD0F.avi,792,107,1256,87,464,2
0X1A2629BF0939E381.avi,914,58,1501,39,587,2
0X1A296F5FCD5A0ED8.avi,1098,80,1911,68,813,2
0X1A2A76BDB5B98BED.avi,921,78,1580,63,659,2
0X1A2C60147AF9FDAE.avi,821,62,1323,46,502,2
0X1A2E9496910EFF5B.avi,797,55,1131,39,334,2
0X1A349D84388BD74B.avi,936,61,1500,44,564,2
0X1A36AE0874972BBE.avi,1004,55,1605,40,601,2
0X1A3D565B371DC573.avi,1024,176,1541,152,517,2
0X1A3E7BF1DFB132FB.avi,1522,73,2843,55,1321,2
0X1A481BE9AE4F2DCD.avi,1204,82,2172,61,968,2
0X1A494FC3B214947B.avi,1848,114,2384,101,536,2
0X1A50422240E04D03.avi,991,110,1503,93,512,2
0X1A58B506ED05C1D4.avi,1286,88,1569,66,283,2
0X1A58C9DFE12C7953.avi,1070,55,1684,38,614,2
0X1A5FAE3F9D37794E.avi,1212,48,1784,35,572,2
0X1A62D321A1A1821B.avi,1840,78,2810,60,970,2
0X1A6699291D449F74.avi,1045,63,1765,47,720,2
0X1A6ACFE7B286DAFC.avi,1717,142,2618,124,901,2
0X1A75652DD11C1689.avi,725,72,1184,54,459,2
0X1A75CDAE16981DBC.avi,1391,19,2244,4,853,2
0X1A76A1A8448B456.avi,974,18,1494,2,520,2
0X1A8797C532A3F0EF.avi,1119,107,1252,96,133,2
0X1A8D85542DBE8204.avi,1609,117,2378,91,769,2
0X1A8F20B8BF0B4B45.avi,783,146,1240,131,457,2
0X1A970F020826E7FA.avi,1121,120,1844,100,723,2
0X1A9827D58AC404D1.avi,1468,78,1824,60,356,2
0X1A9D7251E9464D49.avi,890,160,1502,143,612,2
0X1AA00FE97F010F42.avi,1469,91,2320,77,851,2
0X1AA2E82F7F577905.avi,480,66,722,56,242,2
0X1AA30623C1AE4641.avi,1546,65,2787,49,1241,2
0X1AA5F075905B8FE9.avi,1656,56,2652,39,996,2
0X1AA6A2C3ADD3E2F1.avi,941,94,1584,73,643,2
0X1AA8E4C0155A02E0.avi,964,60,1586,44,622,2
0X1AA923C15A9F0D3E.avi,2386,43,2768,28,382,2
0X1AACBE51D95E0698.avi,1419,43,2484,26,1065,2
0X1AADD51FAA94E4E.avi,1367,97,2278,80,911,2
0X1AB987597AF39E3B.avi,1753,63,2236,44,483,2
0X1ABAD3C70E6D0F27.avi,1254,12,1828,0,574,2
0X1ABE578AF99E8F3E.avi,1057,58,1299,45,242,2
0X1ACB73BE8C1F2C0C.avi,749,53,1111,44,362,2
0X1ACC87A912A57EDA.avi,715,146,1160,135,445,2
0X1AD23DC4055A4B6A.avi,1391,52,2270,29,879,2
0X1AD3CDEC841DA50.avi,735,176,1394,156,659,2
0X1ADDEA184822F38E.avi,1733,62,2611,45,878,2
0X1ADEAFA4D59610C8.avi,1100,61,1974,51,874,2
0X1AE20B8AE3B5E9EF.avi,1107,118,1819,100,712,2
0X1AE66E51AC2B077C.avi,1341,73,2159,58,818,2
0X1AE829B4D710C61B.avi,1599,54,2700,36,1101,2
0X1AE89E8AFB9A3EFA.avi,1077,117,1780,95,703,2
0X1AE9BF9AC0788D0F.avi,827,54,1269,40,442,2
0X1AEAD01BDFAB0A10.avi,822,16,1278,0,456,2
0X1AECADC95492F71D.avi,956,51,1790,36,834,2
0X1AEE3CDCAEC1A61.avi,1395,54,2125,36,730,2
0X1AEE776BCC482134.avi,2590,75,3008,54,418,2
0X1AF21B7690DB0BCB.avi,817,134,1276,117,459,2
0X1AFA6BA6C2E2132C.avi,1609,30,2396,1,787,2
0X1AFB0F66AC312843.avi,1102,128,1637,114,535,2
0X1AFEC568103E25C7.avi,1239,69,2308,49,1069,2
0X1B000374EAD0EC4C.avi,750,75,1195,56,445,2
0X1B00A1770ABC7BD2.avi,1859,138,2173,117,314,2
0X1B01EAEFBE83BEB0.avi,1108,74,1719,54,611,2
0X1B025FF1F6B21C16.avi,1963,59,3223,79,1260,2
0X1B05B56F239276F3.avi,1073,125,1622,113,549,2
0X1B0895E4993C1F79.avi,1259,93,1931,77,672,2
0X1B0B2312599F9EA2.avi,2138,22,2780,3,642,2
0X1B15DFCD442A799C.avi,699,173,1126,155,427,2
0X1B165975B5EF65D9.avi,1393,152,1864,136,471,2
0X1B170168A6449950.avi,1358,55,2029,41,671,2
0X1B1798BF5669FB07.avi,1190,117,2042,103,852,2
0X1B18BF458FEFF359.avi,829,74,1268,52,439,2
0X1B1C20A5745C92CA.avi,1437,63,2462,45,1025,2
0X1B2089E659E6AA87.avi,1387,93,2132,78,745,2
0X1B2241C91CCDEF05.avi,1541,51,1935,35,394,2
0X1B25F9E969909539.avi,900,13,1377,3,477,2
0X1B281A660811E1EA.avi,1208,110,1753,92,545,2
0X1B2900BF089AD45F.avi,639,88,927,74,288,2
0X1B2B05C3C40B72BA.avi,1065,97,1928,82,863,2
0X1B2BCDAE290F6015.avi,2178,30,2520,5,342,2
0X1B2C915522B844C2.avi,780,55,1327,40,547,2
0X1B2E5940872E3373.avi,940,94,1567,77,627,2
0X1B307E34A69B4030.avi,1073,48,1610,36,537,2
0X1B30B4E3D0465503.avi,1562,64,2579,49,1017,2
0X1B357C0B6C82BB18.avi,969,176,1559,157,590,2
0X1B379931357428C0.avi,788,166,1303,142,515,2
0X1B37FD032ECC5F3B.avi,981,69,1431,55,450,2
0X1B3DB601BDE717E3.avi,2005,114,2828,98,823,2
0X1B3EC325B3E2311B.avi,1199,93,1925,75,726,2
0X1B3FFA6126553D43.avi,1362,15,1590,0,228,2
0X1B41B8EBA3A7FCCA.avi,1277,66,1928,50,651,2
0X1B43F368B235BE28.avi,1109,80,1589,60,480,2
0X1B48047F9A40121.avi,1529,99,1943,81,414,2
0X1B4BD1E75ADB69FF.avi,811,135,1154,117,343,2
0X1B4BEF07F46727E5.avi,964,143,1407,129,443,2
0X1B4F427BC662B727.avi,1429,58,2047,42,618,2
0X1B4F9C7AEC750887.avi,941,48,1552,34,611,2
0X1B50C4EFCE4201B9.avi,1039,58,1735,38,696,2
0X1B53202748E0AB3F.avi,2302,182,3010,164,708,2
0X1B54B78D0A2101E4.avi,907,62,1319,42,412,2
0X1B55DFD67FEA873F.avi,1134,108,1851,95,717,2
0X1B5F80BEE43A4CE0.avi,1595,147,2360,128,765,2
0X1B6045BB53151A4A.avi,1459,48,2048,34,589,2
0X1B65D8D908C385B.avi,833,82,1365,65,532,2
0X1B68B516EEF78BA1.avi,1184,64,1757,45,573,2
0X1B6A0E49BE9C0472.avi,1404,106,2503,81,1099,2
0X1B6B465FEA68FBEA.avi,1199,69,1710,49,511,2
0X1B71C9A73CCCC8B7.avi,1959,68,2339,52,380,2
0X1B780BD98DA7D4D9.avi,1287,82,1812,65,525,2
0X1B7833C5A54B5FF2.avi,4201,60,4834,42,633,2
0X1B78D94323028328.avi,1199,65,1781,46,582,2
0X1B7B728C3E99A716.avi,689,106,1160,94,471,2
0X1B7E00757AF6858B.avi,978,98,1467,80,489,2
0X1B7EDA7973C0A9E.avi,931,56,1541,40,610,2
0X1B861DB510984105.avi,1842,95,3671,76,1829,2
0X1B86D91E09FF9EBA.avi,866,51,1459,39,593,2
0X1B8D4F0D26BB0826.avi,1009,78,1727,59,718,2
0X1B8DC2233ED16EA9.avi,1296,89,1940,72,644,2
0X1B8FD7CA891CA2CD.avi,2218,52,2362,37,144,2
0X1B94E05BA6E96C70.avi,1323,76,1676,54,353,2
0X1BA1268DB195A3F.avi,1374,46,1599,33,225,2
0X1BA265AD5BF096E5.avi,1666,66,2090,51,424,2
0X1BA53DA5F128AB92.avi,1754,61,2538,46,784,2
0X1BA556585D2FE6A7.avi,2129,83,2799,68,670,2
0X1BA619D4A0E2746.avi,1077,109,1573,90,496,2
0X1BA7A8147245AB28.avi,1084,66,1976,48,892,2
0X1BA8C753E08FB53F.avi,2128,77,3607,57,1479,2
0X1BA9676E9B1FAEA7.avi,1359,18,2196,0,837,2
0X1BACE554294DDF8.avi,1799,49,2684,37,885,2
0X1BB19B668CF2A22E.avi,2096,81,3325,62,1229,2
0X1BB47462D0C470D5.avi,480,42,764,34,284,2
0X1BB609E66AC34DE.avi,889,120,1589,99,700,2
0X1BB91877C1F2F21E.avi,1623,59,2795,42,1172,2
0X1BC515434037562D.avi,753,51,1181,33,428,2
0X1BCA2217072BCB55.avi,1124,170,1888,152,764,2
0X1BCA569AEE7FCFC6.avi,1343,67,2124,51,781,2
0X1BCAECCA681C2F1A.avi,2103,79,3571,52,1468,2
0X1BCC6B1BA8FEBC5.avi,977,55,1461,38,484,2
0X1BCC9803878310C8.avi,964,72,1604,53,640,2
0X1BCD0AD72ECB908A.avi,1175,238,1796,209,621,2
0X1BD453F455D30DEA.avi,841,53,1490,38,649,2
0X1BD5EEAC641B0443.avi,1100,76,1673,66,573,2
0X1BD7A625C9DA5292.avi,708,68,892,55,184,2
0X1BDA3760E526CD15.avi,3512,110,4094,95,582,2
0X1BDE353AD84F913D.avi,991,35,1690,26,699,2
0X1BDEEC24D5FC570C.avi,1417,113,2422,93,1005,2
0X1BE3FBED90CBC6BB.avi,2309,69,3232,99,923,2
0X1BE64129E54E4042.avi,1005,100,1726,73,721,2
0X1BEA6959BDF3CC69.avi,827,48,1432,37,605,2
0X1BED31FBCDA78011.avi,1135,19,1826,0,691,2
0X1BF00F2E669B915E.avi,2499,149,2936,132,437,2
0X1BF56B66ECD93FED.avi,1514,61,2385,47,871,2
0X1BFF8D71CA0070FF.avi,1087,58,1831,45,744,2
0X1C0BDFA4E539B43B.avi,1065,24,1581,0,516,2
0X1C12CFE9B3EC7C95.avi,1197,124,2266,99,1069,2
0X1C15B7D4A1339799.avi,1203,76,1807,57,604,2
0X1C1A328EA29B6CC3.avi,1111,60,1567,43,456,2
0X1C1E4272FA7678DD.avi,843,62,1375,49,532,2
0X1C1F4EA2045C5402.avi,1431,72,2018,59,587,2
0X1C32622E5515DFF5.avi,1165,145,2177,124,1012,2
0X1C33DE87BFF16258.avi,1134,87,1740,63,606,2
0X1C3559AB35305292.avi,1012,135,1708,118,696,2
0X1C46CC78DD272DA9.avi,1453,53,2580,38,1127,2
0X1C48B213563D806E.avi,955,48,1277,34,322,2
0X1C4BA7E6CC226887.avi,925,30,1611,21,686,2
0X1C569B8A2AA3A56B.avi,1031,66,1519,56,488,2
0X1C5B6810C6224D33.avi,1624,70,2822,54,1198,2
0X1C5E88A031705A5E.avi,1409,58,2501,39,1092,2
0X1C60E6C39540CE11.avi,1538,129,2504,113,966,2
0X1C635AEB198CFFC6.avi,1468,100,2425,86,957,2
0X1C646F03E10DDA20.avi,935,56,1458,43,523,2
0X1C64E294328A8F14.avi,985,55,1598,37,613,2
0X1C65E2F2670EDE62.avi,1142,61,1555,42,413,2
0X1C71836EDBA989E0.avi,1131,128,1572,109,441,2
0X1C7404B2998743AC.avi,932,87,1485,63,553,2
0X1C7A7B6A9AF3D511.avi,953,162,1470,149,517,2
0X1C7C2D50F32C91CF.avi,1018,164,1664,151,646,2
0X1C7C566D4F68F6D2.avi,813,92,1167,78,354,2
0X1C7D028B07255C1B.avi,1577,61,2555,45,978,2
0X1C8054277A139381.avi,1033,26,1577,15,544,2
0X1C82AA09A1D277E8.avi,1029,76,1340,60,311,2
0X1C82B217189FDD84.avi,1139,73,1877,53,738,2
0X1C84462026E440E0.avi,1197,112,2095,95,898,2
0X1C85315EEDEFF010.avi,1283,65,1983,50,700,2
0X1C88C00C2ED813C3.avi,1394,208,2400,193,1006,2
0X1C89EE0FA8900904.avi,1077,69,1574,51,497,2
0X1C8A2199662FE731.avi,1299,158,1964,141,665,2
0X1C8C0CE25970C40.avi,851,34,1303,21,452,2
0X1C9CCA2A21942E09.avi,697,71,1086,54,389,2
0X1C9F9EC57DDAFE0B.avi,1264,121,2035,101,771,2
0X1CA16A648FE49910.avi,1134,58,1536,42,402,2
0X1CA24B09EF768629.avi,999,137,1531,116,532,2
0X1CAD9DE1F782AF55.avi,681,40,1180,33,499,2
0X1CAF8DA4E12CFBA4.avi,1396,119,1778,99,382,2
0X1CB1B34B202C4041.avi,819,19,1406,47,587,2
0X1CB4A8300D2A3A7E.avi,907,21,1470,0,563,2
0X1CB543E7827F3A19.avi,1362,50,1931,36,569,2
0X1CB789DF05D5561C.avi,1126,106,1863,91,737,2
0X1CB9B564C2B0F615.avi,882,125,1295,108,413,2
0X1CBC3578B6638C3B.avi,1327,57,2003,44,676,2
0X1CBE92E8D0B12C7.avi,1008,57,1682,40,674,2
0X1CC5A2587BAEBD73.avi,1519,172,2537,144,1018,2
0X1CC8CF03024E9245.avi,987,118,1473,102,486,2
0X1CD114B3DED2907A.avi,1713,163,2536,134,823,2
0X1CD9761078D7F70F.avi,1153,82,1769,63,616,2
0X1CD9AB4AB31F2DB3.avi,1546,77,2697,54,1151,2
0X1CDCF35D2D2D80ED.avi,1172,77,1799,62,627,2
0X1CDD9C054D8FB60D.avi,1892,130,2245,111,353,2
0X1CDE7FECA3A1754B.avi,1084,21,1514,0,430,2
0X1CEBFD3654DFE9D3.avi,2674,33,3958,22,1284,2
0X1CEDB27808EA7730.avi,1089,76,1983,61,894,2
0X1CF4B07994B62DBB.avi,1557,39,1574,31,17,2
0X1CF55D59270F6C7.avi,1332,60,2439,42,1107,2
0X1CF81033C527E6A3.avi,765,49,1372,37,607,2
0X1CF9770B0D12C750.avi,1450,239,2205,208,755,2
0X1D002C3879CAE6C1.avi,1750,85,2205,73,455,2
0X1D00424C7EBCCA52.avi,917,67,1506,50,589,2
0X1D026A00CF69D6B.avi,947,55,1544,47,597,2
0X1D04C25FA7BF8956.avi,1090,94,1628,76,538,2
0X1D07317451CD15C.avi,1654,108,2112,95,458,2
0X1D0C24D004481BF1.avi,1202,111,1736,97,534,2
0X1D0EE9FA3D7BAB92.avi,963,64,1442,44,479,2
0X1D0F905BD24A0655.avi,1680,115,2276,96,596,2
0X1D15ED3F501B5ED7.avi,964,60,1555,46,591,2
0X1D181F5019010E4B.avi,1222,49,1761,26,539,2
0X1D1827F63E2BF135.avi,1608,107,2042,89,434,2
0X1D1CFF6024EE3376.avi,1471,152,2784,136,1313,2
0X1D1F9CC83450E37E.avi,1179,60,2271,46,1092,2
0X1D20B8AA6F51A9C9.avi,1189,76,1847,53,658,2
0X1D21C27167358D98.avi,717,71,1070,47,353,2
0X1D22C277EE981F30.avi,1477,32,1709,23,232,2
0X1D24CEA29A24560B.avi,920,54,1458,40,538,2
0X1D2517EEA27B805F.avi,2091,111,3351,94,1260,2
0X1D26D7A594FADAA2.avi,1283,87,2261,70,978,2
0X1D3210B98E59078A.avi,911,68,1334,54,423,2
0X1D393AED88F9D056.avi,1382,72,1939,57,557,2
0X1D3B87F45396BF74.avi,2014,73,3334,60,1320,2
0X1D3D82FD91F61757.avi,1017,85,1840,67,823,2
0X1D435EAAB297493F.avi,1100,66,1817,48,717,2
0X1D458DED386FFD57.avi,1676,81,2315,66,639,2
0X1D47DAD797C08240.avi,1365,45,2114,32,749,2
0X1D484F34365B129A.avi,1483,124,2403,102,920,2
0X1D531494AA297EA7.avi,965,75,1496,58,531,2
0X1D5340ABC7E874A0.avi,1173,15,1533,3,360,2
0X1D56758A76508E6B.avi,2088,97,2345,80,257,2
0X1D56E0444C390AAB.avi,2240,95,2761,68,521,2
0X1D5C7F82BC641385.avi,2520,75,3609,63,1089,2
0X1D5D36D11FB698E6.avi,1340,112,2549,89,1209,2
0X1D6C97E5EE466774.avi,613,78,1086,60,473,2
0X1D72D240D0D428E7.avi,966,124,1572,105,606,2
0X1D79693A227013AF.avi,1008,89,1286,81,278,2
0X1D7D9F50E7714DF3.avi,1889,96,3013,81,1124,2
0X1D82C79739A0FA64.avi,1213,76,1899,57,686,2
0X1D855297E0E75B59.avi,840,56,1233,36,393,2
0X1D865EBAD1A947E4.avi,1333,8,1717,0,384,2
0X1D89AB9610940667.avi,2039,128,2547,105,508,2
0X1D8AB94351A8029D.avi,1145,19,1928,0,783,2
0X1D8B6731487F309.avi,1185,57,1763,40,578,2
0X1D8D28801D701B6.avi,1025,33,1524,19,499,2
0X1D903A5F71B0415B.avi,1301,61,2026,45,725,2
0X1D964059BBD23752.avi,810,94,1308,78,498,2
0X1D97238D22053D7F.avi,1034,127,1575,112,541,2
0X1D9BD6464304E4C1.avi,1112,170,1862,153,750,2
0X1DA42DFD1ADF56A2.avi,1487,158,2323,140,836,2
0X1DA5AC481B10C795.avi,749,54,1280,37,531,2
0X1DAD3979E64B1EB0.avi,782,60,1266,46,484,2
0X1DAD96580464A3AE.avi,1149,97,1670,82,521,2
0X1DAFA784FB6CD2DC.avi,979,73,1510,57,531,2
0X1DB488AC3583E3D6.avi,807,88,1292,76,485,2
0X1DBA02F07308FF4.avi,1685,62,2707,42,1022,2
0X1DBA0F198086D94D.avi,1029,96,1581,84,552,2
0X1DBC6610903DEE15.avi,1534,53,2533,39,999,2
0X1DBC96AF6E04AFAE.avi,1333,73,2307,53,974,2
0X1DBFE6B5E123C051.avi,2023,167,2495,149,472,2
0X1DC2DFB2C2B235E0.avi,1209,90,1633,76,424,2
0X1DC37C23058344DB.avi,1441,14,2245,1,804,2
0X1DCA0E401C075C0B.avi,1648,137,2507,114,859,2
0X1DCB42B624F74B6A.avi,889,64,1404,45,515,2
0X1DCD463A9C38E795.avi,1093,94,1681,79,588,2
0X1DD34527824BAE2B.avi,1972,86,3189,67,1217,2
0X1DD541B1AA7D27F5.avi,904,50,1381,38,477,2
0X1DD7E4C84703951C.avi,1471,73,1838,54,367,2
0X1DD94B6FED393031.avi,995,47,1664,28,669,2
0X1DDB2D8370136DF6.avi,625,58,955,43,330,2
0X1DE0D259C9FFED67.avi,897,158,1475,139,578,2
0X1DE1700F4DDEF5AB.avi,1364,150,1951,133,587,2
0X1DE841B07C0641E5.avi,1316,79,2021,58,705,2
0X1DE88A76BA76EB42.avi,1235,63,1817,46,582,2
0X1DEBBA3CCE0C4044.avi,1453,44,1711,29,258,2
0X1DECC0FD3CEFBBF9.avi,1506,128,2513,109,1007,2
0X1DEE80021337DE93.avi,810,157,1669,130,859,2
0X1DF7163A74801695.avi,778,203,1302,187,524,2
0X1DF725E212D34FF2.avi,829,14,1341,1,512,2
0X1DF846341FD06B89.avi,1213,15,2120,2,907,2
0X1DF8F6CF6E254FA1.avi,555,61,968,50,413,2
0X1DFB35BA6E0A7B20.avi,1433,109,2209,90,776,2
0X1E0132313BE50536.avi,1070,59,1566,41,496,2
0X1E042B3994B076CF.avi,1515,53,1841,43,326,2
0X1E0D4D57EA9C0D47.avi,934,55,1431,42,497,2
0X1E125FF0DBDEDD8E.avi,1602,113,2826,96,1224,2
0X1E12C1907286203F.avi,1056,41,1562,34,506,2
0X1E12EEE43FD913E5.avi,1154,42,1320,29,166,2
0X1E1603F30AB541CC.avi,695,58,1116,43,421,2
0X1E19B51380EDA781.avi,1934,128,3345,94,1411,2
0X1E1CEE4FB1052A3A.avi,1136,114,1852,99,716,2
0X1E24B73EF1088C16.avi,1079,54,1692,40,613,2
0X1E254C7288E039E1.avi,2167,104,3478,85,1311,2
0X1E2A3EA85194639F.avi,922,104,1559,95,637,2
0X1E319F331B8638F7.avi,1673,94,3100,79,1427,2
0X1E3950AF8323C7C3.avi,634,34,995,25,361,2
0X1E3989E1CA499ADC.avi,1728,20,2690,1,962,2
0X1E41619BEA0A4042.avi,741,19,1202,0,461,2
0X1E4214A580D40B2B.avi,1561,62,1955,46,394,2
0X1E4319B75C24DB18.avi,926,136,1495,121,569,2
0X1E433E7966FD7332.avi,1133,94,1396,71,263,2
0X1E4717D992CFA5F4.avi,1470,68,1968,51,498,2
0X1E4C615D9F0C3287.avi,916,70,1455,51,539,2
0X1E4FB78F8BCBB9B2.avi,813,86,1215,77,402,2
0X1E4FC262266FC8D6.avi,1398,58,1878,39,480,2
0X1E4FEF1411B063A7.avi,1108,131,1480,114,372,2
0X1E50146E7EAFF53E.avi,1303,143,1584,118,281,2
0X1E5364575AD6FAD4.avi,1671,74,2362,52,691,2
0X1E544C386296BE42.avi,1126,124,1538,105,412,2
0X1E5936D90E75B1A7.avi,1157,146,1955,131,798,2
0X1E611525E31DDA7B.avi,1627,81,2652,61,1025,2
0X1E61DC4342BD6300.avi,963,56,1490,36,527,2
0X1E62CC48E5EF3624.avi,1423,133,2180,114,757,2
0X1E6321147D13B4BC.avi,1740,104,3113,83,1373,2
0X1E635D1244D8F305.avi,1110,75,1870,59,760,2
0X1E6679C7134CBE5D.avi,929,111,1455,90,526,2
0X1E67F4F64EDDA6ED.avi,1165,61,1646,30,481,2
0X1E6815E1D578374.avi,1804,21,2779,0,975,2
0X1E6CBE38BF082CC.avi,1973,77,2793,56,820,2
0X1E72A706170A99CF.avi,962,104,1511,85,549,2
0X1E737062D3FC72DB.avi,1663,73,2975,56,1312,2
0X1E749B73E6D4B963.avi,991,79,1321,60,330,2
0X1E761ED7D7755949.avi,951,116,1549,99,598,2
0X1E7DD9435BBDEFC1.avi,1118,60,2069,41,951,2
0X1E8097AF20639AFD.avi,1132,156,1578,138,446,2
0X1E840F388269AE5D.avi,1601,46,2512,30,911,2
0X1E8826D9BE12BF0D.avi,1008,56,1477,42,469,2
0X1E890CFC7E9C3E14.avi,894,80,1316,67,422,2
0X1E89470188B772FB.avi,1376,16,1902,0,526,2
0X1E8B7A7B0312AD0B.avi,726,52,1128,38,402,2
0X1E9465782E2D5B16.avi,1567,129,2485,115,918,2
0X1E9C4F25D31278C7.avi,1335,44,2293,34,958,2
0X1EA0FB82B5B28F2F.avi,1626,51,2470,36,844,2
0X1EA2B431C3A155AA.avi,1019,71,1789,53,770,2
0X1EA3EC569C1E2C60.avi,937,79,1499,55,562,2
0X1EA50DD28B65A0EC.avi,2372,63,3685,52,1313,2
0X1EA6F8F85D1A8178.avi,1231,23,1996,3,765,2
0X1EA7A5960D8A5576.avi,1693,12,3043,2,1350,2
0X1EA7A71E2DBC4AC0.avi,1036,72,1921,49,885,2
0X1EA7B071C64DA43E.avi,1259,120,2230,91,971,2
0X1EAA8A2138A834E0.avi,1156,89,1897,76,741,2
0X1EB543E46AF39064.avi,1118,92,1905,80,787,2
0X1EB9E86F4FA26B5B.avi,1706,20,2911,2,1205,2
0X1EBDE8F8E5BA979D.avi,1355,134,2534,112,1179,2
0X1EC139D3F3A2D516.avi,662,55,1077,42,415,2
0X1EC55C31E1027A7D.avi,1078,44,1577,29,499,2
0X1ECA00B8BAB9E432.avi,2467,84,3205,64,738,2
0X1ECE22D7A0081047.avi,1494,64,2597,45,1103,2
0X1ECE8E201253DCBB.avi,1115,68,1725,49,610,2
0X1ED03199B5CD723F.avi,1000,155,1646,138,646,2
0X1ED182EA95B3349E.avi,1448,56,2369,47,921,2
0X1ED8BDD5ABC0E688.avi,1220,127,2060,109,840,2
0X1EDA0F3F33F97A9D.avi,1430,126,1797,114,367,2
0X1EDC550222BB3CB7.avi,1015,69,1516,49,501,2
0X1EDE39935530AE94.avi,1151,124,1813,104,662,2
0X1EDF77660FB2302C.avi,1847,65,2215,47,368,2
0X1EE30D34D1CBF56A.avi,1092,50,1822,36,730,2
0X1EE5D4C563C42FFC.avi,1458,47,2304,34,846,2
0X1EF35FFC92F4F554.avi,1621,287,2613,246,992,2
0X1EF97820A1259D69.avi,946,129,1673,111,727,2
0X1EFB6CCF125DF19C.avi,2300,101,2660,80,360,2
0X1EFC35B469AE1CEC.avi,1045,20,1746,0,701,2
0X1EFF5D4EF0A8CAF8.avi,1807,21,2109,1,302,2
0X1F00CAA7AC31402B.avi,944,16,1489,0,545,2
0X1F016C2C0B4EC219.avi,807,119,1169,103,362,2
0X1F042F557F67EF0C.avi,1819,77,1946,60,127,2
0X1F0B89ADC5D08D7B.avi,750,47,1106,32,356,2
0X1F0E003D44A08AC1.avi,1497,127,2204,105,707,2
0X1F110BEB95539840.avi,1318,61,2126,45,808,2
0X1F129E3C07702D2D.avi,1170,115,1942,98,772,2
0X1F147D6EB6F7A33E.avi,1068,80,1774,59,706,2
0X1F16283D4711432A.avi,958,119,1535,145,577,2
0X1F167F8B80CBF9E1.avi,944,59,1548,43,604,2
0X1F19C2EE177D0051.avi,793,67,1244,57,451,2
0X1F1B83FF55E4E8.avi,886,20,1515,3,629,2
0X1F1EBF404A2CBB95.avi,1883,113,2154,96,271,2
0X1F1FD906BE4B4E5C.avi,1542,148,1878,130,336,2
0X1F21C6B7573013C2.avi,1139,122,1816,102,677,2
0X1F22C0D0D9D6CEA7.avi,1027,53,1653,36,626,2
0X1F24BEDFA7735AC2.avi,998,57,1494,43,496,2
0X1F2549CEA36F670D.avi,1026,90,1654,73,628,2
0X1F28DD950C91E736.avi,984,158,1466,143,482,2
0X1F295B3610D3C821.avi,1217,90,1539,73,322,2
0X1F296AC6184AEEA2.avi,1075,71,1662,54,587,2
0X1F2DF5CA165B89C1.avi,1668,121,2555,103,887,2
0X1F30E6AC3FE50EE3.avi,945,66,1393,52,448,2
0X1F32D3B154B596AC.avi,794,51,1192,32,398,2
0X1F341EB2BB60BC7E.avi,1272,61,2172,39,900,2
0X1F38A18115D35B80.avi,913,29,1503,5,590,2
0X1F3A4CF3F7A776F2.avi,1279,57,2075,44,796,2
0X1F3FC0C8E6884E5E.avi,1002,88,1672,72,670,2
0X1F4145A50D7D74A1.avi,2367,47,2530,38,163,2
0X1F415D2BD4F791F1.avi,1069,75,1621,58,552,2
0X1F41F0CD400CE121.avi,1198,97,2043,80,845,2
0X1F4449F6E867C79D.avi,1483,138,2428,124,945,2
0X1F5282DEF12F1522.avi,1361,151,1931,135,570,2
0X1F5743D01B9FF8A7.avi,1006,167,1417,149,411,2
0X1F636F27771CFA8A.avi,1352,20,1933,0,581,2
0X1F6E5F98F771906C.avi,746,73,1189,63,443,2
0X1F7368994CBAFA05.avi,1049,52,1661,37,612,2
0X1F73F80777A9A18E.avi,907,141,1416,119,509,2
0X1F7426166F480035.avi,820,62,1239,43,419,2
0X1F76CC06470CA08E.avi,941,49,1481,32,540,2
0X1F7896620951FFD.avi,1049,60,1519,38,470,2
0X1F7984F85C024A44.avi,2386,59,3573,38,1187,2
0X1F7B281D395F60DF.avi,1285,79,1762,66,477,2
0X1F7C341DFC185B04.avi,1380,63,2361,44,981,2
0X1F89A004D9EC9D11.avi,2657,184,3096,160,439,2
0X1F8C3C7F157F3494.avi,1173,76,2051,55,878,2
0X1F8D2F8CEE622FC2.avi,1190,127,1835,106,645,2
0X1F8FD3228136CADC.avi,777,64,1254,48,477,2
0X1F96B3B6851A691F.avi,1845,85,2076,78,231,2
0X1F9747E8DFC8C33F.avi,1549,53,2570,34,1021,2
0X1F97A5C0DC538F71.avi,1081,55,1480,41,399,2
0X1F97C88FCA1837FC.avi,2421,100,3007,81,586,2
0X1F984B05E47C44E8.avi,1060,75,1841,54,781,2
0X1F9860EB836A4AD5.avi,1280,145,1904,129,624,2
0X1F9A2F0F949DA53C.avi,1769,114,2519,97,750,2
0X1F9B2F6750598383.avi,1048,16,1666,0,618,2
0X1F9EC90B561B66F0.avi,876,60,1392,45,516,2
0X1F9F3763AB755914.avi,519,53,1182,35,663,2
0X1F9F7D8AA7E0AD33.avi,1032,72,1651,49,619,2
0X1FA2FD1613FF2ABA.avi,1582,74,2007,51,425,2
0X1FA393110F28F205.avi,945,54,1277,43,332,2
0X1FA69C9259AB1323.avi,1184,73,1684,59,500,2
0X1FAB4A096967CE44.avi,1023,65,1701,51,678,2
0X1FB746B9CC0A2C34.avi,1138,158,1807,143,669,2
0X1FB77879F86A9295.avi,662,129,991,108,329,2
0X1FB83321A4C5E14A.avi,735,105,1176,91,441,2
0X1FBB4B04FD21CFFD.avi,1762,118,2785,103,1023,2
0X1FBF4879584835DC.avi,918,83,980,71,62,2
0X1FC0DB9513AAE7AE.avi,1149,17,1906,0,757,2
0X1FC4816F238B726E.avi,1162,65,1453,49,291,2
0X1FC8B6CD248E1EBF.avi,1142,70,1829,54,687,2
0X1FCFC35D87A5825E.avi,1441,43,2026,29,585,2
0X1FD1C12446296002.avi,2011,74,2489,56,478,2
0X1FD5C7765ED980E9.avi,1117,119,1950,103,833,2
0X1FED7F19EE7790BC.avi,966,76,1294,65,328,2
0X1FEF660F1B027D9A.avi,1412,59,1734,42,322,2
0X1FF11ED3741D6CF1.avi,1101,68,1661,47,560,2
0X1FF210ABA6FAF49B.avi,2035,78,2714,58,679,2
0X1FF2C044D2369B68.avi,1612,76,2441,59,829,2
0X1FF493CD3E1F9556.avi,972,121,1573,104,601,2
0X1FF49A3B7CCE0940.avi,1440,111,2307,93,867,2
0X1FF884B7C72A46E4.avi,1032,56,1501,39,469,2
0X1FF8C2A15819C013.avi,914,106,1494,91,580,2
0X1FF8F1B69E8A6228.avi,990,73,1445,55,455,2
0X1FFB0CA3E357AA3B.avi,1451,152,2293,135,842,2
0X1FFD70185CCC2352.avi,1026,171,1730,150,704,2
0X20044D5F4DB57EBF.avi,1853,91,2267,64,414,2
0X2006B85D0AC90B99.avi,2206,113,3602,97,1396,2
0X2006F373AD037FB0.avi,863,56,1409,43,546,2
0X2007AA7BEEA8CDE9.avi,1105,74,1713,57,608,2
0X2007E059C9C83B68.avi,1630,74,1937,59,307,2
0X200A81BEC98DEB6D.avi,1486,67,1530,81,44,2
0X200BAB1CBCC59B75.avi,1319,16,2074,0,755,2
0X200D2ADC0AAA7F69.avi,994,78,1584,62,590,2
0X2012F90A3894AE6C.avi,972,16,1655,4,683,2
0X2013A055C2ED13B1.avi,1979,18,3577,0,1598,2
0X2018476243B2BF60.avi,1448,62,1909,46,461,2
0X201E550F4D45FA11.avi,995,56,1525,42,530,2
0X20206186C27410.avi,982,79,1571,60,589,2
0X202CB635A3F07205.avi,1472,49,2460,33,988,2
0X20385C07ACB78AD7.avi,1774,14,2913,1,1139,2
0X20398152C6AC9E74.avi,1009,118,1669,95,660,2
0X203B9F42F7B63F18.avi,1059,72,1686,52,627,2
0X203DEFC1AD6C4FE7.avi,962,66,1461,50,499,2
0X2040D80BE038FF72.avi,980,71,1592,62,612,2
0X204572836CA7223E.avi,1722,95,2747,79,1025,2
0X20466440F503CA47.avi,941,71,1377,47,436,2
0X2046744420463941.avi,984,186,1648,170,664,2
0X20498F7A9EEC40.avi,1054,170,1616,147,562,2
0X2049B43FE38C7E52.avi,1102,56,1653,41,551,2
0X204AE811B3916921.avi,1064,155,1455,133,391,2
0X204B7002B426FB64.avi,1060,132,1690,119,630,2
0X204EABEBB4C346A7.avi,1379,133,2109,117,730,2
0X20527C7266CB3D06.avi,888,51,1451,36,563,2
0X20552C24AF1C72AA.avi,1319,99,2088,79,769,2
0X20586B1BD35F38C9.avi,462,86,819,73,357,2
0X205D332D95319E52.avi,1303,57,1858,42,555,2
0X205D43DE6AFEF1E3.avi,1138,83,1690,70,552,2
0X2061466F4B6FF0D6.avi,1227,133,2091,116,864,2
0X2064D5C200087993.avi,1215,81,2167,71,952,2
0X2067611AEB6EAC1C.avi,968,38,1442,27,474,2
0X206AE6EE14B44F6D.avi,755,93,1089,80,334,2
0X206B9304876FB434.avi,956,184,1469,169,513,2
0X206BF720DCA80EDB.avi,973,89,1691,73,718,2
0X20705C8B7253C987.avi,939,128,1377,111,438,2
0X2072849DEB59E522.avi,1097,153,1626,135,529,2
0X2077ABE141A56534.avi,1222,152,2095,135,873,2
0X2078B65A7DEB1F45.avi,1588,14,2666,0,1078,2
0X207D62797D7ADFE5.avi,1911,46,2640,32,729,2
0X208160FB0725991.avi,1246,93,2108,77,862,2
0X20826845F90FE6D.avi,2142,56,3313,40,1171,2
0X208440694FA7807C.avi,803,106,1382,75,579,2
0X2086CBAC9AC36095.avi,921,64,1471,46,550,2
0X208AC63E1BFEB97F.avi,1204,110,1980,94,776,2
0X208ADDBD7BDAEC00.avi,1240,103,2014,87,774,2
0X208AEA64245AEE45.avi,1110,75,1717,54,607,2
0X208BA5FCD6556200.avi,1660,66,2738,44,1078,2
0X208DD67A7E91CA9B.avi,1126,63,1927,45,801,2
0X208F3DC503692577.avi,1018,67,1633,52,615,2
0X208FBB50F39AAF69.avi,730,71,1045,67,315,2
0X209C2DD9B266CEE0.avi,864,156,1391,139,527,2
0X209D282CEC579EA7.avi,1084,61,1685,52,601,2
0X209F758FA6ECB6BF.avi,887,73,1358,62,471,2
0X20A77232EFCBBA15.avi,1867,46,2230,32,363,2
0X20A9585822B9B71D.avi,948,120,1690,107,742,2
0X20AB680B9A6201C2.avi,1060,158,1694,142,634,2
0X20AEF825025712FA.avi,1042,47,1776,32,734,2
0X20B431A11992F8C1.avi,1464,139,2621,121,1157,2
0X20BA6E6EAB935FF.avi,920,62,1592,46,672,2
0X20BF40D7DF972197.avi,1418,72,1730,55,312,2
0X20C138B0C280E0E8.avi,1175,59,2046,44,871,2
0X20C397F012441121.avi,2001,66,2720,49,719,2
0X20C66395A83A2333.avi,860,14,1240,0,380,2
0X20C709BA520B3393.avi,903,65,1112,50,209,2
0X20C87FB09C5485FA.avi,1864,109,2815,89,951,2
0X20DC0F2BB24C0B14.avi,969,187,1542,167,573,2
0X20E2EEBED55F4D49.avi,1050,57,1589,42,539,2
0X20E888D4879745B8.avi,1380,73,2494,58,1114,2
0X20EF6DD108D6DBEF.avi,759,62,1169,81,410,2
0X20F0ECA9A407E292.avi,1584,143,2820,128,1236,2
0X20F33082C8E339A5.avi,1096,81,1743,65,647,2
0X20F3D05837705ED2.avi,1640,72,1960,60,320,2
0X20F915FF0D48F7B1.avi,952,127,1722,111,770,2
0X20FA1B615696ED4E.avi,850,66,1366,48,516,2
0X20FAB502219482F3.avi,1078,72,1777,51,699,2
0X20FB855B93C178FB.avi,1244,86,1635,69,391,2
0X20FC953931845AED.avi,1186,92,1401,71,215,2
0X20FDE60EA17CDF97.avi,1158,154,1843,138,685,2
0X210265FBDA5360AE.avi,1392,94,2039,78,647,2
0X210582D0841E845.avi,1342,47,1725,31,383,2
0X2109CB4DF22133B8.avi,973,64,1479,48,506,2
0X210C7A32E968D801.avi,1483,152,2168,136,685,2
0X210DAE04842ABFCE.avi,1037,77,1590,57,553,2
0X210F9921E31032AF.avi,985,55,1404,40,419,2
0X210FD939B1583C4.avi,2016,61,3296,44,1280,2
0X2119E364C4EB41A5.avi,1176,165,2320,136,1144,2
0X211D307253ACBEE7.avi,1104,94,1123,86,19,2
0X211D82BA9236CDCB.avi,1854,94,3061,75,1207,2
0X212800138BB39A54.avi,1214,58,1798,44,584,2
0X2128420519D139AC.avi,1154,65,1803,49,649,2
0X212CA9670262F815.avi,928,60,1564,46,636,2
0X21308CC313DC6218.avi,1487,63,1750,48,263,2
0X21335091E8EAB9E7.avi,1511,143,2608,122,1097,2
0X21335E5666FE334.avi,1059,68,1996,55,937,2
0X2137CC12E6EBD1F9.avi,1849,80,2097,66,248,2
0X2138256B8ACBC286.avi,728,66,1132,49,404,2
0X213B9075196791A5.avi,964,56,1446,37,482,2
0X2142A8069D0CEE3E.avi,1275,111,1741,99,466,2
0X2149046928524ECA.avi,955,50,1461,36,506,2
0X21494E0B4F352AA.avi,795,63,1397,50,602,2
0X214C1C219A70B853.avi,1518,18,2487,2,969,2
0X21586B809CFC96DF.avi,1207,135,1776,113,569,2
0X215A85593D22E6F0.avi,799,181,1304,156,505,2
0X215CFDA8D8E99821.avi,1197,107,1513,93,316,2
0X215F0AEFF802A568.avi,584,50,948,36,364,2
0X215F900F6CB6C95A.avi,3560,113,3867,97,307,2
0X216C953D364C7BE5.avi,1027,77,1597,58,570,2
0X216DCC8A21950E6E.avi,1413,120,2646,105,1233,2
0X216E6AFF3D3589CD.avi,1187,69,1677,58,490,2
0X21753A275A66C4B5.avi,1686,79,2409,60,723,2
0X21764955637F610E.avi,1168,25,1904,2,736,2
0X217799C2838B5023.avi,2272,67,3752,58,1480,2
0X21780197024E9D79.avi,1804,76,2489,61,685,2
0X2178C7825C058A65.avi,1384,49,1633,37,249,2
0X21797862231FE398.avi,1870,147,2560,129,690,2
0X217B4E9C7EA72B72.avi,962,14,1161,4,199,2
0X217DA0FD15274A38.avi,900,49,1340,32,440,2
0X217EB21B6C3068DF.avi,822,66,1361,48,539,2
0X218383A7F84BD283.avi,1227,81,1942,68,715,2
0X2183CED6963429F7.avi,1619,17,2234,3,615,2
0X21861CDBBA5F5D9D.avi,963,75,1676,53,713,2
0X218BD0C4F2E153B7.avi,1069,21,1326,6,257,2
0X218C389768E6BEEF.avi,1186,61,1598,46,412,2
0X218E4B013739DD05.avi,1139,75,1777,56,638,2
0X2190CC524D8A3203.avi,1266,141,1927,124,661,2
0X21911F001AA82BCD.avi,857,74,1175,63,318,2
0X2193B0208A4BD2C5.avi,863,89,1618,73,755,2
0X21957D70CCDCA50C.avi,1162,125,1678,106,516,2
0X219A42DE14521E3.avi,1752,93,2883,72,1131,2
0X219B35DD01D6562B.avi,869,67,1322,49,453,2
0X219CD2BA2C006453.avi,1356,54,2265,40,909,2
0X21A13B095CACF0EB.avi,1060,59,1582,44,522,2
0X21A4FF7D4640E7FC.avi,1104,40,1838,27,734,2
0X21ADDDA989F95D59.avi,1039,109,1614,91,575,2
0X21B24F2764DE564E.avi,1584,90,2184,72,600,2
0X21B497B1AE639C14.avi,1074,70,1805,59,731,2
0X21C7B32102269C4F.avi,737,113,1186,100,449,2
0X21C7FD7003B44572.avi,1061,16,1911,0,850,2
0X21D68178D7E68FF6.avi,959,108,1556,96,597,2
0X21D75884E9572691.avi,634,46,880,33,246,2
0X21D7E54015D4F60.avi,1402,74,2196,58,794,2
0X21D8A9341F567E31.avi,1082,99,1623,84,541,2
0X21DB11780A6A35EE.avi,1407,53,2318,38,911,2
0X21E16CBE16849CF8.avi,1300,50,2030,37,730,2
0X21E519C28BC94C65.avi,835,50,1381,35,546,2
0X21EB8F540A5C436D.avi,1136,76,2086,57,950,2
0X21ECA17BDAB1F437.avi,1096,59,1720,45,624,2
0X21F0FCA4D0ED4E27.avi,963,52,1545,38,582,2
0X21F20E41517158AB.avi,1037,101,1756,89,719,2
0X21F489F4F5523D94.avi,1158,66,1802,49,644,2
0X21FF36E89AF42A54.avi,1093,107,1779,89,686,2
0X2205F4A252993508.avi,808,72,1346,53,538,2
0X220A95C40078BCFC.avi,910,70,1585,51,675,2
0X22152A575B5662D1.avi,980,70,1508,52,528,2
0X2216131AF6AC3FC7.avi,962,120,1541,104,579,2
0X22164FE4DE644483.avi,919,72,1448,55,529,2
0X2217DF2C04B344B9.avi,849,62,1369,44,520,2
0X221A17B6FD89EDA9.avi,1554,70,1974,56,420,2
0X221C260D3C7960DD.avi,1096,105,1605,90,509,2
0X221D4FD030661C63.avi,1835,94,3007,76,1172,2
0X2223897D4CA9FE1.avi,1240,86,1724,60,484,2
0X22241B85FF21816D.avi,1333,169,1785,152,452,2
0X22273DBF5B7AA460.avi,1892,18,3125,3,1233,2
0X222A58FCB3875364.avi,2475,86,3128,66,653,2
0X222D850B21C1CBBF.avi,1032,85,1735,77,703,2
0X2230D32DA2165960.avi,1765,64,2841,47,1076,2
0X223201B0F37DA3E1.avi,1361,89,2099,77,738,2
0X22390EC6147E56F5.avi,1143,121,1883,106,740,2
0X223C255E3659DD3A.avi,847,69,1173,53,326,2
0X223CC1A7091C8635.avi,1238,165,1879,150,641,2
0X22449C227AD0E5AF.avi,1185,159,1998,136,813,2
0X2245EF882F5AED68.avi,1014,59,1513,43,499,2
0X2246E1E4611257EA.avi,882,77,1485,56,603,2
0X224BAB7B84F593AE.avi,1137,56,1809,39,672,2
0X224BF576A2C34B1D.avi,1921,90,2782,63,861,2
0X224D087937470C14.avi,969,50,1282,40,313,2
0X224D7364FF5B803.avi,1192,74,1829,57,637,2
0X22516F1CC1E029EB.avi,1077,71,1637,58,560,2
0X2256C847305993D3.avi,1352,24,1897,6,545,2
0X225D461E61753EF7.avi,921,164,1391,144,470,2
0X2265B34908346F7E.avi,907,136,1445,116,538,2
0X2267236AA0B2C189.avi,1031,68,1505,51,474,2
0X226BDFC5918616F2.avi,876,76,1384,60,508,2
0X226CCBEB90960018.avi,1281,122,2309,105,1028,2
0X226F346724BCAD71.avi,1165,148,1799,133,634,2
0X226FC5A7CCB38B74.avi,881,65,1345,49,464,2
0X22720172531FD8E2.avi,775,130,1163,118,388,2
0X227A9B835F6F73F7.avi,1250,143,1947,125,697,2
0X227BA4CE78376983.avi,1184,91,1842,79,658,2
0X228402F6221FD034.avi,895,58,1353,42,458,2
0X228D178D820A29A2.avi,1332,57,1999,41,667,2
0X229107A87184B05E.avi,1574,139,2527,117,953,2
0X2293D93BECAE2E77.avi,931,59,1597,45,666,2
0X2295D5A3C8F9AF68.avi,1501,89,2575,71,1074,2
0X229B538A0319227C.avi,1106,55,1692,40,586,2
0X229F4D6D9E97CF7.avi,1343,97,2190,80,847,2
0X229FA19806028FBF.avi,936,58,1611,41,675,2
0X22A1A8A656653343.avi,1082,90,1928,78,846,2
0X22A224A7045E469A.avi,2117,60,3427,41,1310,2
0X22A4930668E3B1F4.avi,1796,136,3195,116,1399,2
0X22A5FF0B68B27499.avi,1462,93,1876,75,414,2
0X22A6C58CDE4CB622.avi,800,71,1190,55,390,2
0X22A6E3420279C25.avi,1254,90,2108,71,854,2
0X22A8C16F3DEDC047.avi,741,65,1096,50,355,2
0X22A9B6ECBD591065.avi,1021,153,1727,140,706,2
0X22ABDF6856E47639.avi,1315,53,2400,37,1085,2
0X22AE2280530D5513.avi,615,9,961,0,346,2
0X22AEF55BDD1858B1.avi,1511,95,2570,76,1059,2
0X22B5C22119402EFA.avi,1014,123,1644,105,630,2
0X22B62786C6D09449.avi,1365,56,2264,40,899,2
0X22BD7BADB8F9E8E8.avi,779,57,1225,42,446,2
0X22BD87DACA8C3D21.avi,1241,56,2025,40,784,2
0X22BDBD4B2C8D42AC.avi,1656,62,2243,46,587,2
0X22BDBF9811758CD2.avi,1013,48,1414,32,401,2
0X22BEF985FFBEE221.avi,1172,133,2039,112,867,2
0X22C104757C7FC3AA.avi,1060,81,1838,74,778,2
0X22C1D803B10F7071.avi,1962,97,2328,81,366,2
0X22CA1F004555C1BA.avi,739,151,1117,135,378,2
0X22CC169C12A93C2A.avi,1783,75,3132,53,1349,2
0X22D0F8CEA2D21C2D.avi,2161,114,2406,100,245,2
0X22D1F7E6B6953628.avi,1548,54,2168,39,620,2
0X22D2668EC8BB8C20.avi,1365,85,2072,67,707,2
0X22D7FDCF2827269E.avi,762,112,1143,97,381,2
0X22DB24EB0B914163.avi,1244,151,1921,132,677,2
0X22DC2377CAE4D754.avi,1350,18,1721,0,371,2
0X22DD6BCF1DE33B89.avi,1663,60,1943,51,280,2
0X22E82C3D081C819C.avi,1170,105,1479,88,309,2
0X22E91BA7334F8292.avi,1662,98,2612,68,950,2
0X22E9ABEF19984B09.avi,973,84,1626,69,653,2
0X22EEBC2819EE606D.avi,1094,53,1675,35,581,2
0X22F116501001DB14.avi,1818,152,2441,132,623,2
0X22F64BF092575F44.avi,1527,65,2694,50,1167,2
0X22F81F24E8B0741C.avi,1593,48,2777,33,1184,2
0X22FA972EE22D2F30.avi,987,20,1453,0,466,2
0X22FAC36B13D3526C.avi,1363,19,1833,2,470,2
0X22FE585B9B3A0ECB.avi,1504,50,1792,39,288,2
0X2307097BE78FA04F.avi,1670,45,3016,32,1346,2
0X2307127FC335FF07.avi,981,70,1627,52,646,2
0X2308E2752F913346.avi,917,41,1431,28,514,2
0X230ECEDF5353B79D.avi,854,61,1511,44,657,2
0X230F00FD0DF5D71C.avi,917,96,1599,82,682,2
0X23109C0554A16C8F.avi,778,15,1307,1,529,2
0X2311252C422D2782.avi,1684,110,3008,94,1324,2
0X23138B9CCE9AA1D0.avi,846,121,1301,110,455,2
0X23178A65C1003DE7.avi,1144,14,1929,2,785,2
0X231C7BD210366D86.avi,1672,135,2332,116,660,2
0X232094B1E30C45E1.avi,1730,74,2687,59,957,2
0X232232E2699FD6BB.avi,1456,134,2137,114,681,2
0X23229F0B64DC9FAE.avi,1127,53,1670,41,543,2
0X2324CDAF976E078E.avi,1742,187,2658,164,916,2
0X2324EE43744E214C.avi,1313,46,2300,33,987,2
0X232567AC545F3F3D.avi,1249,72,2129,56,880,2
0X23261A4B1EEB9DE9.avi,925,95,1520,79,595,2
0X2326F92D1F6B4980.avi,804,55,1216,39,412,2
0X232B95105F8D700C.avi,764,72,1283,58,519,2
0X232D295076A40924.avi,802,97,1357,83,555,2
0X232DAB0AE399625D.avi,824,81,1339,63,515,2
0X232E3FFDB1D666B0.avi,857,100,1401,85,544,2
0X23316DEB7389A3CF.avi,1666,52,2111,26,445,2
0X233503BE5DE4C30F.avi,908,67,1272,44,364,2
0X2335AA783BB18BF9.avi,772,59,1194,43,422,2
0X233DCAFBF90253C7.avi,2020,67,2423,54,403,2
0X233E8DAD9CD641F2.avi,1393,122,2142,103,749,2
0X233F896CE9F42E51.avi,1325,120,1719,100,394,2
0X233FA49D8921EEF4.avi,1055,115,1654,102,599,2
0X23404EE09A063C6B.avi,935,52,1368,35,433,2
0X23419AB4EA378B47.avi,1587,14,2403,4,816,2
0X234453BC01C1F830.avi,998,69,1588,55,590,2
0X2349279AD743CF2B.avi,1713,62,2462,53,749,2
0X234D7576D2E85005.avi,1830,137,2467,123,637,2
0X234DDA5BD6618265.avi,930,65,1383,50,453,2
0X234F388F6AF6AC9C.avi,1279,69,1936,52,657,2
0X235318E55D1F73EC.avi,2917,62,4705,47,1788,2
0X23562CFC0E7E956B.avi,1101,117,1783,107,682,2
0X2359BC3D3CC007E.avi,1240,93,1867,77,627,2
0X235CC08DFD8EFC4E.avi,1411,61,1908,45,497,2
0X23646D0D797339F6.avi,840,111,1177,89,337,2
0X236567224F84C1A3.avi,643,18,1027,3,384,2
0X2366DB553504817A.avi,1639,103,2513,85,874,2
0X2367EA1E168596C6.avi,2302,147,2754,133,452,2
0X236A602C00A2312.avi,1731,15,2045,0,314,2
0X237A158C025A28E5.avi,1395,104,2339,91,944,2
0X237C76B2D575785D.avi,1994,114,2194,103,200,2
0X237F8C7FF6BB577F.avi,1873,132,2921,121,1048,2
0X2382898F68207D7F.avi,973,86,1438,71,465,2
0X23835D19C3DBFE2E.avi,1346,163,2326,149,980,2
0X2387300342812F85.avi,1104,84,1779,68,675,2
0X238824F40F11736F.avi,1117,18,1705,3,588,2
0X238ADF5CF8E3E97.avi,1427,95,1664,83,237,2
0X238CEE1A57B1D64E.avi,1299,87,1906,63,607,2
0X238D16678F01A823.avi,2463,118,2834,103,371,2
0X2392EF0E06DB21B5.avi,1018,57,1280,42,262,2
0X239CB1C46AEDDF00.avi,992,143,1601,116,609,2
0X239D1851C8D6BE09.avi,644,41,988,34,344,2
0X239FC841AB0C17DD.avi,1139,75,1796,55,657,2
0X23A08B6B1959FCC5.avi,1939,17,2952,0,1013,2
0X23A2F3EB82C3709B.avi,1383,76,1931,57,548,2
0X23AA500225C0E94E.avi,1085,82,1426,66,341,2
0X23AC249A5A6612D9.avi,2016,100,2694,85,678,2
0X23B1641319A2AFA2.avi,1145,66,1908,50,763,2
0X23B883A39F37F8D9.avi,3020,176,5711,160,2691,2
0X23BA55335A3F3F42.avi,759,66,1281,47,522,2
0X23BC106BDEB75F2B.avi,1281,61,1945,41,664,2
0X23C1AA2F97BCD568.avi,1067,92,1677,78,610,2
0X23CA5B856231EF59.avi,968,77,1674,53,706,2
0X23CC21A0B9FBE97.avi,960,139,1606,124,646,2
0X23CC74B76656533F.avi,900,72,1472,53,572,2
0X23CF63A0B3106979.avi,986,17,1477,4,491,2
0X23D1957D8639581F.avi,1376,68,1725,48,349,2
0X23D40A4C6D379CF7.avi,1008,107,1674,88,666,2
0X23D6C6323D56B730.avi,878,111,1410,99,532,2
0X23D7360CB2EF9A53.avi,1217,61,1596,43,379,2
0X23DF57D03E5E2F9B.avi,806,44,1336,31,530,2
0X23DFED26C5A53775.avi,1132,80,1784,69,652,2
0X23E4915490598D1F.avi,1041,114,1588,95,547,2
0X23E619A8A8C3736C.avi,1599,59,2255,29,656,2
0X23E63ABC87C2E515.avi,1514,53,2605,37,1091,2
0X23E98D02C1B728A0.avi,1150,59,1600,41,450,2
0X23EB7A832C5D533D.avi,1511,104,2477,85,966,2
0X23EBAF193699CC69.avi,2117,151,3372,132,1255,2
0X23F29235EC216628.avi,1522,106,2057,85,535,2
0X23F4B52E8588E2AD.avi,1215,212,1859,191,644,2
0X23F7E889AEC65CC6.avi,1444,71,2372,55,928,2
0X23F8FB36ACE98145.avi,945,18,1411,3,466,2
0X23FAB252614B31A.avi,850,128,1414,110,564,2
0X23FCF45E798060D0.avi,2015,187,3085,148,1070,2
0X240DC6905435E17B.avi,1131,55,1611,38,480,2
0X240E0BC8345AB153.avi,1559,73,2648,54,1089,2
0X241057582EE5420E.avi,1169,64,2153,55,984,2
0X2411B3C3F8748A26.avi,897,110,1517,91,620,2
0X2414B3661FDBF9C3.avi,977,61,1664,43,687,2
0X241E08BD87DD9251.avi,990,113,1709,99,719,2
0X241F39470B521282.avi,1106,68,1739,53,633,2
0X2427A56346ED7F61.avi,1460,134,1909,116,449,2
0X242B658934E3E2AE.avi,1081,110,1609,93,528,2
0X242CB7F150E2C5AA.avi,742,76,1123,60,381,2
0X2430FD0356057728.avi,2217,125,3163,104,946,2
0X2432016D32614048.avi,611,85,1132,72,521,2
0X24337F79C53AD299.avi,968,96,1352,77,384,2
0X24346E6B95219B70.avi,1379,132,2294,118,915,2
0X24362254069DD61B.avi,502,79,805,63,303,2
0X2439B4EB7F068E2A.avi,1114,90,1628,75,514,2
0X2439D556A91476D3.avi,1126,69,1771,52,645,2
0X243C32CAE420170B.avi,2439,107,2995,91,556,2
0X243FDE8AE0A05B6F.avi,2129,113,2572,98,443,2
0X24429BE93EA20EA0.avi,899,16,1434,4,535,2
0X2445E24972D9082C.avi,1145,18,2129,2,984,2
0X244B43804C53EDB1.avi,1406,99,2341,80,935,2
0X244C21A1DE9C2E9B.avi,925,18,1577,2,652,2
0X244C8BF642C90DA7.avi,1343,205,2289,185,946,2
0X244CAB3550320216.avi,1414,209,2423,191,1009,2
0X244FC0ACE784DDF8.avi,853,101,1374,84,521,2
0X245274A42C2D825.avi,874,144,1516,131,642,2
0X24543F8B04D98E65.avi,1168,135,1522,123,354,2
0X245BB0CA4EA502B6.avi,812,63,1254,46,442,2
0X24609A701DBC258E.avi,1664,63,2462,48,798,2
0X2461DF4B5870DBC4.avi,1521,50,1749,38,228,2
0X24669F82F91D85C9.avi,850,48,1354,33,504,2
0X246B8C7FCA4D818D.avi,975,50,1463,37,488,2
0X246D33ADC0084497.avi,1027,70,1683,55,656,2
0X246D58B781EFA3A2.avi,776,71,1239,55,463,2
0X24708E2D3F05391F.avi,1042,149,1656,133,614,2
0X2478857A75A6F4E7.avi,867,73,1393,56,526,2
0X247B5634CCC3377C.avi,860,79,1294,60,434,2
0X247FC8D31B4E44B7.avi,1120,81,1845,61,725,2
0X248229014E7A20A9.avi,1732,53,2821,35,1089,2
0X2485A9135A333814.avi,1319,78,2085,57,766,2
0X24889AD4250280C9.avi,2871,162,3256,146,385,2
0X2489A40319D6990E.avi,877,110,1248,92,371,2
0X2490B0F4C6B72FD2.avi,1702,82,3167,73,1465,2
0X2492BC93BE9264ED.avi,1217,51,2100,40,883,2
0X249901C1E8BF28AA.avi,1110,120,1915,106,805,2
0X2499AD2830EAF683.avi,1079,57,1827,45,748,2
0X249FE2498B57B632.avi,1015,117,1513,106,498,2
0X24A8A07492EDC214.avi,1227,72,1960,53,733,2
0X24ADF09C5E5972E0.avi,989,41,1351,32,362,2
0X24B3D97148F6484B.avi,1097,99,1742,83,645,2
0X24B3DECAE59D63C9.avi,1097,69,1625,54,528,2
0X24BC1D83B332BEB6.avi,818,82,1293,67,475,2
0X24BE53A4193FF10D.avi,769,172,1259,154,490,2
0X24C05ADF764D0216.avi,976,116,1414,101,438,2
0X24C20970C045D12E.avi,980,66,1594,49,614,2
0X24C59DA367132337.avi,1395,39,1488,25,93,2
0X24C8EA32354AEA68.avi,2077,88,3455,76,1378,2
0X24C9CCB070DF24A2.avi,1028,66,1431,48,403,2
0X24D4438DC51DFA0E.avi,913,85,1204,71,291,2
0X24DB1B4036794813.avi,1352,88,2376,73,1024,2
0X24DB845BE8C32224.avi,1363,57,1993,44,630,2
0X24DBD52BC75C4180.avi,1104,19,1578,4,474,2
0X24DCAB4C07F1AD8D.avi,936,68,1288,55,352,2
0X24DDDEF00414EBC9.avi,1084,47,1713,28,629,2
0X24DEA0FED8614873.avi,2147,140,2479,107,332,2
0X24DFAB969E9BD3E0.avi,1782,128,3066,107,1284,2
0X24DFC8851585B0DD.avi,1704,91,2484,77,780,2
0X24E187AB50EC7783.avi,1514,31,3013,19,1499,2
0X24E87BD3601FCACD.avi,1872,17,2719,2,847,2
0X24EA617BDDDE90F7.avi,1636,90,2002,73,366,2
0X24EE7C86ABF22F86.avi,1730,106,2527,90,797,2
0X24EFBC61D076595F.avi,1870,104,2513,90,643,2
0X24F61C272DE6EE2C.avi,1098,101,1546,90,448,2
0X24FD10BD50809882.avi,1432,93,2256,75,824,2
0X24FE367014EDA4DD.avi,1154,79,1745,57,591,2
0X24FEF7D294B35A5B.avi,1696,59,2793,45,1097,2
0X250244FCEBCBC052.avi,820,115,1183,108,363,2
0X2505AECEA36CF52.avi,825,93,1271,78,446,2
0X25067F9AEA265A46.avi,990,60,1514,49,524,2
0X2507255D8DC30B4E.avi,1689,100,2885,0,1196,2
0X250C2239FCD3BC30.avi,1872,157,3237,138,1365,2
0X250C34BB262848FB.avi,831,66,1420,50,589,2
0X25153E9120D31CC8.avi,2822,84,4516,70,1694,2
0X25167816F5C51BF9.avi,1145,119,1632,105,487,2
0X2516D09AA3CCE8BD.avi,1535,100,1827,80,292,2
0X25189F2E27A7255B.avi,1127,134,1836,112,709,2
0X251EDDF07FB24ACF.avi,1097,62,1634,43,537,2
0X251F4272F05D83ED.avi,948,50,1543,37,595,2
0X252021CE18C83D44.avi,1242,57,1636,42,394,2
0X25207D09933DFD43.avi,841,68,1350,51,509,2
0X2520973CB1749031.avi,2098,57,3738,40,1640,2
0X252C6960C9AF4343.avi,851,71,1471,52,620,2
0X252E1DC0C5961D6C.avi,1312,53,1894,42,582,2
0X25300D8E61A12BC1.avi,1155,68,1568,50,413,2
0X2532193930C4999E.avi,1684,71,2684,53,1000,2
0X253BCEAF26478E57.avi,1383,15,1605,0,222,2
0X253C4E380393A2D2.avi,1371,63,1999,52,628,2
0X253C90A225AEF537.avi,1200,116,2007,99,807,2
0X2540790A197DB384.avi,1177,100,2088,75,911,2
0X2542AA1A14E87A14.avi,1493,116,2507,97,1014,2
0X2544717E45506688.avi,1310,117,1983,101,673,2
0X2546A823617AE567.avi,826,57,1303,42,477,2
0X2549CEDB5C42998D.avi,1905,98,2563,81,658,2
0X254ABDAB4EA3EDF1.avi,1127,15,2120,2,993,2
0X254E038B4BBEA091.avi,1478,77,2629,64,1151,2
0X254E359564F8F57B.avi,971,96,1550,84,579,2
0X254EAC7CF9705B92.avi,846,64,1268,49,422,2
0X25522AD7521D4273.avi,1311,127,1755,112,444,2
0X2553AFE4965ECA1E.avi,972,70,1634,51,662,2
0X25553AEB1C8D0B7D.avi,1258,84,1952,61,694,2
0X2558A02B9C207AB7.avi,1036,53,1558,36,522,2
0X255B6F7F23189FC3.avi,1199,105,1971,86,772,2
0X255CF282AD77EF.avi,1000,66,1514,57,514,2
0X255D1BAE852D2D09.avi,976,53,1561,37,585,2
0X256237754531D2A2.avi,1002,16,1532,3,530,2
0X25624BE57690EB19.avi,998,69,1583,53,585,2
0X2564F370E5D14459.avi,1067,69,1775,53,708,2
0X25651736878239CE.avi,942,78,1518,61,576,2
0X2566A541FE945277.avi,858,63,1233,45,375,2
0X25698E5F54BE0698.avi,1188,16,2126,3,938,2
0X256A9030D9AB77FD.avi,1112,17,1658,5,546,2
0X256B5ADEF784F5FA.avi,1161,119,2105,104,944,2
0X256B964D43ED2F4C.avi,2103,66,2702,49,599,2
0X257DBA22CD382E13.avi,1018,65,1735,49,717,2
0X257E206A79A1586C.avi,820,100,1421,81,601,2
0X257EF0B5775B242F.avi,1547,60,1822,44,275,2
0X2584F54C17C798FF.avi,600,90,818,78,218,2
0X258CC502191AF4EC.avi,958,51,1629,36,671,2
0X25907540CCAE26A4.avi,1105,88,1774,71,669,2
0X259464E770C6A619.avi,1517,80,1697,68,180,2
0X25964FF07BC01F9F.avi,1634,63,2440,42,806,2
0X2596A4518C3B0F1D.avi,1250,146,2031,128,781,2
0X2596D75079E57033.avi,1506,128,2387,113,881,2
0X259876A5AE3180F9.avi,1205,71,1974,54,769,2
0X259BD7856D76C702.avi,1282,57,2252,41,970,2
0X259C94B50AFAD96B.avi,1164,76,1435,65,271,2
0X259CB75B5D7E779C.avi,1020,173,1427,153,407,2
0X259CBD1FA6358DC.avi,1414,70,2246,51,832,2
0X259D527FD2BEAECD.avi,2009,51,2404,33,395,2
0X25A6935E6A8C35CD.avi,865,70,1278,51,413,2
0X25A6EA066D812683.avi,1572,60,1973,40,401,2
0X25A7456549F3C925.avi,959,65,1521,46,562,2
0X25A8434F6D4F2256.avi,1179,181,1979,158,800,2
0X25B0A5E678CC4D13.avi,1168,108,1846,92,678,2
0X25B9B8065140E94A.avi,1247,120,1542,102,295,2
0X25BD4EC399A57695.avi,661,14,1461,0,800,2
0X25BF7A8880B7E925.avi,1046,81,1243,66,197,2
0X25C020CCF59979A4.avi,1622,71,2594,52,972,2
0X25C4CF4384EAA0FA.avi,1280,103,2187,87,907,2
0X25C5D78648D39291.avi,1682,20,2748,1,1066,2
0X25CB97C76159F8E9.avi,1279,113,1738,96,459,2
0X25D144CE38BAC3B5.avi,1095,106,1725,86,630,2
0X25D1BFBDD75BFAAE.avi,774,120,1365,106,591,2
0X25D22CAAFC2F06F2.avi,1874,73,2675,56,801,2
0X25D27D50A4C85F88.avi,1148,173,1838,159,690,2
0X25D3F22462D32922.avi,852,63,1419,47,567,2
0X25D630E0245B8D8.avi,746,43,1356,30,610,2
0X25D970C75A57B3F2.avi,1026,16,1430,0,404,2
0X25DD6BFF7103EB50.avi,1162,71,1843,53,681,2
0X25E1A2FEB38D5C1A.avi,1015,65,1570,44,555,2
0X25E3D9E8E02E9F8C.avi,1387,60,2128,44,741,2
0X25E51194DDD25625.avi,1546,107,2416,96,870,2
0X25E65648D14CF132.avi,1703,182,2576,162,873,2
0X25EA04C3BB5BD73A.avi,793,138,1200,126,407,2
0X25F3ABD0BC56E0FC.avi,1423,125,2302,109,879,2
0X25FDAC4206518E5D.avi,1868,84,3198,64,1330,2
0X260124F79F295A76.avi,1964,79,3172,62,1208,2
0X260767549892A590.avi,1520,14,1891,0,371,2
0X260789ADF320D4F8.avi,1466,23,2231,2,765,2
0X2608D27FDE98149F.avi,1143,55,1708,38,565,2
0X260C36268AE552EB.avi,1116,123,1845,111,729,2
0X260C383010AEF14B.avi,2352,108,3090,91,738,2
0X260D4D63B7684BDD.avi,1605,90,1814,75,209,2
0X2617EE50F758E3C5.avi,1573,61,1926,45,353,2
0X26206D5594CF7FB2.avi,1982,84,2359,71,377,2
0X2620ED756670917C.avi,1261,64,2177,49,916,2
0X26253C5173D9E765.avi,1247,75,1956,59,709,2
0X262735F84D104CDD.avi,1530,80,2409,63,879,2
0X262D48995AF25D8D.avi,1464,62,2606,46,1142,2
0X262EA10B2898736E.avi,1295,65,1868,56,573,2
0X2630F7B1E8035F5B.avi,1511,117,1807,102,296,2
0X2635B9BFE175C8E4.avi,1053,66,1611,45,558,2
0X263A95AED78DF1B2.avi,1044,20,1823,0,779,2
0X263BDA8DEDBBDBAA.avi,1196,73,1771,55,575,2
0X263C6A56C2FAA248.avi,739,54,1259,37,520,2
0X2641B2DB74DE3FF1.avi,980,35,1584,24,604,2
0X26444E1ACD4FE90F.avi,1000,69,1537,55,537,2
0X2649959DDB6CA52B.avi,903,58,1482,46,579,2
0X264B6A93D7EE624A.avi,1677,23,2238,3,561,2
0X264C65C2ABBD368.avi,1211,91,1947,73,736,2
0X264CFB8943A84B48.avi,919,42,1426,30,507,2
0X264FE9E65AF38F05.avi,1433,31,2112,5,679,2
0X2651CD8338B30EB.avi,1011,123,1505,107,494,2
0X26549E8D48ABC8DC.avi,1039,68,1455,55,416,2
0X2654E4234D69980A.avi,1025,74,1617,58,592,2
0X265A95FC3A21FE5.avi,1248,65,1833,48,585,2
0X265D6BCE92090FFC.avi,1037,81,1552,59,515,2
0X265F7C106F4A0B62.avi,1719,53,2540,36,821,2
0X2660492955910B85.avi,1363,53,1821,38,458,2
0X26626AAEFAAEEC0.avi,1066,13,1834,0,768,2
0X26635CBAB84870AA.avi,877,143,1465,127,588,2
0X2665FA8EF7EEDA20.avi,1241,102,1997,86,756,2
0X266AD7E3C2CC1BE.avi,969,60,1602,46,633,2
0X266D751D516B1711.avi,1862,184,2932,163,1070,2
0X267065C982C08D41.avi,1383,109,2139,89,756,2
0X2670CCCA311E7C7D.avi,1885,108,3080,92,1195,2
0X2671B367BF1DBB8B.avi,1142,126,1836,105,694,2
0X26760E1AE0AA7123.avi,901,57,1415,42,514,2
0X2676C392F6C80EBD.avi,1410,16,2146,4,736,2
0X267B31C01341EDBA.avi,1610,65,2303,46,693,2
0X267E2148259DAA74.avi,669,67,1047,53,378,2
0X267E5D3B36A34A6C.avi,1408,49,2126,31,718,2
0X26804C474CA9671C.avi,1440,41,2213,31,773,2
0X268D722E60E6E7EC.avi,1836,102,2971,87,1135,2
0X26902A58F384934F.avi,668,16,1065,2,397,2
0X2694F675274D5ED6.avi,983,75,1526,57,543,2
0X2698E0A4C8C7777C.avi,1143,96,1782,79,639,2
0X269BDCE2A6A294AB.avi,1185,69,1789,55,604,2
0X26A12BDA55DE0DDE.avi,1637,90,2035,75,398,2
0X26A8F239F3777D92.avi,1740,52,1948,35,208,2
0X26A955191AA5D386.avi,751,137,1184,119,433,2
0X26ABE39755AB6CA8.avi,883,62,1338,49,455,2
0X26AC778A988D76C1.avi,1167,87,1917,69,750,2
0X26ACBFDFA9C147C6.avi,892,49,1470,36,578,2
0X26B10F18D3BA321B.avi,1044,20,1699,1,655,2
0X26B209C0083A4AD5.avi,1561,56,2155,41,594,2
0X26B4D2AD6ECD2F2.avi,1276,65,1819,45,543,2
0X26B75629377907FA.avi,1819,105,2128,92,309,2
0X26BCB772A8DD9BEC.avi,1934,55,2820,38,886,2
0X26C216A513F3EE72.avi,652,61,929,48,277,2
0X26C6F8397D6EC0.avi,1343,133,2197,120,854,2
0X26C7FACA5C9DFA73.avi,996,82,1263,68,267,2
0X26C9C9504E3472BC.avi,1381,60,1833,46,452,2
0X26CCB26A138F5904.avi,1398,65,2404,42,1006,2
0X26CCD2B933FE44D1.avi,943,115,1403,100,460,2
0X26CD1BC6C11A3861.avi,714,58,1159,42,445,2
0X26CF0F0BCD885F65.avi,1494,23,2459,4,965,2
0X26DC58E11003BCA1.avi,1351,97,2054,83,703,2
0X26DCA2BE77293D2D.avi,1040,66,1367,55,327,2
0X26DCCCBC2614214.avi,1489,61,2184,45,695,2
0X26DD260B02C5900C.avi,952,53,1672,42,720,2
0X26DDEAE1C3A6A05.avi,990,110,1604,100,614,2
0X26E20CDE56AEEAF3.avi,1269,20,2106,4,837,2
0X26E2492AD4BD86A9.avi,1205,60,2029,46,824,2
0X26E286395968E8C2.avi,911,47,1565,34,654,2
0X26E3E2CF4D4EC82B.avi,1680,100,2484,81,804,2
0X26E6C7FBCBD4AB54.avi,1244,21,1999,1,755,2
0X26EA0A49954B4816.avi,1185,66,1874,51,689,2
0X26EB82C1481E10E7.avi,894,49,1456,35,562,2
0X26EBEDBF286CD649.avi,716,113,1070,97,354,2
0X26F143D493EF7B90.avi,1149,157,1754,145,605,2
0X26F4ACC4D1DE761E.avi,885,130,1099,110,214,2
0X2704E5FD2037088E.avi,979,47,1487,34,508,2
0X27077CF4CF371370.avi,1738,235,3018,200,1280,2
0X2709CA13E0E58743.avi,1616,93,2909,76,1293,2
0X270BF3E8EC3136C9.avi,1168,86,1798,58,630,2
0X27135E2E874381AA.avi,1325,119,2180,103,855,2
0X271545171DA5B5F5.avi,1015,88,1554,66,539,2
0X27187ECFBEB82A72.avi,631,91,1053,69,422,2
0X271A48B44C62AFDA.avi,1683,13,2518,0,835,2
0X271C112B61F00E3A.avi,1747,129,2970,114,1223,2
0X271C3AE602E3785C.avi,1915,73,2856,54,941,2
0X272447C91729F139.avi,1056,56,1486,41,430,2
0X27250C8B6DF1D971.avi,518,60,1035,39,517,2
0X2728207F531EE47D.avi,1172,53,2005,40,833,2
0X272940207C572D60.avi,1129,77,1430,57,301,2
0X272A1770B9F8E6A0.avi,1693,99,1926,81,233,2
0X272CBEA136AB2FC5.avi,1909,59,2941,44,1032,2
0X272D953C352803EA.avi,1557,73,1841,53,284,2
0X27350E8706E23F95.avi,1444,151,1977,132,533,2
0X2736D654E5082786.avi,893,18,1532,0,639,2
0X273A6EE131B06F89.avi,972,54,1679,35,707,2
0X273A8DAD815E005C.avi,1537,106,2117,91,580,2
0X273E4A9DF1C9DAC9.avi,724,70,1147,52,423,2
0X274474F672CA7CCA.avi,1559,15,2308,0,749,2
0X2749DB8810BA40F9.avi,1013,57,1655,43,642,2
0X27508F921B0D7D12.avi,1488,112,2625,94,1137,2
0X2752526D9BC50FE3.avi,1920,65,2917,47,997,2
0X2753C50A8B05D7D5.avi,1035,84,1592,72,557,2
0X2754B4D0ABE17BD0.avi,1908,99,2256,81,348,2
0X2755371160DC96FC.avi,1165,84,1755,57,590,2
0X275ABCD76B8D34C0.avi,1192,77,1435,64,243,2
0X275B6562C2CAB56D.avi,975,55,1572,42,597,2
0X275C7438812C25A1.avi,829,115,1404,101,575,2
0X276409ED976E48CA.avi,1066,60,1848,40,782,2
0X2764D7135244AB7A.avi,1234,96,1987,79,753,2
0X2768CE554B3E0BED.avi,1387,163,2185,146,798,2
0X276B38EA6C9DED77.avi,1420,55,2149,39,729,2
0X276C46369286E618.avi,1021,72,1435,65,414,2
0X276DED2DD51341DA.avi,1027,71,1684,52,657,2
0X2774E9E5AFD94FFD.avi,1598,73,1799,49,201,2
0X2774EAE17709B110.avi,1556,121,2502,105,946,2
0X2776B06CA00EE370.avi,1155,129,1894,115,739,2
0X2778AF8121E07236.avi,1761,50,3127,37,1366,2
0X277FC348812C0E79.avi,1692,90,1932,74,240,2
0X27836E538BD008A.avi,1435,69,2224,49,789,2
0X278A875DF27E7F42.avi,1107,86,1641,70,534,2
0X2790203453E55347.avi,1288,101,1862,84,574,2
0X2795D1D6CC01F594.avi,1092,62,1836,44,744,2
0X2795F92CA80D4F5F.avi,772,64,1057,45,285,2
0X2797ABAED6ABCE28.avi,2553,102,3123,83,570,2
0X279B82BB85870F8D.avi,1131,80,1542,70,411,2
0X279CA7868FB35FB2.avi,1948,84,3101,69,1153,2
0X27A14489647DFCB.avi,1157,13,1160,1,3,2
0X27A172BEF8B816CD.avi,1009,49,1893,32,884,2
0X27A4A5840BC00390.avi,1944,126,3054,107,1110,2
0X27AB73CC472E519D.avi,1600,60,2755,38,1155,2
0X27AD2D53372C8B2C.avi,1298,70,2215,52,917,2
0X27AE655830163CF2.avi,927,108,1532,89,605,2
0X27B4E7A56393A167.avi,1678,123,2606,104,928,2
0X27B83995F6D5BDBB.avi,727,78,1193,63,466,2
0X27BBC1D9367BD3F.avi,2368,84,3637,61,1269,2
0X27BF8122053FB24F.avi,1075,116,1718,105,643,2
0X27C0E8036DA99281.avi,1668,136,2591,117,923,2
0X27C871612E887EF6.avi,1824,116,3025,96,1201,2
0X27CA6FFE2C5843BD.avi,875,14,1143,0,268,2
0X27CC9C6EAF53A68F.avi,1993,76,3056,58,1063,2
0X27D24C1F2489FB74.avi,1532,61,1851,45,319,2
0X27DE40A84F577EBD.avi,1187,108,1782,98,595,2
0X27E3BABA985C6485.avi,1327,102,2009,88,682,2
0X27E5A824236613DF.avi,1309,100,1870,85,561,2
0X27E5FF18C326FC22.avi,1632,68,2553,51,921,2
0X27E8DE815C310DE2.avi,3782,121,6713,95,2931,2
0X27EBBB70B35C2BDF.avi,1116,100,1940,81,824,2
0X27ED61D9D1D7C33.avi,767,52,1104,39,337,2
0X27F9E56828CA9A79.avi,1056,75,1823,58,767,2
0X27FB927A584A359C.avi,875,16,1342,0,467,2
0X2800557D97ACA8FA.avi,700,134,1114,117,414,2
0X2802CA3B99221213.avi,1058,110,1551,94,493,2
0X280B7441A7E287B2.avi,737,117,942,1,205,2
0X280E7E6433076E5B.avi,1990,82,2983,68,993,2
0X2812459832695FC3.avi,1390,55,1669,42,279,2
0X281A54A385859C72.avi,840,179,1369,166,529,2
0X281BFB3D114BB83A.avi,1650,96,2857,78,1207,2
0X28236C2AA117D80B.avi,1446,98,2073,88,627,2
0X28259FC1DD8D4DCC.avi,1395,104,1597,92,202,2
0X2826DDFD5A2904F4.avi,908,66,1529,49,621,2
0X282AA53113273C8B.avi,1114,116,1711,103,597,2
0X282CA4F9C50B6F6B.avi,1421,86,2114,68,693,2
0X2833102D81E9117C.avi,1002,69,1344,51,342,2
0X2835A031AB3FF693.avi,1020,71,1573,55,553,2
0X2837905EB4C648A6.avi,3234,155,5387,132,2153,2
0X283B9F3D9498F401.avi,874,70,1405,55,531,2
0X283E07E657955D9D.avi,1950,51,2136,36,186,2
0X283EA34320D8C58B.avi,996,148,1569,136,573,2
0X283F3C018BBAA3FB.avi,1019,71,1588,53,569,2
0X2840438B29E95F1F.avi,1169,170,1861,154,692,2
0X2841EE2AE1958F10.avi,1064,102,1648,85,584,2
0X28482EB3CD2FDA9D.avi,1986,72,2743,59,757,2
0X284834DEEBB7C5C2.avi,1169,79,1895,57,726,2
0X284D36D6CA672984.avi,988,173,1692,153,704,2
0X284DA4EF4567F673.avi,1325,59,1840,41,515,2
0X2851536849A2542B.avi,1226,52,1598,39,372,2
0X2851818C006989E0.avi,1000,179,1781,158,781,2
0X2855741E46DF1FA3.avi,831,58,1258,43,427,2
0X285939779C4DBE60.avi,846,50,1120,34,274,2
0X285B6CE9FA9200E1.avi,880,238,1356,212,476,2
0X2863C1D767AA05C.avi,902,60,1235,42,333,2
0X286661146EB02EE4.avi,437,76,738,63,301,2
0X286856FF99946B18.avi,908,129,1472,113,564,2
0X286CE13D5E499A83.avi,868,66,1458,45,590,2
0X2870FB8B7A63E9F7.avi,1087,51,1675,36,588,2
0X28712788DD9BC1B6.avi,2847,120,3244,98,397,2
0X2871AB68D43C2FAE.avi,822,90,1232,74,410,2
0X2871C2C07B263E65.avi,2389,25,4230,3,1841,2
0X2878D9240A9B5CC4.avi,1298,17,1854,2,556,2
0X287940BA389ACFE8.avi,1175,61,1671,42,496,2
0X287AFCC7F6DEED83.avi,1670,145,2729,112,1059,2
0X287BF355C298ACA.avi,1595,140,2422,124,827,2
0X287C85967E202E62.avi,1088,61,1718,45,630,2
0X2882179032E434E1.avi,1840,22,2479,13,639,2
0X28845A25C055F9DC.avi,2190,16,2417,8,227,2
0X2889D8C33077C148.avi,794,79,1388,57,594,2
0X288EB79F76CDA89F.avi,1512,74,1754,66,242,2
0X28903421E8658F6A.avi,1451,86,1786,73,335,2
0X28917531761A46E7.avi,1343,14,2122,2,779,2
0X28923B334611CFC1.avi,944,65,1344,46,400,2
0X2893E0784C56B75.avi,704,53,1132,41,428,2
0X28957333BC12D494.avi,1258,80,2017,112,759,2
0X28957EA81265C8D9.avi,1195,96,2150,83,955,2
0X28980B95F9769CE7.avi,1533,21,2361,3,828,2
0X28A2034B93DBE0D6.avi,468,51,668,34,200,2
0X28A422DF50B05663.avi,672,104,1137,85,465,2
0X28AABB6786125B68.avi,1490,53,1831,40,341,2
0X28B349884BCB88D2.avi,1526,75,1886,53,360,2
0X28B494298CA73B42.avi,898,49,1423,36,525,2
0X28B77DCB71D1245A.avi,1096,120,1749,96,653,2
0X28B8302CC1B2FCB.avi,1259,108,2284,91,1025,2
0X28BD4F110426601C.avi,1103,27,1569,2,466,2
0X28C73B18FDF845BC.avi,3382,194,4049,179,667,2
0X28C95C58B1790E20.avi,702,77,1119,61,417,2
0X28C9F49BA9170823.avi,958,76,1587,62,629,2
0X28CA9C46619120F3.avi,1750,59,2484,45,734,2
0X28CB8784368E0723.avi,925,82,1293,67,368,2
0X28CFBCA1B785A2F2.avi,1305,62,1997,45,692,2
0X28CFCF51E65B1B31.avi,600,114,888,98,288,2
0X28D1BD6F5325C92C.avi,846,104,1453,91,607,2
0X28D708482E66EDE5.avi,998,86,1638,71,640,2
0X28DDDD1528582978.avi,1414,48,2373,33,959,2
0X28DDF77DCDD5982A.avi,843,63,1296,50,453,2
0X28E0837117794467.avi,1079,16,1404,0,325,2
0X28E57A04871E4BC0.avi,1258,107,2036,88,778,2
0X28E5D0919BC9A280.avi,946,97,1326,80,380,2
0X28EA2B0204CD390C.avi,884,80,1437,59,553,2
0X28EAD9701FAB642B.avi,787,113,1519,93,732,2
0X28EDD31B54CBEBD9.avi,1868,132,2426,106,558,2
0X28EDDD27E7D737BB.avi,842,116,1502,104,660,2
0X28EF4C40DB0E777D.avi,1251,98,2223,81,972,2
0X28F054EA79CDB082.avi,891,139,1139,125,248,2
0X28F2E8C16B4A4974.avi,1203,101,1959,75,756,2
0X28F376B3A1AC9A38.avi,1692,68,2359,50,667,2
0X28F676EC204B892.avi,1614,59,1693,48,79,2
0X28FB1162DC7E5985.avi,1422,129,2267,100,845,2
0X28FBB5E92B4E4970.avi,2792,193,3410,173,618,2
0X28FC7D7A02E982B1.avi,974,59,1429,41,455,2
0X290387F4D1B37AE0.avi,784,75,1259,55,475,2
0X29044407543B4ED0.avi,1399,42,1497,30,98,2
0X29088E4297D24753.avi,669,68,1009,50,340,2
0X2909743644F8B146.avi,975,93,1525,78,550,2
0X290C040A358C02C1.avi,854,99,1341,87,487,2
0X29148E0F44A62490.avi,2548,78,3644,56,1096,2
0X2918B2872C91B115.avi,603,93,1029,79,426,2
0X291C4F5273C6D916.avi,562,60,883,46,321,2
0X29205B46A897CCE4.avi,1309,62,1564,45,255,2
0X2925FF720D4E48F.avi,1091,125,1943,98,852,2
0X292971284482F563.avi,1204,147,1878,129,674,2
0X292A1F9335000CC5.avi,920,72,1482,54,562,2
0X292BD6E101B932B9.avi,1153,66,1742,49,589,2
0X292CF3666916BFEE.avi,1005,59,1620,46,615,2
0X2936BE5BD2B454BE.avi,1450,61,1685,43,235,2
0X29372D09CBD2D8D0.avi,1156,60,1810,45,654,2
0X293C81AED2A80133.avi,991,112,1663,88,672,2
0X293C9951DFBCD9D8.avi,1403,81,2369,58,966,2
0X293D1E326007C469.avi,883,120,1331,106,448,2
0X293DC06147AADAD2.avi,1019,18,1596,3,577,2
0X293E8502D91120B4.avi,1631,45,1831,32,200,2
0X294BA2FC928E6983.avi,2261,109,2655,90,394,2
0X294D929C1B18A74C.avi,627,49,984,39,357,2
0X29576307FEE7F10E.avi,1910,94,2291,77,381,2
0X29582FA0A66ECA89.avi,1517,63,2160,43,643,2
0X2959FF1D90DC5714.avi,1346,96,1644,80,298,2
0X295CBC8E87EBEA7E.avi,1045,53,1599,36,554,2
0X295D7794423319AD.avi,1571,102,2021,86,450,2
0X296284667D0B48F7.avi,1052,61,1707,47,655,2
0X2962BA442DE9E45B.avi,1179,90,1692,75,513,2
0X29640FD5E676FCF2.avi,1187,118,1883,105,696,2
0X2966D3700CD4B8B5.avi,2289,32,3277,14,988,2
0X29670BE6399C86BC.avi,941,61,1389,48,448,2
0X296BF1BFDF695E01.avi,1272,133,1925,115,653,2
0X296D27E36A3B10B1.avi,1725,21,2618,1,893,2
0X296F1EF6CF0AFE57.avi,1424,70,2336,47,912,2
0X2971776F0E51B880.avi,1015,172,1279,153,264,2
0X29735078772CEC7C.avi,1157,104,1623,88,466,2
0X2973BE861413FD44.avi,1160,191,1748,174,588,2
0X2975F53722811E61.avi,1479,73,2324,57,845,2
0X297C35461EDC1C32.avi,492,62,781,51,289,2
0X297F7F40A699959B.avi,2214,144,2420,127,206,2
0X2980C863A2001D4F.avi,3322,318,4044,286,722,2
0X298127FA6EF9AE66.avi,1101,101,1802,81,701,2
0X298213C78149E758.avi,1381,98,2338,82,957,2
0X2987121B61405E4A.avi,1019,56,1696,36,677,2
0X29891201362B3276.avi,2543,64,2883,45,340,2
0X2989EFBB544B63BF.avi,876,84,1410,61,534,2
0X298EBAF6CC2B526.avi,763,123,1304,107,541,2
0X2994B5330ED757B9.avi,1486,74,2365,57,879,2
0X299A88D5675F49D0.avi,1349,103,2060,80,711,2
0X299E0A308114BAE3.avi,941,55,1430,38,489,2
0X29A2919E823A0D12.avi,1085,81,1701,58,616,2
0X29A336DCE20541A0.avi,1406,91,1566,75,160,2
0X29A4B28DB80C5246.avi,764,80,1144,68,380,2
0X29AF1111EE5795F.avi,974,45,1483,31,509,2
0X29BB9686E6983297.avi,2581,94,3356,79,775,2
0X29C17E1745706401.avi,943,60,1400,48,457,2
0X29C57DC906DE1162.avi,860,117,1301,96,441,2
0X29C61163B3107A0F.avi,852,48,1167,34,315,2
0X29C62BE737EF818E.avi,1285,107,2106,90,821,2
0X29C81728B50A2E6C.avi,979,65,1543,44,564,2
0X29C990BE357DA21C.avi,1192,69,2021,53,829,2
0X29CB7E7DE6A747BD.avi,1094,103,1796,89,702,2
0X29DC850F81AD37D8.avi,2019,67,2303,49,284,2
0X29DFB3EEC01DD44C.avi,1946,132,2720,110,774,2
0X29E0C74AFAC38079.avi,1726,63,2714,43,988,2
0X29E4873A1EDEDCE2.avi,2556,130,3283,110,727,2
0X29E5CE47FBC8961D.avi,1019,168,1646,156,627,2
0X29E66C557C99EC32.avi,778,49,1338,38,560,2
0X29EA5EC080FF78D6.avi,931,142,1487,122,556,2
0X29EAD82D1B3029D2.avi,1163,103,1909,85,746,2
0X29EB469268DC5E30.avi,1385,65,1942,49,557,2
0X29ED6C257E2FC811.avi,1547,50,2483,37,936,2
0X29F5DCEC80F87BA6.avi,842,61,1458,48,616,2
0X29F88FD41325783F.avi,1068,60,1592,48,524,2
0X29F98334C8C86ACF.avi,1291,94,1868,77,577,2
0X29FA8548E33956DA.avi,957,63,1710,46,753,2
0X29FDE0A4498AB572.avi,2091,91,2488,74,397,2
0X2A005531D741B5AE.avi,1271,49,1666,35,395,2
0X2A01716CA8E6B78C.avi,1178,67,1604,52,426,2
0X2A071BC3FD1AC4EC.avi,1371,59,1966,42,595,2
0X2A09D7E5E6F9F9DF.avi,1435,59,1861,41,426,2
0X2A0B8E212C49D706.avi,915,92,1518,77,603,2
0X2A179DC26614D64F.avi,1187,114,2168,97,981,2
0X2A1AE3B6420FD216.avi,1305,59,2016,42,711,2
0X2A1F8EEF3A53DF5E.avi,895,130,1470,117,575,2
0X2A20552783F445AE.avi,1207,141,1884,130,677,2
0X2A2C1D627826C72.avi,743,57,1231,45,488,2
0X2A2C6AF671DB82E7.avi,1837,123,2359,109,522,2
0X2A2C7C74F6D0D042.avi,1151,56,1377,38,226,2
0X2A2D19625CBF1D16.avi,1456,122,1737,112,281,2
0X2A312A5ECB7000FC.avi,790,146,1370,127,580,2
0X2A388C798DF4CFF0.avi,939,15,1439,3,500,2
0X2A3BB51936839E6D.avi,1180,52,2069,38,889,2
0X2A449C0A5F6A9CCB.avi,913,58,1455,40,542,2
0X2A45204FA70C5C9.avi,1461,50,1777,35,316,2
0X2A46A6A93DF181FA.avi,1696,57,2242,45,546,2
0X2A4B6CD214AAB6A0.avi,1188,146,1882,128,694,2
0X2A4B8B438E6DE7FF.avi,1488,69,1932,51,444,2
0X2A4CE8DBE3CCDE95.avi,1780,64,2463,42,683,2
0X2A5507B5E2C166BA.avi,1073,17,1745,3,672,2
0X2A55659AE64722AA.avi,971,16,1344,28,373,2
0X2A5A066CD7F27D5C.avi,642,49,1086,37,444,2
0X2A5B7EE5D039818C.avi,928,109,1455,88,527,2
0X2A651E015F9439C0.avi,1438,76,2275,55,837,2
0X2A6635B01B13AAA4.avi,1046,96,1527,85,481,2
0X2A667FD468D528A2.avi,1324,69,1896,51,572,2
0X2A67800D05897E40.avi,1091,11,1980,1,889,2
0X2A68164E9B03130B.avi,2075,47,2359,31,284,2
0X2A6A2DB28C7B4608.avi,1325,68,1912,49,587,2
0X2A6A33D5D510FDBF.avi,1127,74,1954,55,827,2
0X2A75592E9961EB81.avi,915,64,1688,48,773,2
0X2A76C86F7457546F.avi,820,49,1246,34,426,2
0X2A777BDE3B51C189.avi,1403,15,2363,0,960,2
0X2A7C5F0B89FED627.avi,1129,83,1664,68,535,2
0X2A7FCA76C4FAEAFD.avi,2290,60,2663,43,373,2
0X2A830BC4A3A36A93.avi,980,55,1616,39,636,2
0X2A8498756C4D6E82.avi,1248,79,2168,56,920,2
0X2A855CCD4A6C6BD3.avi,708,108,1176,91,468,2
0X2A85B05A9671F32E.avi,2343,80,4156,56,1813,2
0X2A85FF99D2016B7D.avi,941,68,1662,47,721,2
0X2A8A694D5740E1F0.avi,2329,113,3161,99,832,2
0X2A8AF50D1F38A71.avi,930,123,1504,112,574,2
0X2A8DA996FB52D5CB.avi,1155,124,1761,111,606,2
0X2A904CE88E96E7.avi,1570,127,1766,114,196,2
0X2A91906B774CE547.avi,1083,97,1707,71,624,2
0X2A928235B332DBCF.avi,787,95,1130,83,343,2
0X2A9687F49EE5406.avi,1023,67,1789,53,766,2
0X2A99BFFB26E9ECE2.avi,1355,63,1651,49,296,2
0X2A9CDF57A90DBE32.avi,1432,121,2130,106,698,2
0X2AA7D76F830E270.avi,1265,50,2106,36,841,2
0X2AA86B752CDAFC28.avi,1200,77,2157,59,957,2
0X2AB5732368D8A3F9.avi,1357,103,2285,85,928,2
0X2AB73E07EA2A8D7F.avi,1275,69,1905,51,630,2
0X2AB81C540CAFDB5A.avi,1538,57,1916,35,378,2
0X2AB98AC8D400D5DB.avi,693,86,1100,76,407,2
0X2ABAD17326F8DC47.avi,1436,64,2690,43,1254,2
0X2ABBA31A554D6E2.avi,1070,130,1854,114,784,2
0X2ABBDEA046C1EBF1.avi,780,93,1092,79,312,2
0X2AC09763183674E8.avi,1807,43,2184,64,377,2
0X2AC18208BD3CA1FF.avi,570,49,993,37,423,2
0X2AC54813DFFE6A44.avi,1934,54,2320,35,386,2
0X2ACD4F35A8D82C7C.avi,1055,100,1644,83,589,2
0X2ACE034731B7CA96.avi,864,63,1342,49,478,2
0X2ACEC865BDA02BE4.avi,923,94,1502,79,579,2
0X2ACF3F84A3F9A6ED.avi,1624,57,1953,84,329,2
0X2AD46881C37E12F.avi,1268,134,1873,122,605,2
0X2AD648B03DA6DDB6.avi,1332,70,1709,56,377,2
0X2AD994F98C491FA6.avi,961,57,1392,41,431,2
0X2ADEADB93D232F1F.avi,1347,57,2066,41,719,2
0X2ADF6020233E02A5.avi,1144,91,1634,75,490,2
0X2AE5EC02C6B6F6DB.avi,1494,73,2704,55,1210,2
0X2AE7F3D6A1A2A977.avi,2056,21,3388,0,1332,2
0X2AEB1E1DE5E9144F.avi,1101,113,1641,94,540,2
0X2AEB5ED737A6EA90.avi,1044,18,1523,1,479,2
0X2AEBE2737F2F198E.avi,715,107,1028,88,313,2
0X2AF780DBAFAEE9DD.avi,979,116,1630,105,651,2
0X2AFCAC3003694C4D.avi,1121,99,1569,81,448,2
0X2AFCEF38F2CB4FD.avi,1024,61,1680,49,656,2
0X2AFE868FF0F26037.avi,1358,178,1551,160,193,2
0X2AFFF29A1DA11CEC.avi,857,120,1469,105,612,2
0X2B00EBE66CDF22EF.avi,1305,114,1699,96,394,2
0X2B0188BDC08AE8F3.avi,749,140,1209,127,460,2
0X2B04379243A07D3E.avi,1880,120,2825,100,945,2
0X2B049A419C740450.avi,909,97,1408,83,499,2
0X2B04D402904C0AF3.avi,1267,63,1958,49,691,2
0X2B0639FDC76E788B.avi,1277,143,1756,129,479,2
0X2B0C7B1FD6FDF2FA.avi,1020,122,1691,100,671,2
0X2B0F87B014648FF1.avi,2242,102,3327,77,1085,2
0X2B11C46C12F72E1.avi,1365,109,1732,90,367,2
0X2B13AFFF378DA58A.avi,1114,41,1426,23,312,2
0X2B1407FFE2B14FB4.avi,1242,62,1822,41,580,2
0X2B1EA4FE61E09B04.avi,1032,57,1623,42,591,2
0X2B2471C251239AD7.avi,2274,71,3229,54,955,2
0X2B2494C2C6EF6F9.avi,1071,66,1807,48,736,2
0X2B25C29EF3612FD9.avi,732,81,1113,69,381,2
0X2B26BF7B0DC2B52E.avi,724,119,961,105,237,2
0X2B2D3664A4F59EF6.avi,987,65,1553,47,566,2
0X2B337C895834063D.avi,1221,25,2042,3,821,2
0X2B357569BC532F43.avi,1286,52,1959,37,673,2
0X2B36749BB015C796.avi,1961,64,2490,50,529,2
0X2B36907D5AB72242.avi,1566,70,2418,51,852,2
0X2B39C678737EB346.avi,1073,145,1415,126,342,2
0X2B39E514C7DED838.avi,820,109,1319,101,499,2
0X2B3A07F9F9F16B0B.avi,1090,98,1767,81,677,2
0X2B3CFA85CCB59333.avi,1847,36,2622,25,775,2
0X2B45ECFBC4E2299A.avi,644,61,1020,46,376,2
0X2B4ACDDAB3F1DA2E.avi,1863,80,2073,62,210,2
0X2B559592BBB6E421.avi,1299,100,2092,80,793,2
0X2B5619B4EDE8F1B8.avi,1356,67,1620,52,264,2
0X2B591E1ED1F86C25.avi,821,57,1370,43,549,2
0X2B5B9DA97FC8A1A7.avi,1032,68,1608,54,576,2
0X2B5C65259968F31D.avi,901,58,1608,43,707,2
0X2B5D059047625083.avi,1212,59,1913,44,701,2
0X2B5E93155A8601B3.avi,1002,99,1450,88,448,2
0X2B62A0DEB27B4C10.avi,1793,72,2941,52,1148,2
0X2B650F4F171CC99F.avi,1983,45,2988,32,1005,2
0X2B6BB50CF65EE164.avi,1802,105,2684,89,882,2
0X2B6E6D287F09E2A0.avi,2007,85,3138,66,1131,2
0X2B6EBF9236788362.avi,1096,55,1593,36,497,2
0X2B75FD103FD8FA5E.avi,1095,86,2027,64,932,2
0X2B76F1C5F5D0466D.avi,943,97,1545,86,602,2
0X2B79C68A21B5F520.avi,1881,80,2746,59,865,2
0X2B7ABC059BB8090D.avi,1042,93,1580,78,538,2
0X2B810D03C090DE59.avi,865,139,1316,124,451,2
0X2B81FE1EF971B25A.avi,921,19,1527,0,606,2
0X2B831262FD6E0F44.avi,1343,126,2186,106,843,2
0X2B8349B0466DDFE9.avi,1184,62,1656,43,472,2
0X2B867271589725B9.avi,2424,105,3878,86,1454,2
0X2B888E6F035154BB.avi,1337,40,1563,20,226,2
0X2B8D66D3AF8E8B84.avi,807,23,1511,15,704,2
0X2B8E2C047E853E71.avi,1596,54,2155,40,559,2
0X2B9185D91BBE0E97.avi,1470,67,2564,54,1094,2
0X2B92A8AA5710178B.avi,1090,19,1787,1,697,2
0X2B935E3B4404D29E.avi,1506,107,2055,91,549,2
0X2B974E47EADA843.avi,1335,62,1835,46,500,2
0X2B9B38D0E03561B3.avi,1217,121,2054,106,837,2
0X2BA0CC0FD446A0CD.avi,1343,47,2230,30,887,2
0X2BA56103B7A6BE7C.avi,1799,20,2602,1,803,2
0X2BB46B720AC47098.avi,1045,55,1754,40,709,2
0X2BB4D1569CCBAAF0.avi,671,133,1109,126,438,2
0X2BB53A7347B59BC6.avi,1847,53,2979,39,1132,2
0X2BB72AFEFA5753AA.avi,1051,98,1636,83,585,2
0X2BB766EF1A13DECC.avi,948,62,1469,47,521,2
0X2BB8F8D3346376DA.avi,1182,44,1993,28,811,2
0X2BBE07A50418CB3.avi,1041,127,1602,110,561,2
0X2BC272DCF674E2FC.avi,1136,106,1876,94,740,2
0X2BC37749440CC632.avi,2302,21,2721,0,419,2
0X2BCA5CD0E25723F1.avi,1531,79,2792,65,1261,2
0X2BCB6F4D73191177.avi,1436,57,1741,39,305,2
0X2BCCE250005CFD40.avi,1502,16,2071,0,569,2
0X2BD1518044A7F1E7.avi,1432,99,2336,81,904,2
0X2BD2EAEB075A7A56.avi,3338,83,3721,65,383,2
0X2BD5CA404CF4822.avi,1355,63,1723,45,368,2
0X2BDAE57715F1BBF4.avi,1068,59,1604,43,536,2
0X2BDE03448DF23DEB.avi,946,77,1460,63,514,2
0X2BDF20FFCF3D29F8.avi,999,57,1446,40,447,2
0X2BDFE5712EFDDD47.avi,1163,68,1736,52,573,2
0X2BE0908F65A5A564.avi,1443,61,2037,42,594,2
0X2BE38B4D5D345FFA.avi,1222,52,1974,38,752,2
0X2BEAF12F3432C314.avi,1053,58,1412,40,359,2
0X2BEC544FB23D724A.avi,1577,57,1993,43,416,2
0X2BF16ED5C2D8A0D3.avi,2460,104,2821,90,361,2
0X2BF66637343A27ED.avi,1552,39,1831,28,279,2
0X2BF77B6A39CD9A0B.avi,2401,157,3259,143,858,2
0X2C03CDC4A9D90ACD.avi,1347,62,2176,48,829,2
0X2C03FAE807BF8E76.avi,1755,62,2740,45,985,2
0X2C04949A6CC88C77.avi,2341,20,2758,0,417,2
0X2C073A809964F995.avi,1100,58,2010,39,910,2
0X2C0B21D4520985EB.avi,1275,58,1988,43,713,2
0X2C12346EFB5636F3.avi,1097,152,1927,134,830,2
0X2C12A8B71D39E8DA.avi,1273,16,1627,4,354,2
0X2C12BF73BA0A814C.avi,1508,121,2679,95,1171,2
0X2C14699B62EE346C.avi,1794,74,2695,55,901,2
0X2C18E8C665E9D9A3.avi,667,49,1113,35,446,2
0X2C190FF79A686E07.avi,1283,119,1744,97,461,2
0X2C1966CD61F4608D.avi,1038,143,1660,123,622,2
0X2C19EFC05FC3B091.avi,1076,53,1594,42,518,2
0X2C21A633164A6BFB.avi,889,115,1432,98,543,2
0X2C2DDBD3EB793DAA.avi,979,63,1754,49,775,2
0X2C34E713BB4D3308.avi,1579,165,2222,150,643,2
0X2C35AFD93B9496EA.avi,1191,71,1746,54,555,2
0X2C36F355EB681B07.avi,1266,138,1901,120,635,2
0X2C41E0CF2733C297.avi,1057,70,1751,49,694,2
0X2C45F28244AF0456.avi,1068,69,1817,56,749,2
0X2C49216A08762644.avi,1053,67,1863,52,810,2
0X2C49AB7562FAA93.avi,1473,84,2232,69,759,2
0X2C49F6FD06CCBCF8.avi,1665,172,2637,152,972,2
0X2C4D02125B318CBD.avi,986,145,1492,123,506,2
0X2C511E5B9B2D8D2C.avi,841,64,1314,47,473,2
0X2C5353EF79A2AE33.avi,986,60,1583,47,597,2
0X2C56A1B8986F6EA7.avi,1605,19,2623,3,1018,2
0X2C5FA07F95C49BEE.avi,1367,74,1898,53,531,2
0X2C6012D44180AE4A.avi,1721,47,1939,34,218,2
0X2C61E96BC700B20F.avi,1788,141,3184,112,1396,2
0X2C693B4B714F5F77.avi,1182,65,1859,59,677,2
0X2C73664CB7057853.avi,1341,67,2067,44,726,2
0X2C75C3C43D12BF.avi,920,108,1535,95,615,2
0X2C76048845DB3B26.avi,1316,49,2404,34,1088,2
0X2C79C011E028C5C8.avi,1138,151,1907,132,769,2
0X2C7D0289D4D9C8DA.avi,1064,18,1670,3,606,2
0X2C7EE3815ECE5418.avi,691,79,1159,57,468,2
0X2C82A1C3E914188A.avi,1457,159,1910,141,453,2
0X2C871D22AD5EAD1A.avi,1382,110,1868,90,486,2
0X2C87657038E600E4.avi,1017,127,1643,111,626,2
0X2C8891A017BD1976.avi,1054,68,1719,53,665,2
0X2C8D4E3F973C4C0C.avi,1045,43,1400,28,355,2
0X2C8D5BE1148380DD.avi,1140,57,1946,45,806,2
0X2C8E3C1FD1F556BC.avi,1275,146,2183,128,908,2
0X2C8F95568F4E8742.avi,1795,56,2554,38,759,2
0X2C90DA7EB02FCCD2.avi,2366,69,3723,45,1357,2
0X2C91EA24C7C0B398.avi,1002,142,1826,125,824,2
0X2C9357E39710C30C.avi,1347,87,1729,74,382,2
0X2C9420596D198D01.avi,1352,99,2050,83,698,2
0X2C97A655ED70FABF.avi,760,143,1247,121,487,2
0X2C97ECB94ED1AD37.avi,973,73,1610,56,637,2
0X2CA3761058236EF3.avi,1090,115,1853,98,763,2
0X2CA42A8211675132.avi,1312,69,2257,55,945,2
0X2CA89051DE3DEC33.avi,1074,98,1934,82,860,2
0X2CA927607A7AB65A.avi,1123,65,1601,46,478,2
0X2CAA96B0D5EB2D62.avi,1663,44,1865,33,202,2
0X2CADB19F2FEE68AD.avi,2736,68,3637,53,901,2
0X2CAE2DE8A42A2342.avi,1043,53,1685,39,642,2
0X2CB0D18E525D7C37.avi,1047,54,1687,39,640,2
0X2CB14DA1C391E86B.avi,1547,182,2561,150,1014,2
0X2CB15E6A301D6B19.avi,1131,141,1854,121,723,2
0X2CB1956D0DB0180C.avi,863,138,1375,124,512,2
0X2CB329D5D9E62171.avi,1237,54,1751,31,514,2
0X2CB7A24A2CFDC0DE.avi,798,86,1337,65,539,2
0X2CB7A5F709ABD767.avi,1083,58,1733,44,650,2
0X2CBCF722CBB5B80D.avi,1340,66,1546,54,206,2
0X2CBD88FCC98A48FB.avi,1222,73,1811,56,589,2
0X2CC10C4F3C7A5F8C.avi,2997,74,5394,56,2397,2
0X2CC1ACAF0876862A.avi,1661,20,2424,4,763,2
0X2CC9EEC1D61BB2BF.avi,913,54,1559,42,646,2
0X2CCCED512683D687.avi,971,16,1488,1,517,2
0X2CCF9716099B6F41.avi,1165,99,1687,82,522,2
0X2CD8C8DD79E1675F.avi,2348,86,3140,61,792,2
0X2CE0CBE435FB7161.avi,900,91,1451,75,551,2
0X2CE2BBE899FB30A.avi,956,45,1696,30,740,2
0X2CE2C2ECE6B2DEF3.avi,1716,63,2047,47,331,2
0X2CE35C58DEBA5E84.avi,1164,108,2074,89,910,2
0X2CE3CF0F97E7FC72.avi,1442,61,2329,47,887,2
0X2CE44822F7569ED4.avi,1509,45,1796,33,287,2
0X2CE840CE9B6A835E.avi,1816,117,3280,99,1464,2
0X2CE8B16185B68E.avi,1734,19,2028,2,294,2
0X2CEF6124DDC757CF.avi,1623,71,1863,61,240,2
0X2CF28B839885FBAE.avi,1260,67,2111,52,851,2
0X2CF2FAD1B2A26CEF.avi,1499,71,2089,54,590,2
0X2CF7B35D7849A5D.avi,1518,17,2607,0,1089,2
0X2CF9DE123FE188CA.avi,813,86,1367,73,554,2
0X2CFC388D482B5B31.avi,1214,24,1487,0,273,2
0X2CFD447B055E05BF.avi,1082,85,1786,74,704,2
0X2CFD990707C2AFEF.avi,1086,133,1727,116,641,2
0X2D03DD1D93E5C751.avi,1187,125,1625,115,438,2
0X2D103F41D2E38399.avi,1724,63,2291,46,567,2
0X2D1062571172E8A7.avi,1225,67,1797,48,572,2
0X2D10BE0BA5D1B6A9.avi,1859,68,2634,51,775,2
0X2D17D1C132427A37.avi,906,49,1338,39,432,2
0X2D196F26588E2E17.avi,1504,77,2619,63,1115,2
0X2D19E502F1A7362E.avi,1660,49,2859,37,1199,2
0X2D1CE5FC57B6FBC1.avi,1699,134,2080,112,381,2
0X2D23A079EADDFA54.avi,1399,17,2560,1,1161,2
0X2D2ED63C8BA47E4D.avi,1838,61,2757,45,919,2
0X2D30608E926E7FC8.avi,921,47,1562,35,641,2
0X2D34C7C038A1E3D2.avi,1678,71,2636,53,958,2
0X2D3555E57E30410B.avi,820,70,1309,46,489,2
0X2D374A42BC63F7D3.avi,975,38,1688,28,713,2
0X2D37B879A205F20E.avi,1078,118,1698,102,620,2
0X2D37C242683F1061.avi,729,71,1139,56,410,2
0X2D385BC839299FE6.avi,939,83,1438,64,499,2
0X2D3D5BE721D93FAB.avi,1152,69,1675,48,523,2
0X2D3E3C182D1459C8.avi,694,63,1206,52,512,2
0X2D3F2E5FFA807CFF.avi,652,47,910,34,258,2
0X2D3F7E5490285446.avi,749,130,1313,115,564,2
0X2D405B452654D053.avi,964,89,1305,71,341,2
0X2D40DC11D737F49B.avi,1451,58,2155,44,704,2
0X2D4304FA6A09F93E.avi,2354,202,2743,182,389,2
0X2D44B66B9949BE4D.avi,1219,81,2169,61,950,2
0X2D4C335281042D7F.avi,1302,76,1760,109,458,2
0X2D4E0673C195F693.avi,1591,104,2665,87,1074,2
0X2D4F77FD196A3828.avi,859,176,1441,156,582,2
0X2D597332A98E785E.avi,1607,91,3101,72,1494,2
0X2D5BD6E67BD7AE69.avi,1143,56,1683,37,540,2
0X2D5CC137BFF6A623.avi,1257,82,1941,60,684,2
0X2D5E11117A6B333B.avi,1268,74,2108,60,840,2
0X2D604D85FE921D9.avi,803,48,1541,35,738,2
0X2D658517E159F3F4.avi,1292,57,2044,42,752,2
0X2D6601DFA32D0382.avi,1070,48,1649,33,579,2
0X2D66386606994937.avi,1092,164,1905,144,813,2
0X2D69D2B24305EB5.avi,2258,44,2823,28,565,2
0X2D6CA36A674EDC8F.avi,1527,56,2008,42,481,2
0X2D6F8C1DEA6EF363.avi,999,112,1759,95,760,2
0X2D72B203AB220EAB.avi,804,75,1325,59,521,2
0X2D7C2A7FD48AC5CA.avi,1017,46,1389,28,372,2
0X2D7E8B6DA9FDB3E0.avi,1686,173,2067,147,381,2
0X2D82FF915BD14EFD.avi,933,113,1440,96,507,2
0X2D88CA57C0CA4328.avi,1166,116,1756,96,590,2
0X2D8A896770271A60.avi,1350,32,1772,22,422,2
0X2D8B38AA1ADBB074.avi,1172,57,1603,42,431,2
0X2D8BD5AF3B8DED9C.avi,676,46,1105,28,429,2
0X2D909B4FCF030F77.avi,1100,99,1833,86,733,2
0X2D93EB042A3DB0E2.avi,1469,59,2495,34,1026,2
0X2D9566C4D06D6F28.avi,915,19,1299,2,384,2
0X2D958648FECCDF1E.avi,844,59,1376,42,532,2
0X2D982113D0EC3AA0.avi,851,47,1472,33,621,2
0X2D9DB9841B21B473.avi,1500,117,1847,99,347,2
0X2D9E50E6BDB7CF9.avi,872,65,1403,49,531,2
0X2DA55EE48DCFCD80.avi,2472,52,2876,37,404,2
0X2DA7DA5B3CBF9227.avi,1049,52,1726,38,677,2
0X2DA998F63F173C44.avi,1350,103,1823,88,473,2
0X2DA99F9FC1DAD8A9.avi,1253,114,2190,99,937,2
0X2DAD48A6BD57C623.avi,788,174,1166,161,378,2
0X2DAE446A22A6038.avi,1069,86,1475,118,406,2
0X2DB1613A3E1C52F3.avi,1199,67,1456,55,257,2
0X2DB1F8801485264A.avi,1255,91,2018,75,763,2
0X2DB87473EC321C75.avi,1101,88,1860,75,759,2
0X2DC165EBD4F6A499.avi,1036,94,1379,72,343,2
0X2DC355CC1C2B3876.avi,1001,126,1495,105,494,2
0X2DC8C2A8797096FA.avi,1473,104,2220,84,747,2
0X2DCE146E4AE80A3D.avi,1584,20,1681,0,97,2
0X2DD4B303E3F4FCB5.avi,1427,100,2326,81,899,2
0X2DD603AC2C74F6EC.avi,673,57,1204,41,531,2
0X2DD74DF5EE1C2986.avi,1019,132,1657,99,638,2
0X2DDA61D944C9F9C3.avi,837,53,1367,43,530,2
0X2DDFB92556009B4C.avi,951,78,1413,66,462,2
0X2DE30D01995BB762.avi,1253,92,2027,78,774,2
0X2DE58B024738E3C7.avi,972,16,1549,0,577,2
0X2DE5DE59AE16AF82.avi,1475,80,2236,60,761,2
0X2DE6608CDEC4A536.avi,1186,15,2153,2,967,2
0X2DE6FC105DDE8B38.avi,1392,51,1463,38,71,2
0X2DEC11BFCC04AD8.avi,1225,151,2060,128,835,2
0X2DEDA110B28EFD48.avi,889,63,1488,47,599,2
0X2DF0CD09785D2C10.avi,1614,178,1900,159,286,2
0X2DF88C27BB20C25D.avi,1161,172,1562,157,401,2
0X2DFB4F76758EF666.avi,1995,110,3134,96,1139,2
0X2E0036AF7A9C970E.avi,1012,66,1671,52,659,2
0X2E00AD0FD28287B9.avi,3305,90,4075,72,770,2
0X2E03541DE1D78F8C.avi,835,57,1590,44,755,2
0X2E041070DF3C0BCD.avi,1291,73,1901,51,610,2
0X2E08BE7843E94F2C.avi,827,74,1266,52,439,2
0X2E0A75B64C955D2F.avi,1414,113,2553,94,1139,2
0X2E0FDC08CC93A3C6.avi,1371,133,2226,115,855,2
0X2E10D578B99BF9F3.avi,2227,19,3903,1,1676,2
0X2E1476D1A5C2BA29.avi,932,43,1378,31,446,2
0X2E17DD438B26829.avi,1141,54,1801,38,660,2
0X2E19B6DE8518F7FD.avi,1019,125,1452,112,433,2
0X2E1C7FD7AF5F7124.avi,1190,66,1937,51,747,2
0X2E1EAA6DEAA3C9A4.avi,858,61,1445,42,587,2
0X2E1EF8E244CECCFD.avi,1409,109,2141,91,732,2
0X2E2A4F7D4604622F.avi,1429,137,2056,120,627,2
0X2E2E861DD589D587.avi,1357,125,2275,110,918,2
0X2E2FB299A22B2B76.avi,1056,83,1868,64,812,2
0X2E38C47AC9A2A3E6.avi,584,96,874,80,290,2
0X2E407BCA61BDF192.avi,1030,63,1806,45,776,2
0X2E410E770355AAC2.avi,912,126,1647,109,735,2
0X2E42A13CDA91A601.avi,2449,56,3166,40,717,2
0X2E462984BEAE8FCD.avi,707,134,1168,119,461,2
0X2E46B7FD40A6955D.avi,1540,56,2162,40,622,2
0X2E47B387F4355FB3.avi,1163,100,1852,84,689,2
0X2E4CC2441CFABDB0.avi,1489,68,2571,49,1082,2
0X2E52102EE379C357.avi,2914,66,4760,52,1846,2
0X2E5298542F1F9C97.avi,1601,151,2293,137,692,2
0X2E580D3095F8413D.avi,1197,56,2004,44,807,2
0X2E5D1A5A950E394A.avi,1055,75,1552,55,497,2
0X2E5D7030DC1C9FBC.avi,2398,189,2854,171,456,2
0X2E5EDA11D632F50.avi,962,73,1536,55,574,2
0X2E61656CEDFA0B02.avi,1253,148,1959,126,706,2
0X2E636FB653B4D46.avi,1163,85,1861,60,698,2
0X2E707E80B324D9F8.avi,2118,88,3332,68,1214,2
0X2E711400B03C543B.avi,1154,74,1695,56,541,2
0X2E71FF0BAAC3BEC1.avi,1268,81,2167,69,899,2
0X2E733C8B779C06B7.avi,1892,55,2315,34,423,2
0X2E74B3A21BA7934E.avi,994,149,1555,137,561,2
0X2E77A82F2D70D940.avi,1172,56,1865,41,693,2
0X2E7C63C6E680E0FD.avi,1031,80,1549,58,518,2
0X2E7D89B9C53F4DBF.avi,704,48,1053,37,349,2
0X2E8342A7771D0391.avi,742,61,1110,50,368,2
0X2E879F97E4C4DB87.avi,898,44,1324,32,426,2
0X2E8A4D028176C17A.avi,2191,96,2549,76,358,2
0X2E8CF6423EA1B7EC.avi,964,65,1461,49,497,2
0X2E908EB5E89DD099.avi,1563,108,2733,94,1170,2
0X2E924753D4D5ED2A.avi,1037,114,1582,103,545,2
0X2E94465751550B92.avi,1226,19,2097,1,871,2
0X2E9602C7CB2FD797.avi,1326,74,2116,58,790,2
0X2E9AEFC26169C304.avi,887,51,1338,37,451,2
0X2E9E2C168789FA46.avi,2633,62,4070,42,1437,2
0X2EA240C55AAD9858.avi,1606,21,2569,1,963,2
0X2EA4BD879EEE7D43.avi,733,111,1038,101,305,2
0X2EA8A7FE9B5CD93E.avi,1402,62,2244,41,842,2
0X2EADDC6889C08ABC.avi,1128,81,1829,64,701,2
0X2EAF0F81176431E0.avi,959,127,1552,116,593,2
0X2EAF0FCB979CE980.avi,1154,78,1744,58,590,2
0X2EB2CC02E37A1070.avi,990,51,1185,35,195,2
0X2EB39D9717E466FB.avi,930,56,1452,42,522,2
0X2EB86B8EAE0A26F0.avi,1921,72,3150,54,1229,2
0X2EB93A2E4548142E.avi,1703,49,2131,31,428,2
0X2EBCFAC54E08438.avi,2104,74,3379,55,1275,2
0X2EC24D55FD3FC423.avi,1148,116,1947,102,799,2
0X2EC2E75D27C6F224.avi,1124,18,1670,46,546,2
0X2EC3A1A5F3971273.avi,2026,81,2321,71,295,2
0X2EC3E1044DE5412D.avi,1188,62,1839,48,651,2
0X2EC46449B60FD85B.avi,1084,104,1812,90,728,2
0X2EC469A29DD619FF.avi,1058,79,1470,68,412,2
0X2EC98D548B0A3542.avi,986,148,1693,129,707,2
0X2ECD35E6B98033EB.avi,1744,84,2322,70,578,2
0X2ECE3ECC0BF62256.avi,1222,80,2057,65,835,2
0X2ED5BE4B6181065A.avi,915,62,1374,52,459,2
0X2ED852A3EC97B2E1.avi,971,22,1641,2,670,2
0X2EDA3A769536EEF8.avi,1991,164,2461,149,470,2
0X2EDDFC5697535B9C.avi,1969,74,3110,55,1141,2
0X2EDF6921AA560E72.avi,1029,104,1763,82,734,2
0X2EE0A304184B797.avi,778,55,1189,39,411,2
0X2EE1815F10D8A1F.avi,819,107,1191,92,372,2
0X2EE56F270D208DF2.avi,2941,63,3827,45,886,2
0X2EE5F2D684F133AA.avi,1503,54,2160,42,657,2
0X2EE799C4FDC049DB.avi,942,26,1508,8,566,2
0X2EEB52E916176270.avi,1074,118,1870,98,796,2
0X2EF360C2BADB742.avi,1773,89,2194,77,421,2
0X2EF6FF02EC002834.avi,1605,276,1927,253,322,2
0X2EF985AA40F1925D.avi,1637,66,2749,46,1112,2
0X2EFB024B09168681.avi,1732,68,2321,48,589,2
0X2EFB608A1CC1437F.avi,1155,79,1460,63,305,2
0X2F064717C2ADEB37.avi,861,76,1314,61,453,2
0X2F094CEC2EEA4606.avi,1057,72,1494,54,437,2
0X2F0A8FC115DF5430.avi,1294,63,1665,47,371,2
0X2F0CAB93EBD17678.avi,738,88,1271,67,533,2
0X2F0CC49D6B277135.avi,1324,103,2062,77,738,2
0X2F0F6CF2E9C4A169.avi,1141,61,1872,46,731,2
0X2F102F29E46CC1C0.avi,1014,64,1591,49,577,2
0X2F11637431660144.avi,732,52,1262,40,530,2
0X2F15468C912C8E60.avi,1250,18,2028,1,778,2
0X2F15D09454E8628C.avi,1663,146,2704,130,1041,2
0X2F178A2E89C73B5.avi,1350,128,1649,112,299,2
0X2F1E80FB8078C3E8.avi,2008,189,2866,168,858,2
0X2F1EFBACA8FA6CB5.avi,1811,32,2199,22,388,2
0X2F21A058E2B8304A.avi,1046,132,1621,123,575,2
0X2F290311A5574772.avi,1136,62,1768,46,632,2
0X2F29E8E7691D0E32.avi,931,74,1444,57,513,2
0X2F2A34E211A5A1FE.avi,1924,16,2762,0,838,2
0X2F3141F00A232601.avi,1381,133,1773,117,392,2
0X2F32F1458812322B.avi,999,55,1610,38,611,2
0X2F332BC4ACA747A0.avi,956,55,1628,40,672,2
0X2F35B6AE58B2D4A4.avi,1677,46,2981,34,1304,2
0X2F38FFD4351DB77B.avi,1795,105,2831,91,1036,2
0X2F3A223D2AC5A8C9.avi,1892,106,2195,91,303,2
0X2F3ABF4B8389713F.avi,890,71,1418,51,528,2
0X2F3CE7185C80B272.avi,1504,65,2149,46,645,2
0X2F3DCD66E67791C0.avi,826,64,1238,45,412,2
0X2F405D88DA52F20D.avi,2376,19,3514,2,1138,2
0X2F51B5A594D13CC4.avi,1214,71,2119,53,905,2
0X2F5250C07A31A531.avi,906,86,1359,73,453,2
0X2F55C5011B932EE5.avi,1455,124,2323,104,868,2
0X2F57AD6F6A61BD37.avi,1038,198,1735,179,697,2
0X2F57AF57EBACCEB.avi,1511,104,2791,85,1280,2
0X2F588214D2744257.avi,926,70,1551,49,625,2
0X2F59305E0FDCC775.avi,916,59,1349,43,433,2
0X2F5B2D5DBDD28F66.avi,2563,16,2947,5,384,2
0X2F60720EDEDB2B84.avi,855,72,1290,51,435,2
0X2F65820B1076710D.avi,2106,74,2603,46,497,2
0X2F694951F67DF1B1.avi,903,51,1454,37,551,2
0X2F6973744CFA87D7.avi,2706,62,3005,40,299,2
0X2F6DD3F418E35400.avi,977,44,1439,31,462,2
0X2F71399035F475FB.avi,697,122,1048,105,351,2
0X2F73A1716262CBE0.avi,1214,120,1896,103,682,2
0X2F763FE2C438D16.avi,1296,81,1934,59,638,2
0X2F778DF5E4DA96AD.avi,915,71,1493,57,578,2
0X2F7B172A664C6989.avi,754,57,1134,79,380,2
0X2F7E24BFBA3AA884.avi,1115,58,1894,41,779,2
0X2F7EF90430E9370C.avi,913,40,1547,31,634,2
0X2F80BA0880335F5B.avi,1368,105,2629,86,1261,2
0X2F8172CBAC91EBCE.avi,953,158,1603,147,650,2
0X2F82938DF2A52427.avi,1136,20,1742,1,606,2
0X2F839D43FB3ABB20.avi,1023,69,1760,55,737,2
0X2F86CEC86F015C5D.avi,1080,64,1572,47,492,2
0X2F874518FF81C895.avi,895,55,1461,42,566,2
0X2F8B4FE7F10C9FA1.avi,1125,83,1797,65,672,2
0X2F9151F662C9CD76.avi,666,95,1098,82,432,2
0X2F92E6A93BE81557.avi,1297,49,2110,39,813,2
0X2F99E4F6D932876F.avi,795,60,1169,47,374,2
0X2F9E2329B851C361.avi,958,44,1449,30,491,2
0X2F9F41180785BAB1.avi,2838,63,3244,45,406,2
0X2FA10595E74036E6.avi,1153,96,2010,78,857,2
0X2FA3584A1A60A7BE.avi,995,126,1467,110,472,2
0X2FA3FF89B166D768.avi,1709,44,1892,30,183,2
0X2FA600708C8C76CA.avi,1133,110,1646,97,513,2
0X2FA6F6D940DD7CEC.avi,1182,87,1892,70,710,2
0X2FA86741F726D47C.avi,1663,59,2669,39,1006,2
0X2FA98A8EA1D32AE4.avi,588,48,925,40,337,2
0X2FAA908FAA937E75.avi,990,117,1585,100,595,2
0X2FAAC59C895C5441.avi,863,127,1296,112,433,2
0X2FAB42A57418EC49.avi,1169,132,1782,110,613,2
0X2FAD587DA2A84649.avi,1347,71,2395,51,1048,2
0X2FADE9E508CBEBBB.avi,1406,164,2311,140,905,2
0X2FAFDA5737784951.avi,1358,100,1664,82,306,2
0X2FB094DB8A50D559.avi,1184,112,1772,97,588,2
0X2FB0B822B78A2E22.avi,1120,71,1754,57,634,2
0X2FB2FF3DCA860716.avi,815,86,1262,73,447,2
0X2FB599E81FD49B1F.avi,1585,59,2079,39,494,2
0X2FB96B1F06BA9765.avi,812,112,1279,92,467,2
0X2FBC0AB4967074E9.avi,1392,53,2231,39,839,2
0X2FCB95682388D5A3.avi,843,61,1352,45,509,2
0X2FCD60103356EECD.avi,789,64,1327,48,538,2
0X2FCD96B6D495DDCB.avi,1490,51,1749,38,259,2
0X2FCF352447197479.avi,1217,22,1835,0,618,2
0X2FCF4A3A64516275.avi,794,79,1447,61,653,2
0X2FCF6321B94208F9.avi,1447,95,2453,77,1006,2
0X2FCF84F7FD763713.avi,906,16,1871,2,965,2
0X2FD13114B6B7BA39.avi,1017,72,1882,53,865,2
0X2FD727869D3D7132.avi,1055,69,1667,50,612,2
0X2FDDCD0EE2DAB2E0.avi,1165,144,1996,124,831,2
0X2FDECA4EA592C887.avi,2187,79,3578,60,1391,2
0X2FDF24DB8EF1CE4D.avi,736,112,1337,100,601,2
0X2FE7BCA20D009E39.avi,1130,77,1895,61,765,2
0X2FE828B7456FE840.avi,1861,83,2352,53,491,2
0X2FE99C7939456141.avi,1280,68,1574,51,294,2
0X2FEC1EA391B6A3BB.avi,1259,125,1734,109,475,2
0X2FF0C9AF0BDAE066.avi,1340,69,2285,51,945,2
0X2FF33D4035E666DB.avi,878,68,1511,50,633,2
0X2FFB2D1F3A52F4AF.avi,1142,49,1755,41,613,2
0X2FFB8AB1CBB7C3D.avi,1681,65,2345,47,664,2
0X2FFF24580B67B985.avi,1635,92,1876,76,241,2
0X2FFF4396044B9599.avi,1372,148,1985,134,613,2
0X2FFFF8FC560376F0.avi,1567,64,2336,47,769,2
0X30031EC6E173237B.avi,1100,171,1906,154,806,2
0X30095431B14EB3DF.avi,1852,19,2866,46,1014,2
0X300AA381A5509008.avi,1001,86,1639,66,638,2
0X300D3D8177BE07A6.avi,1271,122,2042,106,771,2
0X300EB440D348F45.avi,878,95,1460,83,582,2
0X3011B1FF13AA6C42.avi,1952,114,3239,80,1287,2
0X30162222B586A328.avi,1462,116,2691,100,1229,2
0X3016B7ECCCEAE02C.avi,1363,118,2007,98,644,2
0X30191C05574D0257.avi,1170,140,1984,123,814,2
0X3023ECB2216511F0.avi,1152,66,1838,50,686,2
0X302567FE70174845.avi,1069,18,1832,4,763,2
0X30274DCF9BBA567F.avi,997,92,1691,73,694,2
0X3027FD45B2C26E6B.avi,792,119,1203,100,411,2
0X302819E258912025.avi,904,75,1470,53,566,2
0X302995669B66A122.avi,1586,120,1951,102,365,2
0X3029C3C640B5EFD9.avi,1904,109,3380,93,1476,2
0X302B5A67D2FD528F.avi,1471,42,2578,30,1107,2
0X302DC89F8DBB4E72.avi,1021,52,1566,38,545,2
0X3031FD2072E91F1F.avi,1098,73,1792,57,694,2
0X303266C9753A9221.avi,1431,104,2227,88,796,2
0X3032DD7D5F77DC37.avi,1017,176,1963,159,946,2
0X303781B228664E4.avi,1142,68,1309,47,167,2
0X3038AF85DAEA33AF.avi,900,135,1428,114,528,2
0X303B6560E7903370.avi,1221,68,1971,49,750,2
0X303FBC993DCFFA5A.avi,565,90,856,74,291,2
0X304072964F9FED96.avi,2207,122,2991,104,784,2
0X30478F96BBD1A142.avi,2903,96,3210,80,307,2
0X3047DAECF3BF4F35.avi,1457,80,2496,63,1039,2
0X30498000742D4D19.avi,1531,57,2457,42,926,2
0X304BECC72FD64162.avi,798,70,1271,50,473,2
0X304F73AE14FCAAEE.avi,861,65,1402,49,541,2
0X304FEB38430F6379.avi,883,63,1411,46,528,2
0X305357FDBA449A7E.avi,2945,58,3389,42,444,2
0X3057B68614333EF5.avi,1312,69,1835,53,523,2
0X305A08AAFCD0F1B.avi,1478,85,1869,74,391,2
0X305C73A65134962D.avi,1561,89,1794,73,233,2
0X305DA6109DF57F3E.avi,1970,66,3050,46,1080,2
0X306001BA85006E21.avi,741,16,1075,4,334,2
0X306089480560F2CB.avi,1576,92,2163,71,587,2
0X30623CFE5E3AD181.avi,1863,101,2892,86,1029,2
0X3062BAD834AAB2A3.avi,742,94,1068,81,326,2
0X3064D2C12E6718AD.avi,1162,16,1490,7,328,2
0X3064DF4DEEA10F77.avi,1299,133,1810,108,511,2
0X306F42A51FFEB3CD.avi,1384,111,2036,102,652,2
0X3070B9FC19EEA1A8.avi,1085,45,1268,31,183,2
0X3073CB032B344F83.avi,1832,17,2531,0,699,2
0X3074A91A06F3DF4F.avi,1056,56,1759,40,703,2
0X3077040EC90D916D.avi,1222,76,1728,56,506,2
0X30789B87116B381C.avi,1202,122,2187,108,985,2
0X307C147F99088E0E.avi,868,115,1419,100,551,2
0X3086B124F7E9C217.avi,1602,61,2028,43,426,2
0X30875E172CAE1B6E.avi,685,51,1246,37,561,2
0X308F6D2FF3555209.avi,792,210,1347,197,555,2
0X3091FF4E0AE5D57C.avi,1177,113,1624,96,447,2
0X309525C0BF6240C0.avi,1224,64,2155,49,931,2
0X3096BB5F01A3E901.avi,1568,251,2502,227,934,2
0X309AD0F57E1C81B2.avi,1817,24,2886,0,1069,2
0X309C2F4CC7C29F55.avi,846,50,1385,40,539,2
0X309E151E82DD9D94.avi,1085,105,1658,89,573,2
0X30A216CE9B22EF5.avi,1212,130,2168,102,956,2
0X30A55286F1F00DD9.avi,1030,136,1726,120,696,2
0X30A9476068D69B16.avi,1123,58,1686,47,563,2
0X30ADD91111F35C41.avi,2386,57,3438,40,1052,2
0X30AFF793AC29BD2B.avi,1021,94,1363,81,342,2
0X30B39D3B28B492C0.avi,973,74,1609,55,636,2
0X30B3AAE38D19F95A.avi,986,12,1517,1,531,2
0X30B768205DDFE981.avi,785,163,1224,151,439,2
0X30B78D6996933B74.avi,1141,86,2046,71,905,2
0X30BABD45D8570AD3.avi,726,57,896,41,170,2
0X30BFDB06375733D1.avi,928,18,1158,3,230,2
0X30BFEEB4102D358F.avi,866,75,1399,58,533,2
0X30C23954381AEB00.avi,1258,108,1520,93,262,2
0X30C6E212959E3A90.avi,1783,70,2628,50,845,2
0X30CAEB4DADB146B.avi,1228,107,1826,90,598,2
0X30CB7DA75CA8487B.avi,2067,109,3372,96,1305,2
0X30D3622EBC82AC5F.avi,1066,120,1968,105,902,2
0X30D3A903D183E50E.avi,1107,64,1782,48,675,2
0X30D3D4670D1960CB.avi,964,62,1610,48,646,2
0X30D49694BD3BE8E1.avi,2755,19,3223,0,468,2
0X30DC735C9465A19B.avi,731,54,1225,41,494,2
0X30DD2E0EFB94A0C3.avi,768,44,1333,29,565,2
0X30DD64890676EF7D.avi,792,85,1297,66,505,2
0X30DF42C999969D67.avi,1039,50,1197,41,158,2
0X30E04350F8CE348B.avi,753,18,1308,0,555,2
0X30E33024CE9DF8E9.avi,1111,51,1838,36,727,2
0X30F0CADB380AFD41.avi,1154,74,1949,57,795,2
0X30F59532488B7385.avi,1550,77,2919,62,1369,2
0X30FC08C8A542EB2F.avi,823,73,1170,50,347,2
0X30FEEEFC74A8F437.avi,1005,116,1705,92,700,2
0X310589D4CDC13146.avi,1091,93,1449,80,358,2
0X31066B9B6C089130.avi,1063,24,1677,1,614,2
0X31091C108B79BD8D.avi,928,75,1413,52,485,2
0X3112D11F241CFEC2.avi,1022,68,1458,50,436,2
0X312454CBA4A7D4F2.avi,1383,65,1892,42,509,2
0X3125B96D71B7821B.avi,881,78,1524,68,643,2
0X312D452CAA7E64C1.avi,1118,14,1605,0,487,2
0X312EF19F60FD492.avi,1149,18,1725,0,576,2
0X312EF87AE19B3E5.avi,1252,68,1841,48,589,2
0X3135870672917B2E.avi,1206,61,2109,46,903,2
0X31393277CDB5A7CC.avi,1279,69,2093,48,814,2
0X313BCE11B5A12F4E.avi,1124,122,1473,105,349,2
0X313D7019ACE708FD.avi,1033,80,1642,61,609,2
0X313E1E99DB1C98DB.avi,814,161,1291,147,477,2
0X314192FBA6E19068.avi,1991,18,2580,40,589,2
0X31454136B3094167.avi,580,89,1004,73,424,2
0X314D25279BC64DCC.avi,1477,68,2420,50,943,2
0X3153B66CE568125A.avi,942,107,1381,92,439,2
0X3154AED0655FDFA.avi,1095,128,1826,112,731,2
0X31561CB66585395A.avi,1912,22,3269,2,1357,2
0X31564EE859AF143C.avi,916,79,1275,67,359,2
0X3157875A82E09BD4.avi,2078,123,2473,102,395,2
0X3157CB3AA918DBE4.avi,1309,191,1968,171,659,2
0X3157CB9999A6EAA7.avi,1723,94,2318,79,595,2
0X31609610BF62EABF.avi,1201,88,1897,62,696,2
0X31612E3EF6C6CE3C.avi,1549,81,2296,63,747,2
0X316B2586E85BB7B4.avi,2378,117,2698,100,320,2
0X316DE42557C8197.avi,1519,107,2272,90,753,2
0X31728075F994A2C9.avi,1667,50,2854,34,1187,2
0X31765EFF76DA69F2.avi,940,184,1511,162,571,2
0X317B80B024DEF142.avi,1073,50,1465,33,392,2
0X317E4342CFF4F82C.avi,971,85,1450,67,479,2
0X317E86FC42ABB6C4.avi,1642,68,2604,52,962,2
0X317F9211C2AFCAA8.avi,1244,84,2018,62,774,2
0X3180E8CFE4B3CE1B.avi,1021,75,1801,57,780,2
0X3182DE90EDD4C06A.avi,1279,49,2042,35,763,2
0X3184922BBFE6CAA7.avi,1323,69,2051,47,728,2
0X318678A29B2FB80F.avi,1171,118,2102,95,931,2
0X3186FFAF6AEAC0E0.avi,1240,87,1954,74,714,2
0X31875024C412A9E.avi,1199,47,2285,37,1086,2
0X318B72F1FF654675.avi,1805,53,2757,37,952,2
0X318BF49FD37428B3.avi,1057,147,1495,127,438,2
0X31919E16542CBF1D.avi,1129,55,1875,42,746,2
0X3191F7851F57ECC5.avi,1524,57,2489,44,965,2
0X3193A277D6B5C956.avi,1803,68,2532,49,729,2
0X3196BBF36C80C73B.avi,1579,64,2761,45,1182,2
0X31A6794877687D25.avi,1228,120,2014,101,786,2
0X31A818859E10C195.avi,802,115,1516,94,714,2
0X31AC494B44342BAE.avi,1452,58,2584,45,1132,2
0X31B076E2421E08E4.avi,695,67,1137,47,442,2
0X31B3F20AC08B5491.avi,1756,87,2002,22,246,2
0X31B6E6B67B97806A.avi,1540,148,2043,133,503,2
0X31C2B92D52D9835B.avi,1966,58,2784,40,818,2
0X31C63F2F632AFE59.avi,1176,135,1878,118,702,2
0X31C69C4046D1289B.avi,1126,129,1735,117,609,2
0X31C71452F1441C6E.avi,1219,14,1634,0,415,2
0X31C7FC69D6C348EA.avi,912,66,1002,52,90,2
0X31D148279BA1B88D.avi,965,67,1603,45,638,2
0X31D2ECB813466DEF.avi,1385,18,1944,0,559,2
0X31D2ED1154B10621.avi,1322,126,2135,109,813,2
0X31D3AE2E06F1566E.avi,1278,101,1825,87,547,2
0X31D48B2763D0524F.avi,1121,69,1770,54,649,2
0X31D5F0DB04CEBE74.avi,741,69,1185,55,444,2
0X31D873405F58E85E.avi,1074,127,1846,111,772,2
0X31E20056D742A8B3.avi,1631,102,2678,88,1047,2
0X31E24F0580C988DC.avi,1080,65,1830,49,750,2
0X31E2CCEE26A37C66.avi,1398,68,2261,47,863,2
0X31E539C27D120BDE.avi,963,141,1194,124,231,2
0X31E7130E8CEF4E12.avi,1772,91,2731,74,959,2
0X31EE1F0D632DEED0.avi,992,66,1663,43,671,2
0X31F4E5CAC0DE0D41.avi,1225,84,1838,62,613,2
0X31F9215CE617A607.avi,1056,64,1715,47,659,2
0X31FBF37FB7668A25.avi,1150,126,1794,103,644,2
0X31FCB82628884EF3.avi,1000,62,1432,47,432,2
0X31FCC04D7162E128.avi,1320,59,2047,44,727,2
0X32045C0F3B6461A0.avi,878,72,1328,59,450,2
0X3206DD7C0738E9DD.avi,1185,50,1632,39,447,2
0X320A26606B6ADA37.avi,1452,115,2209,97,757,2
0X320AD06F26E9FD6C.avi,1487,67,2419,47,932,2
0X321008E037A779B8.avi,1778,147,2033,126,255,2
0X3210E8ECEF2256E7.avi,963,130,1653,112,690,2
0X32117E92121B16F3.avi,783,208,1118,192,335,2
0X321656F897378A94.avi,1648,54,2333,40,685,2
0X321A0EF32BCBC550.avi,1144,77,1964,61,820,2
0X321D8D51EFB9BA5C.avi,966,17,1486,0,520,2
0X321EBCC21FE8C856.avi,877,93,1286,74,409,2
0X322499B7AF82988E.avi,1490,69,1922,58,432,2
0X3224EE34E8450170.avi,900,88,1342,74,442,2
0X3226DADAA3C82456.avi,1172,55,1855,50,683,2
0X322927F6CCD46338.avi,1401,105,2022,86,621,2
0X322A355CF59F2B40.avi,1018,59,1597,42,579,2
0X322AD1DF704CA51.avi,1238,66,1898,50,660,2
0X322C61C9E15C0DDB.avi,1835,88,2063,72,228,2
0X32312BC4DF1CD8A3.avi,2182,77,2567,61,385,2
0X32340D2C15869C0A.avi,1862,66,2947,48,1085,2
0X3237F0FD286478F9.avi,968,113,1515,90,547,2
0X32397CFF9BBD05C3.avi,1198,138,1749,122,551,2
0X323BF010EA16C00C.avi,1197,96,1915,82,718,2
0X323C358CAEAB7E3B.avi,852,143,1461,125,609,2
0X3249BC61F85F145F.avi,1110,79,1613,60,503,2
0X324A55CC446CDAC2.avi,1215,13,1611,0,396,2
0X324B3671E0084467.avi,1256,65,1798,48,542,2
0X324D566949BA5E4A.avi,953,63,1505,54,552,2
0X324D5ED9263EE7D0.avi,1084,105,1406,83,322,2
0X3255DC6631CBE0EE.avi,1264,101,1611,86,347,2
0X325E7B3148ED7759.avi,827,108,1339,89,512,2
0X325F7A4C97D4DBAF.avi,2110,89,2686,72,576,2
0X3263F90D7E0EC197.avi,1183,71,2166,43,983,2
0X326722FDA159FB67.avi,1164,63,1794,47,630,2
0X32692F7C7ED077C5.avi,2568,57,2900,46,332,2
0X3269691452F4F42A.avi,1876,106,2038,144,162,2
0X326ABE058F8ACB8D.avi,1884,127,2786,110,902,2
0X3275A62B32E854D5.avi,1272,100,2059,82,787,2
0X32793DD199C99CEA.avi,1303,74,1604,57,301,2
0X3285FE374F563092.avi,1458,15,1830,0,372,2
0X3289775294422CD9.avi,1640,119,1966,102,326,2
0X328A9B4F2821F941.avi,1178,132,2154,115,976,2
0X328BD28D092FCAC4.avi,1104,54,1791,42,687,2
0X328E6B9F2BE3343F.avi,1107,16,1664,3,557,2
0X329210815212AA6A.avi,1246,55,1581,43,335,2
0X3296B7D992D8EF77.avi,1005,60,1195,44,190,2
0X32A27346773DADC8.avi,1249,84,1768,61,519,2
0X32A3B50290C0920B.avi,1064,19,1759,2,695,2
0X32A7E7D83FC9AB4D.avi,1156,15,1788,0,632,2
0X32A800B7CCBE3258.avi,1218,82,1844,59,626,2
0X32AEF2B955391F03.avi,1619,67,1898,54,279,2
0X32AFF6A0BED73A67.avi,768,118,1190,104,422,2
0X32BA30438E83A84.avi,1109,55,1978,40,869,2
0X32BC15EF20DA1BD9.avi,1778,106,2426,95,648,2
0X32BD73DC6E258DB.avi,1207,165,1832,153,625,2
0X32C032EAEE7813E7.avi,970,116,1522,100,552,2
0X32C32159B97474E4.avi,1216,103,1745,86,529,2
0X32D38BB19B226A8C.avi,1189,65,1848,52,659,2
0X32D4DA8EABE4418C.avi,1276,64,2069,48,793,2
0X32DB42B7457ECACB.avi,1266,141,1896,117,630,2
0X32DC806BF959BA14.avi,1137,125,1558,104,421,2
0X32E508370DC978B.avi,2037,55,2661,39,624,2
0X32E79594A10EDF5F.avi,1212,107,1485,95,273,2
0X32EE41A1B84B6A14.avi,1300,65,2158,49,858,2
0X32EEB965CE009046.avi,993,128,1610,114,617,2
0X32EFE97394069284.avi,1478,91,2551,73,1073,2
0X32F2F0DB38AB8F0E.avi,1687,57,2222,39,535,2
0X32F6A3D09D55F15.avi,1842,106,3155,89,1313,2
0X32F8AD6F7FAA5FA1.avi,1883,61,2695,41,812,2
0X32FC6DD96FD01C1E.avi,1099,100,1772,78,673,2
0X32FDD6BF12B089E1.avi,904,37,1492,26,588,2
0X32FFE959DFD8A7FA.avi,1677,51,2871,39,1194,2
0X330D6A7AA5B79576.avi,698,67,1214,47,516,2
0X330E6856301BBF9A.avi,1498,20,2469,2,971,2
0X33102FE7080DF430.avi,1242,205,1814,184,572,2
0X331101FA7F150A51.avi,1060,68,1690,52,630,2
0X33129CC972FD945A.avi,976,104,1441,90,465,2
0X331371BEC12BCA1D.avi,2107,157,2444,142,337,2
0X33155387C61B9F96.avi,617,139,992,121,375,2
0X3315BE64B4EFA2E0.avi,1309,17,2060,1,751,2
0X3317BCA5B123B1DA.avi,995,45,998,58,3,2
0X3319F092B34E5C6E.avi,1104,56,1789,42,685,2
0X331A9942531AF159.avi,1105,17,1670,1,565,2
0X331C177536F2D6A7.avi,1039,58,1604,37,565,2
0X331E30E9C34D156B.avi,947,91,1494,77,547,2
0X331E4B6F94DAA79F.avi,1079,61,1816,44,737,2
0X331F3DCBF76715B8.avi,1059,58,1612,43,553,2
0X331FA2EFD16DD71F.avi,1183,118,2116,98,933,2
0X3322B56BD6D0A2DA.avi,1488,17,2271,4,783,2
0X3322CB5CF2D2DFDC.avi,731,61,1212,42,481,2
0X332303C99316EA31.avi,986,132,1568,116,582,2
0X3323D09B5F9FD9E2.avi,1126,120,1823,104,697,2
0X33270551FC06E368.avi,918,202,1531,186,613,2
0X3327607103BF5410.avi,2290,19,3995,0,1705,2
0X332B4C68C60E40D4.avi,1210,81,1743,60,533,2
0X3330641518FE2774.avi,1482,65,2213,47,731,2
0X3331B6D11597103D.avi,958,109,1481,93,523,2
0X3331CE57D8978B42.avi,976,148,1492,130,516,2
0X33343944D242ACF2.avi,1613,122,2266,107,653,2
0X333986F8FA0EE679.avi,2800,125,2944,114,144,2
0X333A6598916DD19.avi,1170,5,2021,0,851,2
0X333F90C4D2DB981A.avi,1489,132,2017,116,528,2
0X333FD98F27A8A355.avi,1266,112,1708,98,442,2
0X3342A007765C4B9D.avi,983,68,1476,52,493,2
0X334387311D165778.avi,1258,53,2087,39,829,2
0X3344182832A27669.avi,982,58,1543,43,561,2
0X3345EE0460BEFF23.avi,1206,69,1830,51,624,2
0X3345F2E187DBB431.avi,971,118,1473,103,502,2
0X334B87F0729817FB.avi,951,16,1579,0,628,2
0X334CC02665FB2A7C.avi,2004,188,3029,168,1025,2
0X334D7C64AAB53CD.avi,2204,71,3614,50,1410,2
0X334F8452094FF33E.avi,1399,73,2148,53,749,2
0X3351369E8117D69F.avi,1266,52,2160,35,894,2
0X335537FEEA365B7F.avi,1161,171,1854,145,693,2
0X3355C64DA540919A.avi,1276,19,1581,2,305,2
0X335B5FC2607A30BE.avi,956,52,1522,37,566,2
0X335BC6AA17BC0556.avi,1408,18,2610,0,1202,2
0X3361443607342447.avi,1982,112,2369,91,387,2
0X33646D65192ECB1B.avi,951,66,1523,50,572,2
0X33684EDE3D2A8403.avi,924,70,1243,53,319,2
0X336E68E12F89AB87.avi,1642,15,2615,2,973,2
0X336FEFA48BEDADD9.avi,981,130,1694,110,713,2
0X337135AA2B0C8A89.avi,1236,60,2080,44,844,2
0X3372DC50E0B65B09.avi,1250,56,1514,43,264,2
0X33763ECB684188DA.avi,2101,105,2694,85,593,2
0X3377F80F64924FF6.avi,1038,174,1711,157,673,2
0X3378E1497A371427.avi,990,92,1593,79,603,2
0X337BC0A792EAA058.avi,1082,62,1676,49,594,2
0X337C7EAD926FC8D1.avi,891,107,1298,87,407,2
0X33801E24EDECD5DE.avi,1358,130,2227,112,869,2
0X3380B75705B84B6A.avi,1443,104,2353,89,910,2
0X3386474C986AC6E0.avi,3389,68,5688,57,2299,2
0X338A79C8EE1DC1EE.avi,1297,144,2179,129,882,2
0X338B2143E28692C3.avi,1127,76,1818,55,691,2
0X3392A216139E5076.avi,1316,127,2085,109,769,2
0X3394222B4D42120E.avi,1490,64,1906,42,416,2
0X3395476F5A327AEC.avi,1214,58,2060,41,846,2
0X339CE86F29AF16AC.avi,1947,20,2602,0,655,2
0X339EDBDA0782AA12.avi,1485,111,2415,92,930,2
0X339F99A07CA3DDE6.avi,862,100,1394,83,532,2
0X33A5EAE97F02CAC5.avi,1346,27,2062,5,716,2
0X33A69D89DA1BF30B.avi,2569,74,3126,51,557,2
0X33AF76D527A55F61.avi,1117,16,1879,4,762,2
0X33B2731B3D69C2E8.avi,822,70,1380,56,558,2
0X33B47388D301E9B9.avi,1026,61,1502,45,476,2
0X33B931135755C02D.avi,1382,118,2244,101,862,2
0X33BB0E79E1949B78.avi,1019,53,1659,39,640,2
0X33BECF6DE6E8D68B.avi,1695,100,2313,79,618,2
0X33BF00D55528C824.avi,652,20,1051,9,399,2
0X33BF24BE8114D6EF.avi,1762,73,3043,57,1281,2
0X33C02A3FE1E3BB60.avi,1423,116,2212,93,789,2
0X33C06F70A505E8A4.avi,1177,70,1861,50,684,2
0X33C1CE560C2A94F7.avi,1607,119,2432,103,825,2
0X33C3D95C20A0D931.avi,832,38,1179,24,347,2
0X33C5FAF146604827.avi,675,41,1083,29,408,2
0X33C791E1689C2726.avi,1112,103,1872,85,760,2
0X33CB7178EBFA4CC8.avi,906,79,1281,69,375,2
0X33CE722927824933.avi,1065,52,1795,36,730,2
0X33D18DF74CDD4C2A.avi,783,132,1133,116,350,2
0X33D2E42B24A37393.avi,2391,63,4279,48,1888,2
0X33D4E36501CE4BB3.avi,1178,145,1783,128,605,2
0X33D4F7277E4B9E25.avi,2186,148,3312,129,1126,2
0X33D5FF46E1A2274.avi,818,62,1355,48,537,2
0X33D6C37E2BE30F7C.avi,1264,68,1812,48,548,2
0X33D87F30AE9C9DB6.avi,1207,70,1761,54,554,2
0X33DC70DA3600D15D.avi,2962,82,3568,71,606,2
0X33DC75C67339384A.avi,1089,146,1919,132,830,2
0X33DF960A6BD847AD.avi,2139,102,2932,81,793,2
0X33E0EF504880E70C.avi,1237,120,1985,101,748,2
0X33E127FCB951ED9C.avi,879,51,1645,42,766,2
0X33E4547677604CF2.avi,1672,52,2054,35,382,2
0X33E9BEA41552C6F3.avi,946,113,1561,103,615,2
0X33EA067E1BF77EFA.avi,1163,94,1761,78,598,2
0X33EA3705CEBB74DA.avi,1924,198,2663,177,739,2
0X33EAE0F44B7618C1.avi,1416,62,1896,42,480,2
0X33EBABBCE09F2DAE.avi,840,53,1244,34,404,2
0X33EC93EAFBBD0C5E.avi,545,79,960,68,415,2
0X33ED9A0B02AAACFA.avi,915,101,1516,86,601,2
0X33EE0DCD5DC58B4C.avi,971,109,1727,93,756,2
0X33EF85BEFE8A25A1.avi,761,198,1431,186,670,2
0X33EFAD3CC44F65D2.avi,1267,170,1826,153,559,2
0X33F1D582C99188E6.avi,1693,65,2319,46,626,2
0X33F65ADDD00BECF.avi,1201,65,1627,44,426,2
0X33F695DCDDB78E64.avi,856,95,1496,76,640,2
0X33FAC1D874BC1873.avi,1734,105,1993,91,259,2
0X33FAD88E89C48D24.avi,1318,52,1772,34,454,2
0X33FB3B666A158A2B.avi,1216,20,1873,3,657,2
0X33FEE43E021DA243.avi,874,83,1409,70,535,2
0X3402A5D3DB11938E.avi,1009,72,1485,60,476,2
0X3402AE2F48D0B71C.avi,713,42,1094,29,381,2
0X340364B9261E5FD8.avi,2797,119,3296,99,499,2
0X3403D217C07A90BB.avi,1299,18,1995,0,696,2
0X34093F356D30ECBD.avi,1962,67,2521,45,559,2
0X340A15409D548A73.avi,906,157,1511,144,605,2
0X340D3CA7C92DC723.avi,1328,46,1541,32,213,2
0X341959DF85C5BE6E.avi,2295,93,3564,71,1269,2
0X341CD0F8247C3635.avi,959,41,1498,29,539,2
0X341CE51CF56BDC97.avi,903,144,1472,131,569,2
0X341D23C239E4D3D3.avi,1158,107,1607,90,449,2
0X341EC20E83B0B356.avi,998,67,1635,52,637,2
0X3420346582CD97A4.avi,1104,57,1658,40,554,2
0X3422556389DBC33C.avi,1186,86,1647,69,461,2
0X342304BADF69D9F5.avi,1098,87,1632,68,534,2
0X342642887C3B635A.avi,1870,69,2195,45,325,2
0X3427B817F8246DC0.avi,1235,141,2027,126,792,2
0X342BECBDEC226B4B.avi,1730,100,2821,82,1091,2
0X342C33B7EFB51C1F.avi,799,66,1405,50,606,2
0X34307A6B78240F3C.avi,935,55,1559,41,624,2
0X34346DB8538E9C00.avi,1405,99,2093,83,688,2
0X34371B72F2CA944B.avi,2583,50,3114,34,531,2
0X343BE9ED06FDDBF.avi,1397,139,2550,116,1153,2
0X343BF4FF40F55526.avi,1329,65,2253,51,924,2
0X343CD94989ABD688.avi,1335,91,2170,78,835,2
0X343CEAA877051407.avi,1199,43,1850,34,651,2
0X3440ECCBC0B8B0B8.avi,896,62,1405,48,509,2
0X3446892185071673.avi,2733,23,4663,2,1930,2
0X344A1BA4E101C1A3.avi,1275,109,1813,93,538,2
0X344B9B92809DFB2.avi,996,152,1439,134,443,2
0X3450FE8B316FA595.avi,1053,78,1711,57,658,2
0X34517C9565F4887A.avi,1168,116,1778,94,610,2
0X3452E6F46D1EED03.avi,1269,77,1511,63,242,2
0X345C12B577CFF6AF.avi,1445,66,2216,46,771,2
0X345D4E0B1B2EBAA1.avi,515,75,1120,61,605,2
0X346296E160818655.avi,817,16,1393,3,576,2
0X34681486F5F5BA04.avi,1112,68,1963,49,851,2
0X3468566357AA7782.avi,958,110,1644,92,686,2
0X346A7A8994D823E6.avi,2320,113,3099,95,779,2
0X346C93EAA0D34D61.avi,1489,118,1797,105,308,2
0X3473A41F60063EDA.avi,1813,140,2097,119,284,2
0X34741F168806C3CA.avi,1276,92,2113,77,837,2
0X3475D2DF28CA8EFA.avi,2047,49,2392,33,345,2
0X347C08CBDD9C7630.avi,921,71,1551,54,630,2
0X348035818233D5AE.avi,2718,103,3218,85,500,2
0X3483EE5D8D715915.avi,1153,120,1441,103,288,2
0X3485FF30A440873D.avi,1777,62,2753,44,976,2
0X3486DE177009C0A7.avi,2484,48,2798,32,314,2
0X3488FD340222E032.avi,1015,54,1568,38,553,2
0X348C1A7ED9165514.avi,763,36,1227,28,464,2
0X348C4CEA595CD540.avi,1239,165,2105,150,866,2
0X3491A2D8671884AA.avi,1113,101,1859,86,746,2
0X349290B231655FCF.avi,1519,14,2017,1,498,2
0X34937EEA012BAFAC.avi,979,59,1428,45,449,2
0X3496FC2940AE309C.avi,944,212,1531,195,587,2
0X349B5DCF9294D081.avi,1102,75,1774,57,672,2
0X34A2487BD238406D.avi,1205,55,1750,39,545,2
0X34A36626F45738E3.avi,2232,16,3186,2,954,2
0X34A57B49B7505FF0.avi,762,104,1290,89,528,2
0X34A86702D598B94.avi,1098,15,1299,0,201,2
0X34A9A9AC83DB199A.avi,1453,41,1901,28,448,2
0X34AFA7E543D8DB5B.avi,1596,65,2470,45,874,2
0X34B0D3390808FB87.avi,1018,73,1707,56,689,2
0X34B3A7DE20686478.avi,1874,116,3004,96,1130,2
0X34B82B9BE9BD2A62.avi,864,69,1409,50,545,2
0X34BF7E5793966642.avi,1142,82,1741,64,599,2
0X34C0948C7AE2C568.avi,1399,73,1956,58,557,2
0X34C0B1836A741427.avi,687,78,1162,62,475,2
0X34C1E0788687F5F.avi,906,113,1518,99,612,2
0X34C21BF64815FE24.avi,1328,64,1747,48,419,2
0X34C28111C4C125E0.avi,837,55,1249,39,412,2
0X34C6D880282612DE.avi,1042,20,1301,6,259,2
0X34C6E0BADBD81AF9.avi,1431,63,2053,49,622,2
0X34D027E4D5B771F7.avi,1112,66,1629,48,517,2
0X34D68DB928DCDFD8.avi,1974,66,2224,53,250,2
0X34D6A77674B8E6F2.avi,890,97,1400,83,510,2
0X34DFB8411A045F86.avi,1100,184,1818,167,718,2
0X34E161E07008834A.avi,1208,116,1947,101,739,2
0X34E300A9A15F96BB.avi,1575,105,2326,89,751,2
0X34EB3569B7B1A4DA.avi,817,99,1447,86,630,2
0X34F1AECC373BB68E.avi,988,51,1650,39,662,2
0X34F2CEE849DC9CBF.avi,1613,139,2419,123,806,2
0X34F41D6E5B689307.avi,1211,71,1885,56,674,2
0X34F5DA86B3B45492.avi,843,142,1417,123,574,2
0X34F7CF2069479824.avi,1939,47,2222,32,283,2
0X34FF0D4A53F3B1A7.avi,941,77,1518,60,577,2
0X3500E28504F6F202.avi,1144,66,1760,48,616,2
0X3503A92D7637451.avi,1577,61,1917,44,340,2
0X35042F01545BC7FB.avi,1216,103,1714,86,498,2
0X350970D6E6E3E907.avi,1270,89,2010,71,740,2
0X350C03638EC233F6.avi,1472,54,1934,39,462,2
0X350E5D4955052AFA.avi,1907,62,2103,43,196,2
0X350F6E738A333B5F.avi,1496,175,1907,155,411,2
0X3511A5055ECF66F0.avi,849,73,1470,54,621,2
0X35132DA02086E6C9.avi,1599,121,2467,100,868,2
0X3514BFDF02AF7035.avi,2361,55,2920,38,559,2
0X3515B5074318C90A.avi,843,123,1174,106,331,2
0X3517BDDF3F6BBF6.avi,1178,54,2088,34,910,2
0X351A2752679C0517.avi,2010,95,3383,76,1373,2
0X351BBD25D2E2FD44.avi,2707,120,3492,96,785,2
0X351E0C8099E00647.avi,1019,104,1755,91,736,2
0X3524E64F44633A40.avi,806,55,1409,41,603,2
0X3527A0143356B7F5.avi,1177,132,1611,114,434,2
0X352BAE1138127A5A.avi,858,161,1387,149,529,2
0X352D7150FCBFA7C1.avi,1142,46,1362,58,220,2
0X353238043903CF38.avi,1031,99,1708,84,677,2
0X3535658F5484B40F.avi,879,62,1451,50,572,2
0X353B18E085493A52.avi,909,49,1320,34,411,2
0X353EA59FF849AC98.avi,835,67,1349,51,514,2
0X3545F8A008B34ED0.avi,1019,66,1521,58,502,2
0X3549E46B61BE286D.avi,938,144,1423,129,485,2
0X354B37A25C64276F.avi,3485,38,3599,31,114,2
0X354BA7E7B96988A6.avi,1010,62,1808,45,798,2
0X354F4B874AED071B.avi,1435,186,2322,166,887,2
0X3555337FE7F02344.avi,1609,96,1877,83,268,2
0X3559536AF7F794B5.avi,1344,184,2167,167,823,2
0X355CFB6583C8DFAD.avi,851,51,1401,37,550,2
0X35607DFD91E00F2B.avi,1738,60,2489,44,751,2
0X3562C155F79822B7.avi,826,149,1219,130,393,2
0X3562CBA08DC6E30F.avi,1606,101,2736,79,1130,2
0X35656E25278C4CCC.avi,918,123,1567,110,649,2
0X356662E85B788616.avi,930,57,1420,42,490,2
0X356731D116D6F9A0.avi,1082,55,1611,40,529,2
0X3569758159E76E83.avi,1712,174,2110,151,398,2
0X356A6FCC675F2E7D.avi,1116,18,1780,2,664,2
0X356CFAC4B58D6D04.avi,1126,84,1789,64,663,2
0X35701918728819DC.avi,1025,138,1621,118,596,2
0X3571562B40FB6BF6.avi,1012,57,1682,37,670,2
0X3572B6AE5C661529.avi,1771,30,2200,20,429,2
0X3574D795ECA3735.avi,866,43,1374,29,508,2
0X357717818F4DA337.avi,1308,24,1556,5,248,2
0X3579BDBD3E3E2AF3.avi,690,87,1097,73,407,2
0X357D90B1EE59CC94.avi,1737,161,2703,122,966,2
0X3585426448E631FA.avi,901,53,1333,35,432,2
0X3587945D9CB88758.avi,1541,149,2339,131,798,2
0X3587F21A9977747D.avi,828,67,1393,59,565,2
0X358A9CDF953254F2.avi,1305,91,1784,76,479,2
0X358D5974FC807D32.avi,1264,143,1756,125,492,2
0X358EBA0C393EA18.avi,1024,16,1684,0,660,2
0X3590CC9889D55995.avi,1436,28,2262,15,826,2
0X35935529AAE83D83.avi,1363,12,1616,2,253,2
0X35943DCDA257FB3F.avi,1676,71,2602,53,926,2
0X35995BE8BB3A6D42.avi,1061,21,1785,2,724,2
0X359C6A18604089D0.avi,647,80,915,59,268,2
0X35A2E30EB9BB238F.avi,1129,16,1885,0,756,2
0X35A57DE1135380CA.avi,970,105,1733,87,763,2
0X35A5E9C9075E56EE.avi,1416,91,1781,44,365,2
0X35A78A31D8EC3E08.avi,1334,244,1838,226,504,2
0X35AA6B2F5D6AEF85.avi,1047,82,1634,70,587,2
0X35B6193459F647D0.avi,1386,73,2049,53,663,2
0X35BC863BEC069E1E.avi,1226,42,1724,29,498,2
0X35C02A1D71E0F261.avi,946,117,1423,95,477,2
0X35CF87872963F067.avi,2068,68,2835,47,767,2
0X35D71675B11A8F12.avi,1648,97,2806,78,1158,2
0X35DBF818D1E47758.avi,1387,88,2272,72,885,2
0X35DE4C4E8984305E.avi,1038,20,1480,2,442,2
0X35DE851D8AB0DF91.avi,1118,57,1660,36,542,2
0X35DFFC5BC8995375.avi,1405,71,2226,51,821,2
0X35ED1628AC7789FC.avi,1732,122,2684,107,952,2
0X35F13DAF9D23F2E0.avi,1157,66,1595,49,438,2
0X35F221108BCA1A20.avi,1676,59,2895,45,1219,2
0X35F5B1F089772D09.avi,1260,90,1905,77,645,2
0X35FEF9072E3537BB.avi,1397,200,2132,182,735,2
0X3600E5DB8324B05C.avi,740,65,1064,43,324,2
0X36029F349497FD71.avi,1348,88,2028,72,680,2
0X3606D9A467E6CE63.avi,1079,54,1519,39,440,2
0X3619CA422F4061D1.avi,1136,70,1845,54,709,2
0X3619FBB48260A469.avi,1144,71,1805,51,661,2
0X361BB885534EDDC4.avi,903,75,1487,56,584,2
0X361CC0F1626A8FC6.avi,897,93,1551,78,654,2
0X361DB800810D49EC.avi,1512,164,2493,143,981,2
0X36212648EAFF0B89.avi,855,13,1120,1,265,2
0X36225F52C1D2A015.avi,1349,22,1579,4,230,2
0X36250F8B6C5C2DCD.avi,688,71,1137,57,449,2
0X36273BA043E4849E.avi,1475,47,2643,35,1168,2
0X362AF0DB0ECE89E9.avi,1598,77,2167,65,569,2
0X362FD3C18A57E4AC.avi,1156,19,2054,0,898,2
0X363F29275ABC04D0.avi,1199,71,1832,52,633,2
0X3641C89EB2887277.avi,850,123,1419,104,569,2
0X3649FD731DF1B5B2.avi,645,68,865,50,220,2
0X364A30E94BB38C.avi,1857,18,3173,0,1316,2
0X364DAFDC16D92240.avi,1527,107,1673,90,146,2
0X3651598B0EB0AE89.avi,1550,58,1831,43,281,2
0X36558A226D3C4158.avi,2168,117,3590,100,1422,2
0X36560A1C88E0899A.avi,2025,120,2883,99,858,2
0X365705882E795EBB.avi,1037,91,1427,74,390,2
0X3658AEF1BA5BFF33.avi,1784,48,3135,31,1351,2
0X3659F7222EFAEE84.avi,1305,81,1965,61,660,2
0X365B2E9FB5F6E9A0.avi,2161,87,2504,70,343,2
0X365CD11BB171403B.avi,884,50,1258,36,374,2
0X365F36B9859AED91.avi,1070,75,1617,63,547,2
0X3662921D976FA535.avi,766,102,1247,83,481,2
0X3664FA96FA937A15.avi,1221,15,1980,0,759,2
0X3668D2C590A028AD.avi,1728,88,2754,71,1026,2
0X36694614F119F8BF.avi,1489,128,2249,112,760,2
0X366AD377E4A81FBE.avi,1515,3,1524,51,9,2
0X366D3126835759B6.avi,1136,112,1689,97,553,2
0X367085DDC2E90657.avi,1897,58,1971,114,74,2
0X36715FD73D74BF39.avi,2556,108,3307,93,751,2
0X3677ED237A9338F4.avi,1048,64,1670,47,622,2
0X3679A40BE82295C8.avi,3223,63,5181,50,1958,2
0X367B540BD67522AF.avi,641,87,1180,74,539,2
0X367CFA84878244FA.avi,859,93,1499,82,640,2
0X367EF3C5E490D06D.avi,930,99,1502,81,572,2
0X3680802CE73F0111.avi,2024,163,2424,137,400,2
0X36820DBFCD583F25.avi,1310,84,2015,63,705,2
0X36843785539A004C.avi,2380,103,2743,122,363,2
0X36854BD13E2D4031.avi,979,82,1459,71,480,2
0X36855520AF004067.avi,1783,137,2698,120,915,2
0X368A36C92FFEC550.avi,1539,71,2747,52,1208,2
0X368C8C18EE91FFC2.avi,776,173,1375,160,599,2
0X368E8CE3FB0A3F96.avi,1491,102,2057,79,566,2
0X368FA2713959D710.avi,1182,44,1978,35,796,2
0X369097280CAAF1E6.avi,2223,76,3183,52,960,2
0X3690E1CA5E40ABD6.avi,449,65,791,48,342,2
0X3693781992586497.avi,3629,47,3911,39,282,2
0X3693F13626B9A3E1.avi,998,69,1349,49,351,2
0X3694A8837AC5F707.avi,836,120,1447,103,611,2
0X3697C1B485A4B66C.avi,1388,98,1955,79,567,2
0X36980E4A755BAB70.avi,1633,118,1967,104,334,2
0X369B8F063DDD3DDE.avi,1493,31,1780,17,287,2
0X369D9859BEDE11F6.avi,955,58,1430,42,475,2
0X369F4745D75C926A.avi,864,174,1506,153,642,2
0X36A70C2755257C5F.avi,851,153,1309,135,458,2
0X36AD89AAE3FAF892.avi,870,20,1329,3,459,2
0X36ADC50A0EA70B99.avi,1056,17,1722,0,666,2
0X36AE471FEC81D0F8.avi,1408,96,2199,81,791,2
0X36AEAF74B90CDBD4.avi,1709,60,2693,45,984,2
0X36AEF23E46307423.avi,1423,106,2418,88,995,2
0X36B24AE5ABCC6260.avi,903,124,1466,106,563,2
0X36B33D2B6530F83E.avi,806,121,1250,106,444,2
0X36B356D92C89CA77.avi,1168,14,1680,3,512,2
0X36B5FD2DD0218534.avi,1265,77,2129,61,864,2
0X36B7933826909A38.avi,1053,78,1614,59,561,2
0X36B7C4AB8CD4B69E.avi,1085,62,1593,45,508,2
0X36BC020D616A1C3E.avi,1157,90,1964,69,807,2
0X36BC2C060ED9295.avi,1312,100,2051,78,739,2
0X36BD144912D456D8.avi,1199,140,1824,122,625,2
0X36BD2518C9D15985.avi,2577,50,2862,34,285,2
0X36C24B4CC763F804.avi,2251,60,3214,40,963,2
0X36C3A242D0282A79.avi,944,65,1593,45,649,2
0X36C4E7ECAA2BCBD9.avi,1121,48,1598,37,477,2
0X36C5A15AC7FC6AAA.avi,1467,58,1853,74,386,2
0X36C5DE35959702C2.avi,1344,185,2188,168,844,2
0X36C8D17C4AA7C806.avi,1003,57,1535,40,532,2
0X36CCD2D8878BA51D.avi,1031,98,1621,85,590,2
0X36CFD828F214D7F6.avi,1043,65,1692,51,649,2
0X36D558075BB74018.avi,1344,19,1881,2,537,2
0X36D59A17CA2C77AE.avi,2005,143,3105,119,1100,2
0X36DF7F18D6224D8E.avi,992,143,1467,130,475,2
0X36DFB3273B20DF4B.avi,963,110,1487,102,524,2
0X36E1B0D2F55F5083.avi,1023,21,1561,4,538,2
0X36E1F0560F36E313.avi,1423,140,1779,119,356,2
0X36E4468C9E659B89.avi,1626,21,2282,2,656,2
0X36E57BE2B11E4E3E.avi,1911,128,3028,116,1117,2
0X36E731545F69ECDC.avi,928,82,1475,66,547,2
0X36EAF76B49E25D66.avi,758,43,1297,32,539,2
0X36F52C92187D7452.avi,777,47,1100,33,323,2
0X36F9A84314FD103C.avi,1482,94,2216,73,734,2
0X36FB42EDBD9C3623.avi,999,95,1508,82,509,2
0X370587577A29EA9.avi,1649,90,2460,69,811,2
0X37065F92C8742D4B.avi,1248,62,2088,47,840,2
0X3706CECB0D52DB89.avi,767,44,1123,32,356,2
0X370BFF01AB719E61.avi,1323,132,2183,114,860,2
0X371AEF210253C983.avi,2386,49,2832,36,446,2
0X3721BAB9BF06CE82.avi,1259,61,1871,45,612,2
0X3723344573E75E5.avi,1089,104,1492,88,403,2
0X3725F884E49C387C.avi,1756,74,2665,53,909,2
0X3729DC43901DD07A.avi,1716,75,2890,53,1174,2
0X37307937DDFA46A9.avi,2756,61,4969,44,2213,2
0X3732593549EE8E29.avi,1159,140,1860,121,701,2
0X374099556945A9EA.avi,4498,132,6073,121,1575,2
0X3748E23FFEA283C6.avi,1509,129,1816,114,307,2
0X3752924AB02EDDE6.avi,1612,106,2182,88,570,2
0X3754A0841B209E31.avi,1488,202,2447,185,959,2
0X37580FDB4D1D140.avi,1185,56,2272,41,1087,2
0X375A84A3AAC32C67.avi,1620,59,2225,40,605,2
0X37671D9D80CCE804.avi,1453,15,2134,3,681,2
0X376C845E9F31E90D.avi,1156,16,2210,38,1054,2
0X3771953B5331C326.avi,2355,145,3698,120,1343,2
0X3774A913EC0A4ED0.avi,1013,19,1784,4,771,2
0X37761C666D82804F.avi,1244,72,1928,55,684,2
0X377A054F49B13FAE.avi,868,101,1333,81,465,2
0X377F8EF0A95F368.avi,943,42,1378,30,435,2
0X378127302CF37356.avi,928,48,1419,34,491,2
0X378691AE5C1F4D1.avi,1027,63,1704,47,677,2
0X378710053D7ED204.avi,965,108,1544,88,579,2
0X378B60986C2959FC.avi,922,116,1526,98,604,2
0X378B99020DEA60BA.avi,1776,81,2192,61,416,2
0X378C9BDA702A27CE.avi,1030,77,1572,61,542,2
0X378E08181E0B8BAA.avi,2500,17,3158,0,658,2
0X378F03AA6A00CE87.avi,1411,63,2290,44,879,2
0X3790431EBFD08B20.avi,1407,113,2291,99,884,2
0X379177330C90F7EA.avi,1975,66,2675,45,700,2
0X3793C26A31FEFF54.avi,1431,54,2250,37,819,2
0X379702FD21B373CE.avi,1109,89,1879,80,770,2
0X379A4AF7F8D17ACB.avi,1679,54,2495,42,816,2
0X379CA9FEA4B8D934.avi,603,118,1001,108,398,2
0X379D5D1F9907784D.avi,1326,64,1812,49,486,2
0X379DAAC5FF13821B.avi,1115,72,1697,56,582,2
0X37AA5019490DE956.avi,974,104,1272,84,298,2
0X37AA7B612514A839.avi,831,56,1403,43,572,2
0X37B267E780801BBA.avi,853,108,1395,95,542,2
0X37B5700D43C90E67.avi,1992,69,2193,56,201,2
0X37BFEEF205E5ACA3.avi,1873,143,2943,121,1070,2
0X37C22AD689BE34F.avi,929,74,1513,56,584,2
0X37C81FB4C90A9A3E.avi,1082,129,1630,114,548,2
0X37C99A3FE9350BA0.avi,1772,123,3149,105,1377,2
0X37D94E893C4F237C.avi,853,87,1365,74,512,2
0X37D9FB2652E17FC8.avi,3296,105,3822,87,526,2
0X37DA9BFFBB4A5DAE.avi,1075,83,1729,68,654,2
0X37E48E1504E3D89.avi,1482,97,2657,80,1175,2
0X37E6E6434A0C815B.avi,1081,68,1776,50,695,2
0X37EB51583A9D8E6C.avi,797,107,1242,89,445,2
0X37EED937EE5D531F.avi,2756,96,2907,87,151,2
0X37F75947334E0950.avi,1459,65,2371,50,912,2
0X37F9E9981E207C04.avi,3253,90,3932,75,679,2
0X37FF2E02E64FDC8A.avi,1058,109,1824,93,766,2
0X380404E9F3B02E7F.avi,2394,68,3408,52,1014,2
0X380AB851A1F1ECDC.avi,1211,95,1809,82,598,2
0X3811B3B600535B08.avi,1234,62,2221,46,987,2
0X38143F4D496E1C01.avi,893,60,1425,41,532,2
0X38145E7CC30DC7A5.avi,1234,93,1879,66,645,2
0X381609E5A502011E.avi,1230,52,2053,39,823,2
0X381864BFF92B7437.avi,1160,67,1989,49,829,2
0X381A1032716BDFE3.avi,1432,73,1876,58,444,2
0X381BBECABC1D6FB2.avi,2746,70,3131,54,385,2
0X381E0029617F214D.avi,911,128,1462,109,551,2
0X381F0E140D552666.avi,1773,73,2850,57,1077,2
0X3821E9F21EBFFF33.avi,1170,68,1947,56,777,2
0X38254D78E538011D.avi,1050,88,1616,71,566,2
0X3825F13C4A46F44C.avi,1277,114,1594,101,317,2
0X382685BB75B13E86.avi,1079,56,1796,39,717,2
0X3828251CB7F52FDE.avi,1007,65,1792,50,785,2
0X383838D5E679ACFE.avi,1482,133,1502,115,20,2
0X3838EE835D844578.avi,595,140,871,121,276,2
0X383AE9D85E471FEC.avi,1026,128,1546,115,520,2
0X383C974A8DDF5.avi,941,73,1474,56,533,2
0X3842C50FE6B2F4B1.avi,1682,83,2493,69,811,2
0X3845FCDDC728107D.avi,1446,82,2111,69,665,2
0X3846391F71AB9B06.avi,1046,146,1516,133,470,2
0X3847FF474B4D4AEB.avi,1596,83,2533,61,937,2
0X38491F42504861CA.avi,1262,393,1899,375,637,2
0X384933A479F6904F.avi,1342,138,2174,122,832,2
0X384A037668246F4E.avi,1948,149,2283,124,335,2
0X384AA2C9A3C82A61.avi,1053,109,1489,94,436,2
0X384B32F8B19D8E0.avi,1254,65,2027,50,773,2
0X384FCB5F752D8DCF.avi,1008,114,1361,93,353,2
0X385071ADD66846AD.avi,1413,30,1676,12,263,2
0X385229E934253438.avi,2586,113,4515,98,1929,2
0X3852798141EC72CD.avi,1066,157,1783,144,717,2
0X38553A64F1845D6.avi,985,110,1401,138,416,2
0X3856B31133D591F9.avi,1332,32,1782,18,450,2
0X385A1BC46A38CB5B.avi,1598,160,2000,139,402,2
0X385B21C57A42C5A1.avi,1025,66,1704,53,679,2
0X385C5071980C3241.avi,984,72,1632,59,648,2
0X385F55F9B1A71FD2.avi,1167,16,2131,1,964,2
0X3860318B66CC8557.avi,1004,59,1506,41,502,2
0X38638F441D35402.avi,2318,155,3064,135,746,2
0X386444FB91940E3D.avi,1101,89,1726,65,625,2
0X386924A6B430342A.avi,1336,103,1745,87,409,2
0X3869ABCAB47DF8C9.avi,968,148,1547,127,579,2
0X3869C8E146FBD123.avi,2151,109,3353,90,1202,2
0X386DAB52217592A2.avi,1524,184,2221,163,697,2
0X386E38E6214B10A1.avi,1160,69,1803,50,643,2
0X386E6F14BB2F2D6E.avi,792,50,1406,35,614,2
0X38715946C362E4A2.avi,1466,52,1755,38,289,2
0X3875F6FD6EDAC72B.avi,883,122,1472,103,589,2
0X3879A849BC662476.avi,970,70,1591,53,621,2
0X387C1FBF1C6448E6.avi,1049,102,1646,87,597,2
0X387CAAFEB15599D2.avi,2008,57,2878,39,870,2
0X387DC966A4E49FF7.avi,741,153,1117,132,376,2
0X387F179AFBFB9768.avi,760,46,1239,31,479,2
0X3881278C9B1525BD.avi,2436,71,3166,54,730,2
0X3885497D26EE0A1E.avi,1641,66,2595,52,954,2
0X388632531BB30B3C.avi,1361,67,1760,48,399,2
0X38879CF9F172C79.avi,1046,77,1721,54,675,2
0X389086C8EC0A5181.avi,1494,82,2283,58,789,2
0X3892C8528EDF3D78.avi,2455,74,3557,55,1102,2
0X3893725E893E66B1.avi,1445,90,2400,68,955,2
0X389455E41FE5B36.avi,2540,95,3481,72,941,2
0X389A53F8C76EB122.avi,1565,124,2125,112,560,2
0X389AE3058DF8A75A.avi,986,56,1447,40,461,2
0X389BA6B21FADB9D8.avi,1126,69,1643,51,517,2
0X389BC2B8D056A031.avi,1032,98,1602,85,570,2
0X389D268AC64FDF16.avi,1749,109,2384,96,635,2
0X38A0EAF624F7A247.avi,829,124,1271,107,442,2
0X38A2BB53562636BB.avi,1430,54,1687,37,257,2
0X38A3C665EF3925D1.avi,827,64,1375,45,548,2
0X38A74D84490F7CFF.avi,743,118,1300,108,557,2
0X38AD513F67133C37.avi,1205,185,1773,170,568,2
0X38AF259B8CB9ED38.avi,2098,153,2907,137,809,2
0X38B128C923F9718F.avi,1663,43,1915,29,252,2
0X38B537356485B1FB.avi,753,81,1176,65,423,2
0X38B6140101279B52.avi,959,128,1545,110,586,2
0X38BB67496B74ED43.avi,1328,383,2296,350,968,2
0X38BD4E9D7BE145D3.avi,1044,65,1625,49,581,2
0X38BF5A1070D6D922.avi,1388,169,2091,144,703,2
0X38BFE1C170679687.avi,1934,29,3082,4,1148,2
0X38C80D99FBBD1995.avi,967,143,1664,129,697,2
0X38CD1C45920A92B.avi,959,76,1432,61,473,2
0X38CE7A69D1AD269D.avi,1218,75,2117,59,899,2
0X38CFBFF9E0F722F7.avi,1219,15,1903,0,684,2
0X38D1523C8AC932CB.avi,648,74,936,51,288,2
0X38D5F0D5CCF21875.avi,903,131,1481,114,578,2
0X38D61BFC461E6880.avi,1165,61,1640,45,475,2
0X38D723B271A17254.avi,1488,102,2446,84,958,2
0X38D92BC43C1543C0.avi,1741,57,2990,38,1249,2
0X38D9D8D3E8CAD64D.avi,1144,114,1835,96,691,2
0X38DC5920EB30FD44.avi,1832,62,2596,45,764,2
0X38E23F5101349879.avi,942,100,1261,86,319,2
0X38E252DBA241D7A7.avi,930,56,1415,39,485,2
0X38E98D54857003CA.avi,1179,44,1774,30,595,2
0X38EA1D595376A658.avi,1179,168,2016,150,837,2
0X38EE2A5624ABAE2C.avi,1297,95,1988,78,691,2
0X38EEE406BC289A52.avi,2356,76,2656,58,300,2
0X38F5A46E6132A231.avi,1608,65,2266,49,658,2
0X38F6970A7694ECF5.avi,1075,143,1784,123,709,2
0X38FA13F5CA0BC79A.avi,669,166,1054,150,385,2
0X38FA5C50E4F65BA.avi,768,49,1176,34,408,2
0X38FD38D5BC7288D2.avi,1444,136,1786,118,342,2
0X3901B0181816DDB2.avi,1153,116,1663,107,510,2
0X3902A366CE2F62E8.avi,655,16,1076,49,421,2
0X3902FE711F8B581B.avi,1405,75,1989,56,584,2
0X39036C86D46D7EFF.avi,1127,145,1830,127,703,2
0X3904CF2713F4604D.avi,1082,138,1488,119,406,2
0X39051FE34AF2ABF2.avi,1356,106,2368,80,1012,2
0X390A2A0F25666BFB.avi,1223,42,1945,29,722,2
0X39123D0EB3886D8.avi,1106,18,1866,1,760,2
0X39159841194ACD89.avi,1800,95,3032,79,1232,2
0X3915AE4881C75F2E.avi,1190,55,1398,40,208,2
0X3915EB0A9DE6FDAF.avi,1940,96,2705,67,765,2
0X3917A23D1B120284.avi,823,41,1218,32,395,2
0X39207AF594BF77D7.avi,1838,69,3105,51,1267,2
0X3924FFA1465DC6E8.avi,1053,63,1655,47,602,2
0X3925BB805E197F96.avi,1456,88,2337,70,881,2
0X392B60853721DCCA.avi,1852,115,2769,97,917,2
0X392DB57364299195.avi,1459,74,2407,53,948,2
0X39316269EC98F850.avi,1115,92,1863,80,748,2
0X39348579B2E55470.avi,952,81,1527,53,575,2
0X39361D8B4B5EDFE8.avi,1354,17,1980,5,626,2
0X39386679DE7A85F9.avi,1041,63,1746,47,705,2
0X39391A4909EE1831.avi,1460,129,2577,114,1117,2
0X39430B9C27CAE73E.avi,1104,66,1637,52,533,2
0X3943402607F915DA.avi,877,90,1575,76,698,2
0X3957CF1AAADE25C.avi,955,46,1440,30,485,2
0X395E507F8ECA4193.avi,1520,135,2417,120,897,2
0X396631243C670596.avi,1158,104,1716,83,558,2
0X3967483E89F10A1E.avi,1860,64,3136,50,1276,2
0X39692AE83D7076F8.avi,806,76,1236,58,430,2
0X396B442D42E66666.avi,1168,77,1954,58,786,2
0X396ECCF27946B21C.avi,863,111,1387,97,524,2
0X3972F3D228C6973.avi,2298,133,3610,115,1312,2
0X39785B105916D907.avi,1463,65,2275,48,812,2
0X398111BC19E289A6.avi,1847,151,3105,136,1258,2
0X39812AAD22D1087E.avi,1620,11,1832,2,212,2
0X398198DD34B47AB6.avi,1324,42,2041,31,717,2
0X3982C7E5ECE74699.avi,2010,106,2417,89,407,2
0X398379987B3E5DE0.avi,1422,57,2323,42,901,2
0X39878B4033C03C7A.avi,1264,106,1922,89,658,2
0X3988D1B584CBEC93.avi,1347,69,1590,49,243,2
0X398B7A013EC01F9A.avi,735,74,1196,64,461,2
0X398F29049BB32013.avi,1378,146,1842,136,464,2
0X3991463690B05802.avi,1342,57,2736,44,1394,2
0X39972DF04C904BF8.avi,976,20,1816,4,840,2
0X399873AFA4B674D6.avi,1863,13,3508,1,1645,2
0X3999802A1B03A98E.avi,3394,136,3892,111,498,2
0X3999AFEE5AF07F42.avi,1739,69,1878,58,139,2
0X399C53F778C73E41.avi,1840,76,2533,58,693,2
0X399F9331838E32BE.avi,878,110,1501,99,623,2
0X39A128E3A510782.avi,1190,58,2073,40,883,2
0X39A85FA14F06B62D.avi,1001,95,1663,82,662,2
0X39AAB4E253F2AEAD.avi,1388,123,1805,105,417,2
0X39AB3B74095BAC3D.avi,894,14,1189,3,295,2
0X39AE5B2F372542EE.avi,867,122,1425,108,558,2
0X39B358EAE5C1A47.avi,1112,71,1657,50,545,2
0X39B757B79F8A81FE.avi,1117,119,1928,102,811,2
0X39B8C93985E7FC88.avi,1283,98,1965,86,682,2
0X39BB31692C2E764B.avi,964,15,1641,5,677,2
0X39BE5E9C68E021D2.avi,1335,60,2185,48,850,2
0X39C79919BCB7B445.avi,1371,113,2105,97,734,2
0X39CA8CC96A5D5E8B.avi,1814,50,2299,32,485,2
0X39CC8C89DE6060B7.avi,1009,109,1591,95,582,2
0X39CCCA303517758C.avi,1455,61,2394,49,939,2
0X39CD6157F36F9824.avi,1863,112,2618,95,755,2
0X39CF332039C0D5F.avi,963,84,1522,62,559,2
0X39D01FC74E846311.avi,681,64,1058,55,377,2
0X39D0A18C20873B10.avi,1989,80,3317,64,1328,2
0X39D1558A3C02EC2D.avi,894,172,1400,156,506,2
0X39D4ACDFC707D00C.avi,783,134,1151,117,368,2
0X39D64C26334E84BB.avi,1457,60,2152,36,695,2
0X39D6D1217FE384B1.avi,1040,70,1793,51,753,2
0X39D91890A1999E8.avi,881,182,1212,163,331,2
0X39E11EB4ED0DB0B7.avi,1483,96,1627,84,144,2
0X39E19BB2FA344EA3.avi,1008,78,1574,63,566,2
0X39E3FD0C9DB2E14C.avi,1141,66,1660,57,519,2
0X39E53D97C96FAAAB.avi,1712,94,2823,79,1111,2
0X39E5EE69D1ABD158.avi,668,107,1050,99,382,2
0X39E6A4F87A2B6A88.avi,1781,57,2280,43,499,2
0X39E992259898874A.avi,915,50,1313,34,398,2
0X39EF484992C44E9D.avi,1230,108,2140,91,910,2
0X39F0C16E2A50442A.avi,1086,137,1800,124,714,2
0X39F5B35EA80E4D86.avi,1433,95,2281,80,848,2
0X39F7878941FCCEE3.avi,1054,28,1808,8,754,2
0X39F8C168B5299BA6.avi,1083,55,1918,39,835,2
0X39FCEE4F2B02701B.avi,878,13,1111,0,233,2
0X3A016DA394E94ED8.avi,1411,129,2149,116,738,2
0X3A04B8BB685836CB.avi,2189,63,3865,42,1676,2
0X3A04D1EE256B301E.avi,1001,14,1509,1,508,2
0X3A067F55DF845A2E.avi,1259,103,1794,87,535,2
0X3A0FE82D5FCB1393.avi,1728,59,2961,43,1233,2
0X3A1243389B03E037.avi,1299,74,2080,57,781,2
0X3A1256ABF660B385.avi,1267,85,2101,70,834,2
0X3A129451EC32992C.avi,1031,176,1649,157,618,2
0X3A15E907186AA019.avi,736,65,1159,49,423,2
0X3A162CB5BE129444.avi,1667,73,2427,61,760,2
0X3A170C20A679FBB4.avi,1531,41,2190,30,659,2
0X3A1B3966D331F29B.avi,1228,90,1845,76,617,2
0X3A21DB8AEB6B5B20.avi,1858,19,2144,7,286,2
0X3A24403843DE9A9F.avi,909,179,1530,158,621,2
0X3A2C0C6E64CD5F3D.avi,1129,70,1763,55,634,2
0X3A2DE690A0917A75.avi,1093,52,1607,39,514,2
0X3A3085150FD2D6E8.avi,1852,60,2755,40,903,2
0X3A309F6036FF0518.avi,959,67,1542,50,583,2
0X3A30AB065E7F6735.avi,719,74,999,61,280,2
0X3A34B1EB60C2A9AE.avi,841,152,1431,135,590,2
0X3A381225412BA53C.avi,1747,111,2613,94,866,2
0X3A46A45145C2FF9B.avi,1238,64,1903,50,665,2
0X3A493A5E7BC5B076.avi,940,118,1588,101,648,2
0X3A4D1AFE98C8476B.avi,1221,99,1880,79,659,2
0X3A58A66B6AF3DE55.avi,1080,58,1802,43,722,2
0X3A5F75A015056908.avi,737,103,1314,90,577,2
0X3A6035ED10B83B7.avi,1920,86,3049,60,1129,2
0X3A6437E8004F6401.avi,1331,114,2103,98,772,2
0X3A66D46DC689ADD2.avi,1385,71,2068,52,683,2
0X3A67F07292B0D9D4.avi,1317,96,2171,79,854,2
0X3A689C00E2F6EE71.avi,1053,68,1319,57,266,2
0X3A6A8F1ED1A86F94.avi,1218,15,1968,3,750,2
0X3A6E1BAA9065D40.avi,1925,45,2981,35,1056,2
0X3A6E9277ED871C65.avi,651,61,1030,45,379,2
0X3A7280211A9AC1E3.avi,982,53,1666,37,684,2
0X3A73982E9C3E2D12.avi,1206,49,1818,38,612,2
0X3A76AD5CC9D50E57.avi,812,139,1241,120,429,2
0X3A7787951A5869B1.avi,1052,76,1905,62,853,2
0X3A78E8C699486EDF.avi,1564,51,2544,36,980,2
0X3A79044052AC3197.avi,614,78,1128,52,514,2
0X3A7952D92A293CE8.avi,948,94,1553,82,605,2
0X3A7E305F4B67D1B5.avi,1139,89,1770,76,631,2
0X3A810212F92EEBFB.avi,1316,59,2083,43,767,2
0X3A84F1E3BCC9B6E6.avi,1031,76,1376,56,345,2
0X3A8625DCFA369F48.avi,1086,118,1448,101,362,2
0X3A87C4BE51F04CDA.avi,1006,65,1534,46,528,2
0X3A8CA79BEA19FD1F.avi,1185,18,1876,0,691,2
0X3A8ED493DA57D7C9.avi,997,63,1562,45,565,2
0X3A8F6D088C91167E.avi,1409,68,2121,48,712,2
0X3A9F57EC10C1BAC7.avi,975,51,1603,37,628,2
0X3AA01BE48EE8D367.avi,942,52,1410,39,468,2
0X3AA1B577666CC8F2.avi,1050,53,1629,37,579,2
0X3AA31784B8E430AF.avi,1102,47,1697,34,595,2
0X3AA99E66716364B0.avi,1382,103,1833,90,451,2
0X3AAD7B4B21165095.avi,1232,169,1937,159,705,2
0X3AAFF6ACE7FF7530.avi,1003,59,1547,42,544,2
0X3AB11C73780B865.avi,717,61,1234,47,517,2
0X3AB210C90632B5E3.avi,1669,127,2146,104,477,2
0X3AB5343A178908A5.avi,963,100,1585,89,622,2
0X3AB7B94F0A6C3A4C.avi,1196,110,2068,94,872,2
0X3AB82E8B51CB82B4.avi,1429,57,2021,38,592,2
0X3AC15CD077FEBB79.avi,994,56,1561,42,567,2
0X3AC3331F9A0AF935.avi,826,16,1404,2,578,2
0X3AC5CEEB4DAAF8BF.avi,2073,157,2306,137,233,2
0X3AC5EFB793652CF6.avi,1837,149,2256,128,419,2
0X3ACB543DE5B8DC6E.avi,950,78,1693,58,743,2
0X3ACD9DB45C258269.avi,790,105,1293,97,503,2
0X3AD4B9300F9748BC.avi,1082,64,1429,43,347,2
0X3ADFA6B8CB1E4B50.avi,1065,126,1463,107,398,2
0X3AE208A723F16D85.avi,1362,102,2246,86,884,2
0X3AE232F2E17B6E19.avi,1766,88,2120,65,354,2
0X3AE5CD9B4520576A.avi,908,95,1514,74,606,2
0X3AE5DC56D2D6EB43.avi,1950,63,3402,45,1452,2
0X3AE781FF538E7AB3.avi,1017,82,1624,67,607,2
0X3AE7ECDB6EF083C6.avi,1110,87,1535,72,425,2
0X3AEB0F3ACC9C5F9E.avi,1702,162,2758,142,1056,2
0X3AF27BD1C1A050F1.avi,1237,39,1950,27,713,2
0X3AF341668970568D.avi,1084,98,1658,82,574,2
0X3AF4F78B11EE5786.avi,1194,62,1887,53,693,2
0X3AF6861FF7D6EBE4.avi,807,99,1458,72,651,2
0X3AF7715F4850205C.avi,852,71,1272,56,420,2
0X3AFBEFE4316A347D.avi,856,69,1349,51,493,2
0X3AFC37AB794657DD.avi,981,128,1590,115,609,2
0X3B01B7487E3D81EA.avi,1901,114,2186,97,285,2
0X3B051BD857A8B444.avi,1357,18,1729,4,372,2
0X3B08A5A9B4068C8.avi,919,105,1520,91,601,2
0X3B0C001E8B03BB10.avi,1853,76,2092,53,239,2
0X3B0D2D527C387A0E.avi,1580,65,2045,52,465,2
0X3B0DB4D5A796D849.avi,1793,84,1962,64,169,2
0X3B0EFA9B23EC8818.avi,1135,53,1910,36,775,2
0X3B14BC7494925CB4.avi,1234,25,1637,6,403,2
0X3B1588F22CB71934.avi,1042,76,1774,62,732,2
0X3B1FFC28D7B1CE3B.avi,810,69,1328,52,518,2
0X3B22750F2A0F254A.avi,1813,60,2805,40,992,2
0X3B23F68C62732572.avi,1589,80,1877,60,288,2
0X3B296AB590431282.avi,978,46,1701,31,723,2
0X3B2972B434AE6A78.avi,1082,14,1869,2,787,2
0X3B2B0A52DE5AD1A8.avi,1005,137,1387,117,382,2
0X3B2F240FF65AE41B.avi,934,73,1469,61,535,2
0X3B30E66FEF073895.avi,694,85,1117,68,423,2
0X3B31E6C62C7C6591.avi,1043,15,1360,1,317,2
0X3B31EB8AE613B1A7.avi,1759,129,2230,105,471,2
0X3B32C9427B83BD8A.avi,1068,71,1702,54,634,2
0X3B331163E39CA813.avi,740,37,1242,29,502,2
0X3B33B2D734EC62BD.avi,1138,76,1595,62,457,2
0X3B364B92D87FAE47.avi,1610,63,2524,47,914,2
0X3B466B406FD980EF.avi,1101,64,1776,48,675,2
0X3B4FD958BC21357A.avi,1035,47,1647,32,612,2
0X3B54A5459841DCE8.avi,1268,197,2104,182,836,2
0X3B54F8E8FCFF40EB.avi,2571,78,3015,62,444,2
0X3B552B3CA7ADCD4.avi,1544,84,2433,60,889,2
0X3B56BE7AED85F78A.avi,977,53,1605,35,628,2
0X3B578029793AD7B5.avi,1092,24,1670,2,578,2
0X3B5BFB5AC9060009.avi,1313,63,1814,45,501,2
0X3B5F7979D1C544AC.avi,1178,177,1801,160,623,2
0X3B62B3502E5549A.avi,771,61,1123,49,352,2
0X3B631332E2C4EEC3.avi,994,44,1472,32,478,2
0X3B6528FD917A0E82.avi,1810,68,2928,47,1118,2
0X3B678EDC4E4A37B7.avi,1045,46,1936,31,891,2
0X3B67E74D2C8F04BB.avi,860,48,1341,36,481,2
0X3B6A2EE83A5CFB1B.avi,1180,120,1953,106,773,2
0X3B6EA00B1D3C01D5.avi,1085,75,1693,55,608,2
0X3B6EBD8C8C9A9567.avi,1436,164,1838,143,402,2
0X3B73EAA40F02D974.avi,869,121,1521,101,652,2
0X3B75427EFE40B784.avi,2417,110,2924,88,507,2
0X3B76E85F3FFFB9B2.avi,704,72,1181,47,477,2
0X3B7727089F2566F0.avi,1015,53,1594,37,579,2
0X3B7AA5C59BF84FDA.avi,935,102,1562,88,627,2
0X3B7D20FAB496DF62.avi,2075,22,2812,0,737,2
0X3B803011C96CBE78.avi,1360,50,2122,36,762,2
0X3B80677CE0873E50.avi,1736,62,2474,47,738,2
0X3B82E9714CF3B6A4.avi,1726,108,2679,93,953,2
0X3B877CAB3CE51ED3.avi,921,99,1506,83,585,2
0X3B8E49B631D4E9AA.avi,677,59,908,46,231,2
0X3B91490FC40F157E.avi,1578,73,1999,54,421,2
0X3B931BE44B0F7CEF.avi,834,70,1327,58,493,2
0X3B94C97A61200FCC.avi,1618,72,2586,55,968,2
0X3B9D7438096AB76B.avi,919,64,1384,44,465,2
0X3B9FBD87EE113D62.avi,1337,160,2054,144,717,2
0X3BA12609E25A458F.avi,2491,127,3959,111,1468,2
0X3BA376E0E5A67F4C.avi,2122,66,2944,47,822,2
0X3BA391DC362B4BE7.avi,1276,67,1912,51,636,2
0X3BA6403DB9C2AD71.avi,777,55,1333,40,556,2
0X3BA9F7C9DB0CF55B.avi,1572,35,2833,0,1261,2
0X3BAA632C6C366B61.avi,1020,142,1621,126,601,2
0X3BAE126085E973A0.avi,1003,115,1621,91,618,2
0X3BB173537B79E344.avi,1860,229,2616,205,756,2
0X3BB32EDB13EC2A74.avi,2333,73,4177,50,1844,2
0X3BB510E550819AA2.avi,693,19,1236,1,543,2
0X3BB59C8B26565746.avi,1011,59,1649,45,638,2
0X3BB8002E0FD6110F.avi,627,54,1026,42,399,2
0X3BBB2B7BE7446182.avi,1846,62,2690,47,844,2
0X3BBE4D476015547F.avi,1130,18,1846,0,716,2
0X3BBFB5A8F09489E2.avi,1882,89,2888,76,1006,2
0X3BC39D4DEBF4DF5F.avi,962,115,1334,95,372,2
0X3BC67725F75CEB00.avi,1173,79,1651,58,478,2
0X3BC79FE68CD2CED5.avi,1524,100,2419,85,895,2
0X3BCAEEF6C5EE3565.avi,3675,29,4207,21,532,2
0X3BD7B111C743A3E8.avi,815,32,1208,20,393,2
0X3BD86D7A28CDA981.avi,990,15,1729,0,739,2
0X3BDD6A56EDE84B37.avi,1306,125,2096,107,790,2
0X3BE0524B897D6DCF.avi,952,59,1506,45,554,2
0X3BE346AF6B1F7F3D.avi,1877,94,3345,77,1468,2
0X3BE3B298ACB92FB1.avi,663,164,1058,151,395,2
0X3BE4253D023C725E.avi,1209,91,1836,68,627,2
0X3BE4BB11401AFD70.avi,1275,67,1923,47,648,2
0X3BE6ED32D643E96.avi,1183,61,2104,42,921,2
0X3BE6EEE3814E2D16.avi,1556,62,2669,45,1113,2
0X3BEEF9FC14A7E660.avi,1224,102,1503,82,279,2
0X3BF2052B5989097E.avi,785,65,1337,50,552,2
0X3BF45BED0E9423D0.avi,1036,54,1531,42,495,2
0X3BF4EAA8E0239D15.avi,1062,57,1622,43,560,2
0X3BFAE73D52A18389.avi,2663,32,3439,12,776,2
0X3BFC66B250CE89A9.avi,1037,105,1738,94,701,2
0X3BFD07170E3ECF82.avi,937,128,1670,116,733,2
0X3BFFB8615C86AE75.avi,1321,72,2029,56,708,2
0X3C01B72B850884FE.avi,841,75,1296,55,455,2
0X3C05A6B4BBA623EB.avi,1362,17,1720,0,358,2
0X3C0B954729E57D23.avi,997,104,1670,77,673,2
0X3C0E58FD3198CE78.avi,567,87,906,75,339,2
0X3C10C1CAA3095680.avi,1109,59,1629,46,520,2
0X3C10FEA4A7AA072E.avi,1104,143,1933,132,829,2
0X3C1488440F282158.avi,1152,101,1867,86,715,2
0X3C1724919FD1F5F3.avi,1604,74,2335,60,731,2
0X3C18E7594F18AEB9.avi,890,102,1548,84,658,2
0X3C1C3E87980982AA.avi,1246,48,1374,35,128,2
0X3C1D516F4D4D105B.avi,1018,82,1750,64,732,2
0X3C1E9131F69E4821.avi,1858,154,2766,135,908,2
0X3C1F4A30EA25362E.avi,899,54,1463,36,564,2
0X3C207E8489AD5BAE.avi,1089,114,1840,100,751,2
0X3C214412B9774A5C.avi,1426,105,2335,95,909,2
0X3C2544AC6E008D62.avi,876,71,1415,51,539,2
0X3C28EECDC72E0A31.avi,997,122,1726,108,729,2
0X3C29707A418FF73A.avi,787,55,1181,44,394,2
0X3C2DCCC974C5380D.avi,732,64,1212,42,480,2
0X3C2E350B97C8F6CD.avi,1045,53,1591,40,546,2
0X3C3AAA44DBD1EC3D.avi,1610,78,2902,62,1292,2
0X3C3C53B0F4B5AD69.avi,858,106,1323,90,465,2
0X3C3C930EC09E4FA0.avi,1063,79,1471,64,408,2
0X3C456FD0C7FE2F99.avi,1351,81,2036,70,685,2
0X3C48AA6205472D1F.avi,1893,83,2320,70,427,2
0X3C4A698888698E8D.avi,1691,77,2297,55,606,2
0X3C4BE41655860B16.avi,1434,236,2526,209,1092,2
0X3C4F8E30B6FB805F.avi,1178,118,1768,102,590,2
0X3C539D3821B4C6C3.avi,640,156,917,133,277,2
0X3C53CAB06AA69C4E.avi,759,44,1324,32,565,2
0X3C56DA933D255BF8.avi,1159,160,1905,143,746,2
0X3C5A6B5C6A66C7C0.avi,819,147,1248,136,429,2
0X3C5E3047DEC19504.avi,1275,73,2062,60,787,2
0X3C63C23E5B0823D.avi,1533,0,1612,15,79,2
0X3C67FDA7B1C1ECFB.avi,957,52,1702,40,745,2
0X3C68A75B6DE0D08C.avi,806,41,1410,31,604,2
0X3C6F96F86CD908BD.avi,1075,139,1652,121,577,2
0X3C7BC046308348F6.avi,950,91,1596,74,646,2
0X3C7E3932E8C3BFFE.avi,980,84,1518,66,538,2
0X3C7EF15C4B7BEEA1.avi,1060,55,1511,40,451,2
0X3C8AE3EFC3758990.avi,2390,86,3019,67,629,2
0X3C8EB3097C147507.avi,1701,17,2764,4,1063,2
0X3C9463D76CD9D31D.avi,1164,128,1856,109,692,2
0X3C990664C618D934.avi,745,20,1195,4,450,2
0X3C9E605F756EA1A7.avi,1040,19,1655,3,615,2
0X3CA062FAAA9EFB99.avi,1058,170,1586,150,528,2
0X3CA164EF7A7C434E.avi,2303,61,2437,47,134,2
0X3CA5F8D4ADB6829.avi,1216,58,1889,44,673,2
0X3CA6AD191674E7F3.avi,1373,78,2321,60,948,2
0X3CB03161634EC101.avi,1133,70,1494,53,361,2
0X3CB10C063C914079.avi,916,170,1503,155,587,2
0X3CB30E851B8FBC78.avi,844,68,1482,54,638,2
0X3CB7489A1A24C46B.avi,2016,71,2888,53,872,2
0X3CBDF15DCB01AF08.avi,979,99,1721,83,742,2
0X3CC1B60D1EB0CC43.avi,1355,99,2293,73,938,2
0X3CC2AB71D7704B20.avi,2395,68,2723,54,328,2
0X3CC63FF01D85B689.avi,686,57,1179,43,493,2
0X3CC86A7AC66865CC.avi,1909,130,2747,109,838,2
0X3CCC712117D9D487.avi,1061,40,1593,29,532,2
0X3CCC98A57DEBD70F.avi,1203,20,2210,0,1007,2
0X3CCE67A145CD0C46.avi,915,142,1437,121,522,2
0X3CD460CFB766061A.avi,696,39,1077,28,381,2
0X3CD5272915885147.avi,816,97,1619,85,803,2
0X3CDBEFCEB9B8880A.avi,1057,65,1671,48,614,2
0X3CE02140AB9185AA.avi,1102,17,1600,2,498,2
0X3CEA8556432BE7BC.avi,1028,148,1597,127,569,2
0X3CEEFB97FDD529F6.avi,1564,124,2715,111,1151,2
0X3CF4BCE027237660.avi,680,107,1047,91,367,2
0X3CF60A132BD7B415.avi,1127,36,1463,24,336,2
0X3CF7C368106B59F2.avi,1406,45,2169,30,763,2
0X3CF920996FE95ADD.avi,1500,58,2354,41,854,2
0X3CF93606C249E004.avi,774,129,1242,108,468,2
0X3CF952AD9FD34D08.avi,1658,63,2075,51,417,2
0X3CFB24DC0CD3A91E.avi,900,145,1621,124,721,2
0X3CFBD509C0C1139C.avi,1091,105,1789,88,698,2
0X3D02DA95E6C72181.avi,1745,55,2135,39,390,2
0X3D045BDA30F1FBBC.avi,1448,234,2364,209,916,2
0X3D04E9B90266352E.avi,1335,79,1687,62,352,2
0X3D058CE72C565376.avi,1005,68,1737,49,732,2
0X3D07B11AAF49F722.avi,1257,123,1840,107,583,2
0X3D0F47DF1809F2DD.avi,1018,16,1531,2,513,2
0X3D1241A509AEDD5D.avi,1323,143,1998,116,675,2
0X3D1676A87AECCD69.avi,695,77,1102,64,407,2
0X3D1BC917DF22CD1C.avi,717,122,1083,111,366,2
0X3D27B5899DFF0F5B.avi,903,163,1431,151,528,2
0X3D2B3C9081953DBF.avi,986,97,1571,79,585,2
0X3D2FBDFA09694A20.avi,1135,82,1814,66,679,2
0X3D39E510C89F3D8A.avi,857,53,1319,38,462,2
0X3D3A944C969D30E.avi,1986,82,2925,63,939,2
0X3D3B33569911F8E9.avi,802,101,1412,86,610,2
0X3D3DB395AA082092.avi,1523,87,2320,71,797,2
0X3D3F1825094494A8.avi,1038,72,1423,60,385,2
0X3D403DF4736012FA.avi,907,98,1455,80,548,2
0X3D407167B0EA095C.avi,900,152,1330,137,430,2
0X3D41C6447029BE0E.avi,1251,100,1865,83,614,2
0X3D42EBE6DAD6A388.avi,848,107,1343,86,495,2
0X3D451D3B3946A2D.avi,1996,97,2803,81,807,2
0X3D490017BDE7B6EE.avi,2517,132,3135,104,618,2
0X3D536804F75D24EB.avi,1509,88,2213,72,704,2
0X3D5444E2DD4FB625.avi,2544,81,3998,60,1454,2
0X3D595A1C7728A00B.avi,844,73,1290,54,446,2
0X3D5C0E6B4A194D33.avi,1940,55,2769,39,829,2
0X3D5F894D74A3D21C.avi,1527,134,1828,121,301,2
0X3D63829F3F3D8C85.avi,1296,79,1839,63,543,2
0X3D66A6CF6230C66.avi,1663,49,2848,32,1185,2
0X3D6D79A159FD4A12.avi,2582,123,3004,108,422,2
0X3D6E773C9BEA8474.avi,2354,134,4428,115,2074,2
0X3D74EF75B61DFE76.avi,1141,269,1714,237,573,2
0X3D7715AB0A91C268.avi,1944,88,2639,62,695,2
0X3D775CE5815FC482.avi,1107,117,1894,100,787,2
0X3D7C7B6AFF1A89F9.avi,1455,114,2464,94,1009,2
0X3D829DE5E49B5761.avi,829,57,1633,40,804,2
0X3D8353611168F743.avi,885,58,1305,43,420,2
0X3D856D0C128BEF63.avi,1274,67,2016,43,742,2
0X3D858B954AD5D2FA.avi,1381,58,2223,41,842,2
0X3D8A8864DB8B12E.avi,1063,67,1642,53,579,2
0X3D8B6D455EECFE25.avi,1454,68,2243,48,789,2
0X3D8EE56C7B00E120.avi,1951,89,2314,62,363,2
0X3D93FC3FB436EC51.avi,1292,68,1554,54,262,2
0X3D94B49D5A396636.avi,1546,150,2700,131,1154,2
0X3D9576C39233FCCF.avi,1410,15,1550,4,140,2
0X3D982D1B05D54EE.avi,677,17,1151,2,474,2
0X3DA2B290B58A6540.avi,2045,68,2556,49,511,2
0X3DAB48A224B6D7D8.avi,833,14,1179,0,346,2
0X3DAD6456C3A92CD6.avi,1316,145,1997,127,681,2
0X3DAEE457C2318B8.avi,1095,52,1680,41,585,2
0X3DAFB661E3500C9F.avi,2007,62,2122,52,115,2
0X3DB63E43A23F46D3.avi,790,120,1134,101,344,2
0X3DB7EB2C0003CD50.avi,1209,48,1871,32,662,2
0X3DBA4134C729B96D.avi,888,66,1294,50,406,2
0X3DBBF3506D11ACF5.avi,1180,87,1802,71,622,2
0X3DBF6E850E8E7FA.avi,707,6,1146,1,439,2
0X3DC0EC09F9CDBCCB.avi,1190,74,1743,54,553,2
0X3DC339BAEDC91F8C.avi,1407,65,2304,49,897,2
0X3DC771421B48F300.avi,1112,104,1783,90,671,2
0X3DC981FD3E796896.avi,1635,14,2088,0,453,2
0X3DCE831133A8B66C.avi,1148,78,1913,60,765,2
0X3DD2E68A5BE7A4FE.avi,857,149,1441,129,584,2
0X3DD6E63CFB42333E.avi,1455,15,2275,4,820,2
0X3DD8AAB0045765B9.avi,2126,136,2433,113,307,2
0X3DDFCD65C68B3AF6.avi,1819,70,2472,53,653,2
0X3DE081EA128A37EB.avi,1447,132,2215,116,768,2
0X3DE5250E0FF122E3.avi,939,12,1649,0,710,2
0X3DEB26CCC9E0393A.avi,1111,68,1604,51,493,2
0X3DEBAD684DB64050.avi,1196,101,1823,84,627,2
0X3DEC46D1B8397CDE.avi,1091,34,1287,27,196,2
0X3DF087AF1FA33A0A.avi,1402,57,2028,41,626,2
0X3DF459E0724B3BC.avi,851,74,1520,54,669,2
0X3DF564B9BA59AC74.avi,1095,136,1589,121,494,2
0X3DF694B393734B26.avi,686,132,1465,119,779,2
0X3DF6E49145C3F553.avi,1198,58,1878,41,680,2
0X3DF926CE61E8DE9.avi,953,68,1201,51,248,2
0X3DFD53597B122E4B.avi,1166,138,1923,122,757,2
0X3E00E41595F7FD72.avi,1354,89,1791,69,437,2
0X3E04B170778411F9.avi,736,137,1162,121,426,2
0X3E0D058327AC7898.avi,1184,69,1703,50,519,2
0X3E14A0D52DE6AB3E.avi,953,107,1637,96,684,2
0X3E15B2CD0D7FFFEB.avi,1310,56,1673,41,363,2
0X3E15E5CD8C70443D.avi,1191,74,2156,56,965,2
0X3E1E76F3876FA4CB.avi,1149,106,2110,90,961,2
0X3E201401ADFBC022.avi,1846,60,2031,44,185,2
0X3E22D89049C5F9BA.avi,1245,43,2198,31,953,2
0X3E2557960F25996A.avi,1117,63,1883,49,766,2
0X3E26D7B4C74C467C.avi,1240,40,1495,28,255,2
0X3E2841AEE0E86911.avi,1044,83,1369,67,325,2
0X3E28448D6D5B8AA1.avi,1114,88,1844,77,730,2
0X3E29ABEC75D557EB.avi,1511,98,2018,79,507,2
0X3E2C9B9D3AAE8365.avi,948,137,1916,118,968,2
0X3E2F182038897EA5.avi,868,50,1183,35,315,2
0X3E3207C0977DED20.avi,1797,71,2069,58,272,2
0X3E3C352FEA13FFF3.avi,1461,62,2374,45,913,2
0X3E3D4ED914A2CC26.avi,691,59,917,49,226,2
0X3E3D520FC52F1206.avi,1137,62,1657,43,520,2
0X3E410467C49E2577.avi,1065,155,1713,140,648,2
0X3E41F86EDA927362.avi,2003,89,3085,68,1082,2
0X3E423D83A5D8629A.avi,814,111,1204,97,390,2
0X3E4992933C229E41.avi,1075,96,1756,78,681,2
0X3E4E93103612D991.avi,1113,121,1801,106,688,2
0X3E4F117C74E7789D.avi,1204,55,1881,39,677,2
0X3E512A22832F853E.avi,1819,68,2810,52,991,2
0X3E519478152D535B.avi,1297,130,2263,111,966,2
0X3E54E90C8CF89B22.avi,1017,111,1801,98,784,2
0X3E554757948CE381.avi,1076,59,1862,41,786,2
0X3E561D7327B975CB.avi,2754,67,4552,51,1798,2
0X3E56DED8582F762B.avi,861,131,1397,116,536,2
0X3E5B5FCDCC9F9D5.avi,1359,122,2018,107,659,2
0X3E5EDF4D13CA55D7.avi,1129,13,1685,0,556,2
0X3E616DCE18D8B5DA.avi,1985,111,2983,93,998,2
0X3E6339FE3313BF65.avi,1009,191,1629,172,620,2
0X3E65996D18F7EA4A.avi,1829,66,2612,48,783,2
0X3E663E38BC70B73C.avi,1420,20,2129,2,709,2
0X3E6901D663EA8922.avi,2128,61,2932,42,804,2
0X3E6A113EC1BA37C2.avi,925,100,1546,85,621,2
0X3E6AE8BEB9B6DBD4.avi,1195,48,1717,31,522,2
0X3E73331470DA4030.avi,837,19,1367,1,530,2
0X3E767AC5BF9A0089.avi,889,59,1263,42,374,2
0X3E778B07970A2940.avi,851,132,1430,108,579,2
0X3E786535782F9C5F.avi,891,73,1445,55,554,2
0X3E7951D6403EC835.avi,956,98,1489,83,533,2
0X3E79B6F78B6B7331.avi,1905,85,3108,70,1203,2
0X3E7A22F643CCEC3E.avi,1284,51,2107,36,823,2
0X3E822C675DD2B6A3.avi,1434,63,2638,43,1204,2
0X3E84E059A32F47E0.avi,1193,49,1424,31,231,2
0X3E880A36CEE7240D.avi,1225,105,2036,86,811,2
0X3E8B36F8E715DED1.avi,1505,14,2302,2,797,2
0X3E8B547584BD000D.avi,1258,101,1855,104,597,2
0X3E8D8B4A87FECF17.avi,1508,122,2344,109,836,2
0X3E8E8C0F87FF65BF.avi,1192,64,1755,49,563,2
0X3E91DA6C6799C069.avi,1563,83,2621,67,1058,2
0X3E92D553912D1EA1.avi,932,138,1568,124,636,2
0X3E93B09A1B702BAF.avi,995,56,1580,42,585,2
0X3E9510ADA06F09A9.avi,1904,67,2754,51,850,2
0X3E9FD284E6497932.avi,1152,53,1872,38,720,2
0X3EA17859559E4ABF.avi,2735,66,3574,51,839,2
0X3EA9C5F8DCDD2DEC.avi,1117,66,1696,47,579,2
0X3EAA6F77F2617102.avi,1377,61,2172,44,795,2
0X3EAF0968B6971345.avi,1148,110,1838,95,690,2
0X3EB0FC2695B0AB5F.avi,1012,16,2390,88,1378,2
0X3EB109A9072999EC.avi,1485,63,2459,44,974,2
0X3EB1A47797F16A83.avi,1002,102,1599,83,597,2
0X3EBA07E431D6AC14.avi,766,111,1410,98,644,2
0X3EC21D2B9F1EA8CC.avi,1735,93,2747,69,1012,2
0X3EC366112F42E64.avi,940,46,1563,31,623,2
0X3EC5E2BA17FB1E6E.avi,1077,132,1826,119,749,2
0X3ECA9EB5E06CEA8B.avi,1385,13,2192,2,807,2
0X3ECCF263161995AB.avi,1390,97,1662,77,272,2
0X3ECE2DC0B6619E01.avi,1241,99,1867,82,626,2
0X3ED97063EEB0647F.avi,1383,56,2200,41,817,2
0X3EDC28E881C680CB.avi,1335,82,2250,62,915,2
0X3EDC9FA8DD9B473E.avi,1432,79,2425,57,993,2
0X3EE9455B3F6C0C25.avi,1281,66,1904,50,623,2
0X3EEFB992455C8E98.avi,639,112,1044,93,405,2
0X3EF49ADFD0B23622.avi,927,75,1641,54,714,2
0X3EF958B90BC01EE.avi,1688,69,2005,49,317,2
0X3F016CB9A145CA5F.avi,1056,64,1755,47,699,2
0X3F0187363675176A.avi,1450,63,2385,46,935,2
0X3F02002B186417B4.avi,1169,68,1774,51,605,2
0X3F022794066FF6CA.avi,932,54,1285,38,353,2
0X3F06BAFD1BACCE09.avi,970,66,1561,48,591,2
0X3F076329C702F768.avi,779,64,1159,48,380,2
0X3F0A268A296882B5.avi,731,121,1057,103,326,2
0X3F0C78F7A17748AC.avi,1789,21,2326,3,537,2
0X3F0ED71A38DA9C98.avi,1131,121,1555,104,424,2
0X3F0F139DF3E450A5.avi,1226,83,1934,60,708,2
0X3F1D93F58B1FD1FD.avi,1073,71,1592,54,519,2
0X3F1ED852891344A2.avi,1088,19,1305,5,217,2
0X3F21B014EDBAD737.avi,1508,120,2493,108,985,2
0X3F22CABAAF726217.avi,1444,104,2393,79,949,2
0X3F24B7E7AE2C282B.avi,1424,112,1966,92,542,2
0X3F267C727EACE516.avi,2177,51,3164,38,987,2
0X3F2724A0E1BC2582.avi,924,69,1325,54,401,2
0X3F276CE820A27C46.avi,1001,90,1688,80,687,2
0X3F27BA3A0224153F.avi,1174,22,1797,4,623,2
0X3F2924595718D58A.avi,2410,95,2765,69,355,2
0X3F2BD19A79D5A8AD.avi,1818,73,2844,53,1026,2
0X3F2C0A0610E39E08.avi,871,16,1490,0,619,2
0X3F2D1C1FFD4D503E.avi,1279,49,1909,35,630,2
0X3F2D3F4C42130943.avi,1049,113,1884,93,835,2
0X3F318993B8006FD7.avi,671,76,1028,65,357,2
0X3F3190FAC575A7AC.avi,1535,139,2313,118,778,2
0X3F3397C6B81E8565.avi,2110,74,3395,47,1285,2
0X3F38886ABD417322.avi,1549,142,2545,105,996,2
0X3F3965B7F7CAEEB4.avi,1061,69,1761,49,700,2
0X3F3DC1A6F0B18FA.avi,958,50,1290,34,332,2
0X3F46D480CDB787B9.avi,1953,142,2621,122,668,2
0X3F4EE55CAA4CF6B4.avi,881,122,1380,107,499,2
0X3F50ED36355BC255.avi,1705,57,2743,38,1038,2
0X3F63071C1EB0A15E.avi,533,62,898,56,365,2
0X3F699DC528E8E721.avi,754,71,1301,54,547,2
0X3F6A65114504DCE4.avi,1942,18,2307,5,365,2
0X3F6DF4F515FE44FA.avi,751,111,1131,94,380,2
0X3F71ED0C572EB3E7.avi,1795,46,2065,27,270,2
0X3F7285D129E9D228.avi,1019,17,1813,3,794,2
0X3F86A98444A36448.avi,1006,21,1384,3,378,2
0X3F86DB69FFDAC9AF.avi,1123,67,1704,49,581,2
0X3F8AB03513284E92.avi,1065,54,1519,39,454,2
0X3F914081EEB5588A.avi,1030,92,1429,77,399,2
0X3F92841AA6681005.avi,1090,64,1624,48,534,2
0X3F97ED7FEAA2AC6E.avi,1703,92,1986,76,283,2
0X3F9A02817B34BB11.avi,1210,64,1899,50,689,2
0X3F9EF1DB2A783F8.avi,3123,176,3524,164,401,2
0X3FAD7F576C576B76.avi,1293,140,1936,125,643,2
0X3FB36AEDBE1A4B10.avi,867,11,1187,0,320,2
0X3FB431651C25CB49.avi,3202,68,4419,51,1217,2
0X3FB529259ACCAD46.avi,925,60,1412,47,487,2
0X3FB5BB8755886893.avi,426,57,623,42,197,2
0X3FB63A70136D80EF.avi,1116,97,1787,82,671,2
0X3FB8DCE875DFB29F.avi,801,46,1313,32,512,2
0X3FBB626ABE49160.avi,1980,118,2955,103,975,2
0X3FBBF5350D8CE522.avi,1693,127,2281,110,588,2
0X3FBC7F6543824119.avi,1396,114,2074,92,678,2
0X3FBCED662ED19173.avi,1530,84,2351,58,821,2
0X3FC4CD5A46EF4035.avi,815,97,1216,79,401,2
0X3FC56CBCE0A32923.avi,1520,57,2519,41,999,2
0X3FCDAB936D61FB3C.avi,1366,84,1605,71,239,2
0X3FCF64E16CAB91B.avi,1253,64,1815,47,562,2
0X3FD06E4600AFB1B7.avi,890,66,1381,52,491,2
0X3FD37EEEABBE989D.avi,1534,55,2323,41,789,2
0X3FD79FECFF0B9E30.avi,1836,135,2623,118,787,2
0X3FDA5448318F58AC.avi,1559,74,2379,52,820,2
0X3FDECC3DAEFC3C88.avi,1498,87,1832,74,334,2
0X3FE045B8656715A9.avi,2590,57,4045,39,1455,2
0X3FE27FE080EC17D8.avi,1032,10,1551,1,519,2
0X3FE59CC3E9AF7EE5.avi,1001,83,1716,59,715,2
0X3FE72DE1C9A5154C.avi,1419,138,2084,117,665,2
0X3FE9162ED296F4A3.avi,1316,107,2230,93,914,2
0X3FE99EBEE1E0830E.avi,1444,70,2516,54,1072,2
0X3FF10F5B3ACC1D81.avi,1060,71,1620,48,560,2
0X3FF2A5EB9E33B58F.avi,1144,74,1925,57,781,2
0X3FF38CE334BFB6AA.avi,1411,67,2190,49,779,2
0X3FF3AADBE6D35A09.avi,2923,92,3236,79,313,2
0X3FF4A824721D77C4.avi,1172,138,1970,122,798,2
0X3FF79E1647F263C4.avi,1271,93,2081,79,810,2
0X3FFC6F63147F8BE2.avi,968,96,1492,82,524,2
0X3FFD93A11E0038E1.avi,952,46,1464,34,512,2
0X3FFFEF15F69088B5.avi,650,108,934,91,284,2
0X40005DECF5DCF4D0.avi,1239,70,1697,54,458,2
0X4002E1801D36EDA8.avi,772,113,1339,83,567,2
0X40089B3B847361A0.avi,1087,20,1740,3,653,2
0X400CC61D727033DF.avi,1028,88,1667,75,639,2
0X4010CDE479C5BB80.avi,1053,66,1757,44,704,2
0X40124E47CF121BDC.avi,798,15,1156,1,358,2
0X4013D6C4137D4297.avi,982,59,1441,49,459,2
0X40237596721647DC.avi,1116,70,1679,50,563,2
0X40253981E97848E5.avi,1318,91,1871,79,553,2
0X40271772155BCBF0.avi,1580,53,1805,40,225,2
0X402ECE64134842CD.avi,2370,60,3725,42,1355,2
0X402F47A30DFA51A3.avi,1828,21,2909,1,1081,2
0X4030E11F8E65C1EC.avi,939,155,1533,138,594,2
0X4032BAC50AC5C707.avi,1226,69,2050,50,824,2
0X403633BA8EA5322C.avi,1118,131,1601,116,483,2
0X40363DBD828783F.avi,638,99,1889,106,1251,2
0X403CA8347D30A9D1.avi,885,23,1437,4,552,2
0X403F31515BED0BC2.avi,1348,54,2487,41,1139,2
0X404118277675D8BD.avi,1100,76,1737,57,637,2
0X40414596BC8DF812.avi,1100,93,1664,75,564,2
0X404AF6762D671C09.avi,1388,88,2313,69,925,2
0X40527E38E6EAC117.avi,1180,73,1911,55,731,2
0X40551ED55932933D.avi,1240,113,1746,97,506,2
0X405B25BDFB97D0AB.avi,1187,112,1415,95,228,2
0X40601D27143778D2.avi,1247,218,1963,193,716,2
0X4065BFB6010E7254.avi,904,111,1583,97,679,2
0X406899187CFD9A61.avi,938,55,1615,48,677,2
0X4069B91589712C3A.avi,1010,155,1762,138,752,2
0X406B49B4D454D534.avi,1205,68,1905,50,700,2
0X406BAC86BAC0B5A6.avi,954,76,1430,58,476,2
0X406C05B9EE046427.avi,1238,63,2117,45,879,2
0X406C79DF5EBE13D9.avi,1613,61,2472,44,859,2
0X40736AFD734803E0.avi,1110,56,1452,43,342,2
0X407AA1CC9F54562A.avi,1592,146,2883,125,1291,2
0X407E509DDF2BC32C.avi,967,53,1436,39,469,2
0X40818EDA7A4B5FD4.avi,981,110,1664,95,683,2
0X40819D22B667DFBD.avi,1079,50,1771,34,692,2
0X4082228407B256A7.avi,954,89,1676,71,722,2
0X4082A009493C50F0.avi,2403,168,2818,153,415,2
0X408387EC8C30606B.avi,1237,64,1701,47,464,2
0X40859A35AFC437FA.avi,1978,76,2906,61,928,2
0X408693AAA1896166.avi,1038,21,1548,9,510,2
0X4088FBA37F95B692.avi,1574,136,2182,119,608,2
0X408CA650E6AD4896.avi,1027,51,1528,36,501,2
0X408F18F641936D78.avi,1053,52,1748,40,695,2
0X4090418C2ABF84C6.avi,803,40,1086,30,283,2
0X4091E9362CF3A5E9.avi,1377,130,2239,111,862,2
0X4093BA80E43ED821.avi,1052,104,1710,91,658,2
0X4093E9E5EC007FB5.avi,1816,112,1968,94,152,2
0X409A16F791C8CE6D.avi,1774,67,2098,53,324,2
0X409AE8C96B617FDC.avi,1541,126,2202,104,661,2
0X409C1560857D0D4A.avi,1142,57,1970,40,828,2
0X409CD860C8D45814.avi,742,59,1192,45,450,2
0X40A08EF6EABF3936.avi,1013,51,1576,35,563,2
0X40A1C500E145B14B.avi,1166,56,1727,42,561,2
0X40A33D515599EAA9.avi,1353,120,2167,104,814,2
0X40A621CC0171F360.avi,858,152,1369,138,511,2
0X40A984ED6112B7E.avi,973,64,1399,47,426,2
0X40BA8F1AE901A09F.avi,2139,74,2656,59,517,2
0X40BD33B3D3423B77.avi,1490,78,2413,58,923,2
0X40BF3AC7A4247121.avi,2621,173,3466,155,845,2
0X40C09230C16A634A.avi,845,46,1389,68,544,2
0X40C4C63CE4108315.avi,1625,96,2809,78,1184,2
0X40C9109740FB02C0.avi,825,77,1316,56,491,2
0X40CC7E1811AE44A7.avi,692,56,1122,39,430,2
0X40CFB9F5945D9A25.avi,1555,57,2129,29,574,2
0X40D1A3EFB465C064.avi,1864,61,2316,45,452,2
0X40D28C26DDD4F3AE.avi,1217,55,1846,41,629,2
0X40D38248ACAECAFF.avi,816,53,1400,39,584,2
0X40D604767A9FEED7.avi,1384,150,2307,119,923,2
0X40D6BD692A4A1AA2.avi,1208,63,1487,45,279,2
0X40D6CA4DA2637768.avi,994,124,1509,111,515,2
0X40DFB5351FAEA5B3.avi,1919,70,2900,48,981,2
0X40E0117CBE0F5B26.avi,1664,83,3070,62,1406,2
0X40EBACBB84040DA1.avi,2426,15,2764,3,338,2
0X40EDBEF64BC45E9B.avi,1239,98,1724,82,485,2
0X40F21F75AAD20630.avi,1671,41,1950,29,279,2
0X40F475A3CA97F09B.avi,1357,52,1727,41,370,2
0X40F87CEA33AD96E4.avi,1445,81,2117,70,672,2
0X40FD0B2BD7D3024E.avi,2652,89,3107,77,455,2
0X40FE2C51364DC01C.avi,631,55,914,40,283,2
0X40FF58F1074E0DB6.avi,1196,17,1877,0,681,2
0X41032F601E057D7A.avi,1780,48,2194,31,414,2
0X41080410790C9DC1.avi,1012,52,1555,37,543,2
0X410B873DE1ED0E4E.avi,1023,60,1723,43,700,2
0X411029297A4D5496.avi,1251,69,2126,52,875,2
0X41130893A44122AB.avi,1033,92,1585,74,552,2
0X4117A1621282635F.avi,1187,114,2027,94,840,2
0X411DD3F7DC7803DE.avi,933,50,1086,42,153,2
0X411E89F93DAB415A.avi,1205,69,1807,48,602,2
0X4123160399050F47.avi,746,138,1406,119,660,2
0X412697A4C6EF423E.avi,1230,54,1745,39,515,2
0X412BA2C154A65BFA.avi,821,134,1532,119,711,2
0X41308881D4F393B1.avi,1397,66,2267,50,870,2
0X4130EB4CD7ED958B.avi,1270,51,1913,36,643,2
0X4139F1929AE5230.avi,1573,15,1807,6,234,2
0X413A04EDB27F10BE.avi,1169,88,1936,70,767,2
0X413CDF79953C6C31.avi,1309,50,2174,35,865,2
0X413DF958F18C23EF.avi,1111,127,1745,114,634,2
0X41443641BCA80EC1.avi,1350,81,1701,56,351,2
0X4146353BEBAC0B61.avi,835,141,1452,122,617,2
0X414A9CA51200E64A.avi,1190,105,1883,91,693,2
0X4154F112065C857B.avi,1818,265,1959,45,141,2
0X41563E2CC2230C0E.avi,1674,61,1896,47,222,2
0X415B037A261F0B09.avi,1159,119,1714,100,555,2
0X415C13236237ADB7.avi,1050,103,1458,86,408,2
0X415D34188C1D556C.avi,1571,83,2635,63,1064,2
0X415E9AAB5322E413.avi,1120,61,1801,45,681,2
0X4160B78C9976F248.avi,1070,19,1758,2,688,2
0X4161CE9AEBC8547A.avi,1101,67,1780,48,679,2
0X41620B09AE05528A.avi,1628,81,2665,64,1037,2
0X4164152D3E303FE3.avi,2118,189,3726,164,1608,2
0X41705247E0540BD7.avi,681,55,1134,44,453,2
0X41744FC51A5EE79B.avi,1134,45,1649,33,515,2
0X4176EA075A0EBF26.avi,660,58,1086,48,426,2
0X417AD9FA7525C729.avi,767,120,1351,108,584,2
0X417FE24DAA4F1CFD.avi,1378,77,1823,60,445,2
0X418002B8508D5B48.avi,879,60,1349,40,470,2
0X418085E25998E23F.avi,1009,116,1510,102,501,2
0X4181DF413111AE92.avi,948,65,1530,51,582,2
0X41895072DE028B62.avi,1745,60,1986,43,241,2
0X418C2890BA967BAD.avi,943,127,1690,108,747,2
0X418DBC5A437805F7.avi,1098,148,1661,126,563,2
0X418EBC0BB953DD1D.avi,1043,118,1887,97,844,2
0X419129FDE2B698.avi,1428,61,2186,48,758,2
0X4191ACD0157311E5.avi,1478,148,2096,128,618,2
0X4192B06B630C55B.avi,1113,81,1575,54,462,2
0X4195ECBB24A79F9C.avi,1534,76,1839,52,305,2
0X4196162A5DACE3D3.avi,1430,22,2742,2,1312,2
0X41968367F83EE799.avi,912,39,1216,27,304,2
0X419AE8BD5422648A.avi,877,80,1326,65,449,2
0X419B8AB73B88CD2.avi,1064,51,1644,38,580,2
0X419CFE84D92DA4C9.avi,923,64,1477,45,554,2
0X419D371816750A8F.avi,1162,67,1818,50,656,2
0X41A0E8A4807C4032.avi,1459,59,1893,41,434,2
0X41A429D0083F5F5.avi,1277,64,2069,43,792,2
0X41ABCD5C085A1AD1.avi,2000,83,2755,67,755,2
0X41AC5C5FC2E3352A.avi,1089,64,1377,56,288,2
0X41B290E45772DEE1.avi,1013,53,1529,43,516,2
0X41B2A2D4742E77C1.avi,1114,58,1276,40,162,2
0X41B72A9649E82710.avi,1147,97,1814,83,667,2
0X41B74DD5E613C49F.avi,1042,20,1601,4,559,2
0X41BA1D1E3BB9581F.avi,992,73,1289,49,297,2
0X41BAB6D9416FBE7B.avi,1372,65,2174,43,802,2
0X41BB1EB5C7CD7602.avi,1021,87,1611,69,590,2
0X41C2A106032ED4C8.avi,871,92,1465,78,594,2
0X41CCADA441ED8E9D.avi,1343,145,1654,129,311,2
0X41D05190CAD06AFF.avi,918,80,1560,62,642,2
0X41D3376851045E5C.avi,1043,50,1542,32,499,2
0X41D34DC8CABC6CEB.avi,1292,146,2103,120,811,2
0X41DE226BF847CB96.avi,1414,66,2404,51,990,2
0X41E0823368A8B52C.avi,2036,121,2739,103,703,2
0X41E72F7748120F47.avi,1000,126,1476,112,476,2
0X41E921A2E68382C.avi,1758,81,2059,64,301,2
0X41EBF1EA58FF8DD9.avi,953,84,1511,67,558,2
0X41ECEC7AAEEFD0E6.avi,1609,110,2569,94,960,2
0X41EDA817E75BE7C5.avi,1127,72,1728,50,601,2
0X41F0358EBEADDEBC.avi,1113,103,1457,83,344,2
0X41F15BF2544F66AF.avi,920,76,1362,54,442,2
0X41F3070C2F41EE12.avi,1337,101,2271,86,934,2
0X41F30922BBD210B2.avi,689,122,1072,108,383,2
0X41F8C8319BD36BF2.avi,1425,69,2398,51,973,2
0X41FE84170D568B47.avi,830,105,1408,87,578,2
0X420398026F3662C9.avi,933,64,1235,50,302,2
0X4205814AC4202A6F.avi,1036,95,1620,81,584,2
0X4205B4B64D62076E.avi,909,59,1552,42,643,2
0X420CADF76E49326E.avi,1540,140,2394,122,854,2
0X4214946C295B2A3F.avi,818,64,1200,47,382,2
0X42160C64630C3604.avi,1153,84,1891,64,738,2
0X42186EEA400ABD80.avi,800,50,1130,35,330,2
0X421A1675AA317C41.avi,904,87,1630,74,726,2
0X421B7C03B9A14BBD.avi,1386,58,2098,40,712,2
0X42221E1A611968E4.avi,1247,68,1931,53,684,2
0X422467D9C123BE7F.avi,2120,73,2374,47,254,2
0X4225D03BC0BFD7BA.avi,783,18,1363,2,580,2
0X422763AFB6CC0079.avi,973,131,1644,118,671,2
0X4227F6B51B9564C1.avi,1432,66,2561,49,1129,2
0X422C6837BE6E90FF.avi,968,45,1471,38,503,2
0X423111F7729F2921.avi,961,145,1608,127,647,2
0X423333322D0460A1.avi,1409,70,2360,52,951,2
0X4234AE7B8A1D56DB.avi,1396,89,1730,80,334,2
0X423517ED3C3F4F4A.avi,1410,63,2102,45,692,2
0X423C16E2A001C3F4.avi,1233,19,2075,0,842,2
0X423CEDC513D5B859.avi,1089,19,1374,2,285,2
0X423EA0BF7849D62F.avi,898,71,1404,59,506,2
0X42452C0B4B89666C.avi,1171,166,1969,148,798,2
0X4245425C1E02917.avi,1037,124,1667,112,630,2
0X4248836479957C64.avi,1148,119,2127,105,979,2
0X424902FAA612F188.avi,1081,18,1383,6,302,2
0X424A49302AC57003.avi,693,18,1169,3,476,2
0X4251AEC1C92C818B.avi,1497,93,2647,80,1150,2
0X42524FDE837219AD.avi,1522,103,2440,79,918,2
0X4255A4E685B8C704.avi,1219,14,1735,1,516,2
0X4258AE527948FCC6.avi,820,88,1259,77,439,2
0X425BF6D9A7606E95.avi,830,115,1263,106,433,2
0X425ED2D33412C0ED.avi,1232,135,2006,103,774,2
0X4260E36917BA928C.avi,1152,84,1951,66,799,2
0X4261735B7D42AAC3.avi,1483,94,2111,78,628,2
0X4263AE5BC2AB585.avi,947,68,1619,54,672,2
0X42686D6D058B94F3.avi,1301,79,2054,69,753,2
0X4269E4638DFA9D6F.avi,2178,222,3297,199,1119,2
0X426A61CAF55DE426.avi,1114,103,1797,88,683,2
0X4271BA2AE35CA20C.avi,902,49,1525,33,623,2
0X427B9E706F15970F.avi,669,54,1205,37,536,2
0X427F2A16BCD02AC1.avi,947,122,1571,110,624,2
0X4289FCE738C4F880.avi,1179,130,2080,110,901,2
0X428C4C892FAA3A4.avi,890,127,1542,109,652,2
0X4291313997B65398.avi,955,70,1532,35,577,2
0X4293A45F4307D1C1.avi,2292,124,3337,103,1045,2
0X429630AA81357707.avi,891,66,1436,49,545,2
0X4298D4668E5A228E.avi,888,154,1593,138,705,2
0X429D3AEAF71AF3A0.avi,886,14,1548,4,662,2
0X429D577F56E5C4C4.avi,964,12,1414,0,450,2
0X429DCB15C18B3DAC.avi,914,69,1632,54,718,2
0X429EA0C3F7F89BE4.avi,1168,93,2080,76,912,2
0X429F7C1AEE51AE35.avi,831,108,1491,89,660,2
0X429FE687ADA1461C.avi,1034,75,1879,55,845,2
0X42A20F2F4933967B.avi,1144,123,1835,107,691,2
0X42A3C9A6C7D2E883.avi,2745,20,3635,0,890,2
0X42A595A2F699E62C.avi,1208,64,2100,46,892,2
0X42A8CA2A231EB60D.avi,1709,70,2595,52,886,2
0X42A97568F13E2DB2.avi,972,43,1524,33,552,2
0X42AADB936FD457E6.avi,576,57,880,44,304,2
0X42AF88E9A1646C0D.avi,1358,78,2134,64,776,2
0X42B6080C10501A3C.avi,989,61,1814,39,825,2
0X42B73B5F4502A112.avi,1056,72,1407,60,351,2
0X42BCAEEAABF2299B.avi,1254,86,1832,73,578,2
0X42C04088F5D97815.avi,1807,112,2468,94,661,2
0X42C3CEBDAA6DDFFF.avi,990,57,1496,35,506,2
0X42C8891F05AF4C14.avi,810,61,1225,41,415,2
0X42C8E86BF44DA282.avi,1264,63,2168,46,904,2
0X42CAA48D4E8A27F2.avi,819,69,1309,50,490,2
0X42CBCE2146F01745.avi,1300,60,1898,46,598,2
0X42CBFD88E60F9D7B.avi,1210,66,1576,51,366,2
0X42D0EE9B93BD8553.avi,980,76,1274,66,294,2
0X42D952F5218473D0.avi,1679,110,2598,94,919,2
0X42E373298623FEB5.avi,814,54,1295,41,481,2
0X42E71F03706C0C1B.avi,1152,97,1759,83,607,2
0X42E75641217CF946.avi,1177,49,1412,35,235,2
0X42E8226CA93B7BAC.avi,1487,99,2357,84,870,2
0X42EE64F2F93A5495.avi,1109,139,1747,120,638,2
0X42F1D77D086650B7.avi,1126,60,1780,45,654,2
0X42F2DEE7361EB3EA.avi,1453,57,2255,42,802,2
0X42F505EAA821321C.avi,1283,19,2098,1,815,2
0X42F798C10FDBFFD2.avi,1512,21,2267,2,755,2
0X42F9A073A7F81C75.avi,1036,72,1785,53,749,2
0X42FA0DD3D57C70F0.avi,1901,60,2443,48,542,2
0X42FB891C8FD2AF86.avi,1114,65,1714,46,600,2
0X42FBF848EE88CB8D.avi,1316,80,2137,58,821,2
0X42FC131122748839.avi,899,72,1073,63,174,2
0X42FCA98A2D9A42ED.avi,975,153,1535,134,560,2
0X42FE7843ABA61F46.avi,931,66,1431,47,500,2
0X43006B44D749C590.avi,1481,94,1642,85,161,2
0X43023BBA3D8A2262.avi,917,22,1351,3,434,2
0X430656FE4E49EF4.avi,1050,53,1418,40,368,2
0X430D43B88803388B.avi,964,63,1384,44,420,2
0X430DF0D4A4EAAF4F.avi,1184,66,1821,44,637,2
0X431296CD82BE53D1.avi,2030,60,2992,43,962,2
0X43175234A39001F7.avi,1746,69,2089,46,343,2
0X4317999FCC5CED6.avi,1673,68,2373,51,700,2
0X4318E9C5A211F415.avi,1334,94,1765,72,431,2
0X431DCBBC8DB99EB.avi,1074,149,1537,131,463,2
0X431E2B7F33C1E480.avi,1383,66,2107,48,724,2
0X431E5FB3F15C0615.avi,923,92,1546,76,623,2
0X432623D2D414961F.avi,1251,50,1805,36,554,2
0X4326F9C7F097171F.avi,1297,56,2202,42,905,2
0X432B70567E87D984.avi,1485,47,2004,31,519,2
0X432F60CE4D406775.avi,1068,18,1741,4,673,2
0X433A0F02D46DF762.avi,942,121,1374,104,432,2
0X433AB6AAF05E964.avi,1128,54,1770,38,642,2
0X433BDA782B668C2A.avi,1083,66,1887,50,804,2
0X4341623F0423931B.avi,1203,105,1992,90,789,2
0X434587808499737A.avi,817,57,1434,33,617,2
0X4349B3104CBFBBDD.avi,1967,75,3161,52,1194,2
0X434E045B4F822B88.avi,2366,70,2565,57,199,2
0X434FFAE9BF99D811.avi,2712,72,3957,49,1245,2
0X4350FE5538F115C9.avi,902,16,1389,1,487,2
0X4356EE7B8102993C.avi,1435,93,1712,75,277,2
0X4356F73DF9D111B1.avi,1437,20,1824,5,387,2
0X4357A4E9731D8383.avi,1314,80,2128,62,814,2
0X4357D74D4E26F278.avi,933,76,1431,56,498,2
0X435D425391F6DF3C.avi,787,138,1287,124,500,2
0X4361231DA99A3480.avi,1136,114,1276,88,140,2
0X436381EDEAF56C17.avi,1632,97,2018,79,386,2
0X4365A9CB0E95EDEF.avi,1695,92,2779,75,1084,2
0X4365DD7E115C67FE.avi,1186,107,1935,92,749,2
0X436641C58DF2E587.avi,1674,129,1953,105,279,2
0X43664BF0CDA9C803.avi,940,213,1593,194,653,2
0X436749E54CB808D9.avi,877,110,1418,100,541,2
0X4370E51E70C62FFC.avi,1331,80,2282,60,951,2
0X43715A8C6B3E61D0.avi,783,67,1418,49,635,2
0X437170B1DA64BB42.avi,1293,107,2013,90,720,2
0X4371FE77D4A20EEC.avi,1335,85,2018,74,683,2
0X43765C8EB3F53183.avi,996,92,1437,77,441,2
0X43776A8E158E1D2F.avi,1207,54,1926,39,719,2
0X437B9516E64991DE.avi,1200,118,1852,103,652,2
0X437D0633EFFC953B.avi,1125,166,1565,154,440,2
0X437E57907032965C.avi,1085,88,1649,68,564,2
0X4382CD09EDB1F1AE.avi,857,65,1265,52,408,2
0X43861B35CB8BA1BB.avi,1228,17,2081,4,853,2
0X438D6923619BE51.avi,1020,62,1694,42,674,2
0X4399118D8F5C539D.avi,1430,58,2637,43,1207,2
0X439A555348548AF4.avi,1202,90,1515,81,313,2
0X439A95D51AEB357C.avi,1812,85,2926,70,1114,2
0X439B5F9ACAD2B7B9.avi,1919,37,2407,22,488,2
0X439D002885864206.avi,1694,62,2112,51,418,2
0X439F5C1EA9F88AB1.avi,1330,74,2082,54,752,2
0X43A5C5FAAFCA1B2C.avi,980,72,1469,55,489,2
0X43A764414165A4A2.avi,901,74,1508,57,607,2
0X43AC858DBD11798A.avi,1917,49,3195,32,1278,2
0X43B0DD69DEECF471.avi,2039,75,2309,50,270,2
0X43B379583D0B5CB1.avi,1232,88,2045,73,813,2
0X43B733F38B1CBB9D.avi,1109,64,1499,43,390,2
0X43BA107A8AF8080B.avi,1597,47,1773,32,176,2
0X43BC7C82C6B0943F.avi,1284,121,1898,109,614,2
0X43BE743B95734154.avi,1651,18,2302,2,651,2
0X43C9344873751202.avi,745,53,1216,38,471,2
0X43D42D2CAFA7F36D.avi,976,65,1578,49,602,2
0X43D78A77C44A10E.avi,1192,16,1551,4,359,2
0X43DA861ABE7A0720.avi,897,103,1405,85,508,2
0X43DDF013296DD5B7.avi,737,99,1134,81,397,2
0X43DDF0E398EF559C.avi,1994,57,2421,38,427,2
0X43DE853BD6E0C849.avi,1591,97,1818,50,227,2
0X43E03104CE2A7E6C.avi,1063,61,1795,42,732,2
0X43E1086D4D329A14.avi,1031,142,1642,126,611,2
0X43E21822FFC80CAC.avi,2345,143,3018,121,673,2
0X43EA065ECBFA9AD7.avi,1197,112,1972,95,775,2
0X43EB4B6F88339ECE.avi,799,173,1236,158,437,2
0X43F19DCFF6CA5A09.avi,1433,17,1871,0,438,2
0X43F30BAC89739F29.avi,1166,23,1913,1,747,2
0X43F4E26080A78B79.avi,1284,129,2284,116,1000,2
0X43F7687722616CE9.avi,909,97,1417,72,508,2
0X440008B474A3319D.avi,590,53,950,39,360,2
0X44015C0D217CCC6.avi,1450,62,2222,45,772,2
0X4402D6BAEB80060A.avi,1134,118,1912,105,778,2
0X44031EA0A99B3D73.avi,892,51,1325,43,433,2
0X440900BA9598705F.avi,2558,130,2778,114,220,2
0X441412385377D690.avi,976,124,1490,109,514,2
0X44150A0B561EEE19.avi,986,169,1454,151,468,2
0X4415AD160E79F9B8.avi,1497,133,2300,99,803,2
0X4419F57C64568EB3.avi,1423,68,2446,50,1023,2
0X441A8CB3361C5CDB.avi,1075,82,1334,72,259,2
0X441E7CCDB720CE61.avi,1497,61,2412,49,915,2
0X441F60FC358D26EF.avi,2192,76,2913,58,721,2
0X4428361A82F59F0D.avi,927,22,1658,1,731,2
0X442C9DCF330755E.avi,1363,74,1987,55,624,2
0X44323BC92DF07925.avi,1729,136,2535,116,806,2
0X443438E2F2550D6A.avi,1382,142,2049,122,667,2
0X4435084D81702978.avi,1787,105,2771,89,984,2
0X443E4C7ECF7C9423.avi,1314,76,2031,61,717,2
0X443FEC9AB1D22316.avi,1406,46,1634,34,228,2
0X444315D43840AAE1.avi,888,109,1615,94,727,2
0X4443C1C10CC3B13A.avi,1087,107,1700,97,613,2
0X4448BE2B5EE675E.avi,821,72,1385,55,564,2
0X444AA630FB840A63.avi,1609,102,2472,80,863,2
0X444C866E5B4D119A.avi,1072,130,1527,118,455,2
0X444CC9F0CE8B22E5.avi,1046,76,1822,57,776,2
0X444E4604BB173900.avi,1450,62,2535,45,1085,2
0X4450ACAA532729CC.avi,1001,103,1674,86,673,2
0X44519EA71861508A.avi,1550,86,2425,73,875,2
0X4454A9B655CE4748.avi,1327,71,2137,52,810,2
0X445575CFEECB0986.avi,1040,118,1602,103,562,2
0X4457399F82B0DB8B.avi,615,54,947,42,332,2
0X4457792327507BF.avi,1549,74,2468,53,919,2
0X44663DBC0CF673F5.avi,1947,21,3094,0,1147,2
0X44665B39EAC0DDA9.avi,1067,103,1669,88,602,2
0X44687A734737EBA4.avi,936,115,1591,97,655,2
0X446B63558C3D8706.avi,1039,67,1629,54,590,2
0X446DAA2329C90ED6.avi,1145,166,1701,139,556,2
0X446DD98991C15E41.avi,1112,77,1549,55,437,2
0X446E8D1FC944760C.avi,1290,58,2079,46,789,2
0X4471745EFED4FB8A.avi,1465,15,2459,0,994,2
0X44720ED76ECBB413.avi,1295,20,2035,3,740,2
0X447284A7BA9F97EE.avi,1121,83,1757,70,636,2
0X4477077E68BF47B2.avi,1558,4,1576,1,18,2
0X44791B99E952C4B6.avi,1495,60,2397,39,902,2
0X447A2F85FA084EC3.avi,1136,78,1736,63,600,2
0X447A53FC10CB6952.avi,1071,49,1538,35,467,2
0X447E46029B268525.avi,1051,75,1543,60,492,2
0X447E50EF7BF3F9AA.avi,1680,59,1906,41,226,2
0X448007F0DCEDA6EA.avi,1170,53,1635,39,465,2
0X44805AD09697CF0E.avi,1583,107,2322,83,739,2
0X448282F7DD71CDEE.avi,1365,115,2123,96,758,2
0X4484CF47B67B79.avi,626,55,1001,45,375,2
0X448FCAC1F300393C.avi,1851,128,2830,111,979,2
0X4492BEA1A146BCEF.avi,890,69,1423,51,533,2
0X44945BF0F44F4ED6.avi,1082,177,1792,160,710,2
0X4494601784C9C2B5.avi,1406,59,2243,44,837,2
0X449BDE33FCD6216B.avi,736,87,1169,69,433,2
0X449F4DBE528DB8E4.avi,662,45,1105,36,443,2
0X44A12BED8BD703D5.avi,1362,118,2302,102,940,2
0X44A1DA7C5681687D.avi,2055,118,3348,102,1293,2
0X44A229D25A6D90F6.avi,840,99,1501,87,661,2
0X44A22A6AC83EAAE3.avi,1342,21,2077,0,735,2
0X44A388BE279381C5.avi,772,121,1205,96,433,2
0X44A3EA77AFCBC602.avi,773,79,1230,68,457,2
0X44A4EFFB743B7EBA.avi,912,22,1462,0,550,2
0X44AAEEDEB27D7CD8.avi,1073,77,1750,60,677,2
0X44ADA67E755F8482.avi,2289,98,2539,83,250,2
0X44AF62DCB1DC4329.avi,1646,105,1963,88,317,2
0X44B04DF0162F5E97.avi,825,60,1238,42,413,2
0X44B6C59A842F6A21.avi,1872,149,2862,128,990,2
0X44B83C6255383CDB.avi,1187,107,1887,97,700,2
0X44BE0AE1373FE644.avi,771,42,1218,32,447,2
0X44BF53A7F48527B1.avi,1361,115,2314,95,953,2
0X44BFFB354D8E21C9.avi,914,115,1262,105,348,2
0X44C16995297F2548.avi,1809,162,2775,145,966,2
0X44C18287CA978438.avi,3293,63,3546,51,253,2
0X44C1C7FC939E2A3.avi,1139,115,1799,97,660,2
0X44C2F41C10A2E2FE.avi,1359,127,2171,110,812,2
0X44C35F9C8D4F230B.avi,1490,131,2522,112,1032,2
0X44CB24B21421CE66.avi,878,65,1671,50,793,2
0X44CB4ECD6A40E9C9.avi,1390,143,1856,127,466,2
0X44CBEE8CA4DECC80.avi,2146,117,2450,100,304,2
0X44CC955D681B4488.avi,1195,111,1683,93,488,2
0X44D1529F884ADC65.avi,1995,85,2577,68,582,2
0X44D460005C844C04.avi,1695,80,2116,64,421,2
0X44D47829F06BD67F.avi,1832,54,2464,40,632,2
0X44D508496C453D89.avi,1634,66,1776,54,142,2
0X44DA3D8853AE917C.avi,1589,66,2415,48,826,2
0X44DCF479544BA8C6.avi,1227,75,1995,56,768,2
0X44E27BC8B24601D5.avi,1268,62,1951,47,683,2
0X44EAC282A8452B0B.avi,1282,152,2046,133,764,2
0X44F675DB0863E29.avi,1283,44,1941,31,658,2
0X44F783F5B514A943.avi,1422,42,1925,29,503,2
0X44F9A80B05DFC224.avi,2240,86,2976,74,736,2
0X44FA43FAC7FE022.avi,716,118,1091,103,375,2
0X44FDE6498A51E3BC.avi,985,85,1541,66,556,2
0X4502CEC81747E7BD.avi,1723,16,1871,2,148,2
0X45047F0D2B3DA0CC.avi,665,60,1007,43,342,2
0X4506870DFECB082E.avi,1061,124,1368,106,307,2
0X4506A36DB51B7766.avi,1402,103,2058,87,656,2
0X450790A4885E9762.avi,978,132,1730,116,752,2
0X4509E093754F0304.avi,1394,66,1900,48,506,2
0X450BE2C78EC9B5EF.avi,1120,76,1523,58,403,2
0X4512900B884F5CB.avi,2138,21,2390,11,252,2
0X4512AB205DE541B2.avi,1154,143,1870,126,716,2
0X45169B4E6FA0A0A0.avi,1170,16,1963,3,793,2
0X451AAC4A666A91BF.avi,1862,66,2114,54,252,2
0X451AEA20249EFD25.avi,1159,67,1707,48,548,2
0X4521C31BFB79E41F.avi,1420,73,1934,53,514,2
0X45239B4E5153E962.avi,962,47,1555,34,593,2
0X4523F8C611A32164.avi,1142,130,1912,115,770,2
0X4527BA99A25B80AA.avi,1422,117,2500,89,1078,2
0X45286C289D7A233D.avi,2094,77,3580,59,1486,2
0X45288341238CE3FD.avi,983,58,1610,46,627,2
0X452A08132F153B56.avi,1286,68,2293,54,1007,2
0X452FB515DC2DE477.avi,1007,117,1759,99,752,2
0X45300281828E615A.avi,981,102,1542,83,561,2
0X4530203B198A87C6.avi,2945,77,4914,62,1969,2
0X45357AC4B9F02268.avi,1302,87,1873,71,571,2
0X4536DCD1EF2AF7FF.avi,1055,122,1777,103,722,2
0X453EC33BC6E96460.avi,818,76,1187,67,369,2
0X453F41898001E174.avi,1237,109,2025,95,788,2
0X45418C574D97027A.avi,965,16,1442,1,477,2
0X4548ECB3A01FC674.avi,1539,76,2340,59,801,2
0X4549C792D8239391.avi,1673,59,2321,42,648,2
0X454C1F4146B14E0E.avi,1403,55,1816,56,413,2
0X4550086B27E8492F.avi,989,66,1711,52,722,2
0X4556F926DF2708B6.avi,1676,114,2278,98,602,2
0X455C2277C037ADFF.avi,1226,60,2015,47,789,2
0X455EF2F2E407CBA9.avi,1091,55,1795,37,704,2
0X45606D3650036C6B.avi,1255,115,2043,100,788,2
0X45632A2A3B1D4EC2.avi,1451,96,2299,78,848,2
0X4563D5F18EF850.avi,1969,64,3206,50,1237,2
0X4569782F9EE65B79.avi,2374,60,2740,42,366,2
0X456A974FA4772464.avi,1048,104,1514,88,466,2
0X456AF7E56AC662AA.avi,938,133,1681,121,743,2
0X456C5475063164C4.avi,1862,94,2040,79,178,2
0X456CF175454A3E15.avi,986,61,1669,42,683,2
0X4574E7735C7EC705.avi,1828,80,3203,62,1375,2
0X4578EAE5AD6B92D6.avi,1205,89,1902,75,697,2
0X45797518BBA63676.avi,1106,71,1656,57,550,2
0X457979CC6D12EBB8.avi,1424,90,2209,67,785,2
0X457C7DD05898EC66.avi,1187,150,1913,137,726,2
0X457D30606BC14265.avi,1100,63,1633,49,533,2
0X457DAB4FF89AC668.avi,1458,111,2051,90,593,2
0X457FA6E8CA802DC2.avi,1270,121,1880,104,610,2
0X458076DDE5F2F78D.avi,714,163,1326,145,612,2
0X4584371B4D8B2D39.avi,909,134,1459,120,550,2
0X458A3FC76A16F3CF.avi,2938,83,3381,67,443,2
0X458C107A05DAB733.avi,1200,152,1943,139,743,2
0X45980563E8E0859C.avi,1098,92,1836,78,738,2
0X459A709C0D875EEF.avi,1164,144,1662,128,498,2
0X459F7C29B033C1D0.avi,870,106,1628,85,758,2
0X45A14722B0DFC1EA.avi,1250,160,2082,141,832,2
0X45A28C1FB1A33FC5.avi,1099,64,1707,48,608,2
0X45A5D731A015ADBF.avi,1672,138,2130,119,458,2
0X45A763EE890FBEA.avi,811,64,1413,48,602,2
0X45A9015B761B40A9.avi,1244,123,1706,108,462,2
0X45AD580B725C799E.avi,1489,121,2289,99,800,2
0X45B2F88F92A460D5.avi,976,50,1614,36,638,2
0X45B5C4D9038D5F9E.avi,1017,98,1626,85,609,2
0X45BE0065FB0FEFD7.avi,1046,71,1540,56,494,2
0X45C0B5CB8EAC7CE3.avi,1385,45,2384,33,999,2
0X45C3270D57E3DF4.avi,2102,119,3510,98,1408,2
0X45C47B88561016CD.avi,1148,133,1930,112,782,2
0X45CC26E182BB7C4.avi,1395,89,2160,74,765,2
0X45CE057EC2EB577F.avi,1663,131,2080,110,417,2
0X45CE6C8893A4E3A7.avi,1085,52,1719,35,634,2
0X45D646D50FEED577.avi,1221,116,1993,105,772,2
0X45D67C2F0E610EE.avi,715,11,1006,13,291,2
0X45D733BB49E9C17D.avi,948,14,1644,0,696,2
0X45D79F6C97A51897.avi,902,165,1371,149,469,2
0X45D7BE7523C46BB2.avi,786,129,1165,113,379,2
0X45DF2459DF7D77B0.avi,917,56,1489,44,572,2
0X45E20189E7AA1A4B.avi,571,113,895,106,324,2
0X45E3351DC2069AA3.avi,1073,127,1742,113,669,2
0X45E4438C079A69DF.avi,955,79,1632,62,677,2
0X45E6F6924D4AA7C3.avi,927,53,1460,39,533,2
0X45E83530C042A5F4.avi,1472,47,2555,35,1083,2
0X45E8B3791798B0BE.avi,1477,51,1808,35,331,2
0X45EC30D3FE91D38D.avi,1185,57,1963,40,778,2
0X45ED432FAE218EFD.avi,1262,81,1766,58,504,2
0X45ED7398E9C3AAEA.avi,855,220,1219,203,364,2
0X45EEBFE43C183552.avi,1298,123,2057,107,759,2
0X45EFEE60B0C9E31A.avi,1202,101,1862,87,660,2
0X45F32591DF9DFC34.avi,1346,101,1747,86,401,2
0X45F39E3406B7CAA5.avi,829,51,1407,38,578,2
0X45F50AF374B2D1E6.avi,882,148,1252,130,370,2
0X45F6B2D62CFBDD5A.avi,2180,76,3400,59,1220,2
0X46024CC33D00D4C6.avi,3324,48,3639,33,315,2
0X4602E7CB509084C4.avi,1789,98,2601,86,812,2
0X460698918BEA659B.avi,934,84,1510,62,576,2
0X460B910F3236924B.avi,1382,55,1784,39,402,2
0X46112A0A6AAA4A03.avi,1088,147,1806,124,718,2
0X4611FC9B7FE4F50A.avi,1469,74,1693,61,224,2
0X461758F43BB8187.avi,1505,81,2508,66,1003,2
0X4623FC023AE07EE1.avi,1416,83,2254,64,838,2
0X46258A8F882A3019.avi,2048,61,3368,49,1320,2
0X4635A6E545BAD9FD.avi,1177,52,1920,39,743,2
0X463659CEAFA45073.avi,1336,65,1866,48,530,2
0X46380BAFF46D6E69.avi,1588,72,2106,54,518,2
0X463A7B7D46C6CA4.avi,1417,126,1903,103,486,2
0X463C296E8E65DA97.avi,1083,53,1820,39,737,2
0X4649CB5A58E805C6.avi,1761,113,2327,97,566,2
0X464AFEA5B054D5B5.avi,1086,47,1841,35,755,2
0X464B97C85D11DCC.avi,975,48,1405,34,430,2
0X464C4B92D0C0CF58.avi,1491,73,2242,56,751,2
0X464D690506890716.avi,1235,9,2057,0,822,2
0X464D8CFAA048566E.avi,1872,119,2558,104,686,2
0X464DF46257E5BDD.avi,917,38,1452,27,535,2
0X464DFB5050226BDF.avi,1131,135,1579,119,448,2
0X46540E51EA8D3CB3.avi,1483,144,2071,130,588,2
0X4654445DEC676C34.avi,748,44,1188,32,440,2
0X4659B984370E6F6.avi,991,66,1718,51,727,2
0X465E263A2E3C4006.avi,899,57,1345,41,446,2
0X465E766F162C7A19.avi,2044,74,2289,62,245,2
0X465ED1F90846CB26.avi,1428,52,2068,32,640,2
0X4666116E3F120DF9.avi,856,120,1433,104,577,2
0X46682D67FA3FE237.avi,1054,82,1639,64,585,2
0X466EB4595EE4C15D.avi,2208,63,4080,43,1872,2
0X467280BF224215F.avi,755,116,1137,100,382,2
0X4678C04CB6F6CC0B.avi,1796,109,3100,94,1304,2
0X467B292B5E1C740B.avi,974,98,1466,80,492,2
0X467B7DC0FAEAAD97.avi,997,61,1647,45,650,2
0X467C4565D025C33B.avi,944,97,1520,75,576,2
0X467DCC27BC71B286.avi,969,101,1681,85,712,2
0X4681E706E18BF21E.avi,1566,94,1902,80,336,2
0X468340D877F36659.avi,943,41,1315,28,372,2
0X4686D15BB8789AC4.avi,996,16,1549,4,553,2
0X4692017DDC366859.avi,1253,101,1546,93,293,2
0X4692C4D2FDB8FF33.avi,1482,113,2608,96,1126,2
0X469546878D04E5AF.avi,1840,48,2332,55,492,2
0X4695711AF5D23C2F.avi,2089,51,2373,37,284,2
0X46974CA9C1FAFF54.avi,1121,54,1786,37,665,2
0X4699853F9A68420E.avi,985,49,1704,38,719,2
0X469F0E05A55908A4.avi,1924,124,3173,108,1249,2
0X469F5261704011ED.avi,1090,119,1659,97,569,2
0X46A60B1F1ACEE9FF.avi,1184,49,1522,31,338,2
0X46A887F79BFB58DC.avi,957,70,1449,53,492,2
0X46A8BD539728F654.avi,1164,101,1714,87,550,2
0X46ACC9C2CF9CFB1E.avi,1906,43,1931,104,25,2
0X46AE1D888EB482C9.avi,1028,68,1537,52,509,2
0X46AF7C10F61E0EA7.avi,1182,92,1681,70,499,2
0X46B0C3E74FBBA739.avi,1230,99,1809,88,579,2
0X46B0E42A1E861C36.avi,967,106,1568,92,601,2
0X46B1CCE5B354B752.avi,790,37,1265,24,475,2
0X46B2F29BE675B414.avi,1193,133,2038,113,845,2
0X46B8BB5213CB1F0E.avi,1048,67,1747,50,699,2
0X46B96E600D63E220.avi,1623,135,2365,119,742,2
0X46BBFEEF6D8F4FC7.avi,929,47,1843,34,914,2
0X46BCFDEAE8089A57.avi,1223,80,2011,64,788,2
0X46C26D1B887FA60E.avi,1315,76,1889,55,574,2
0X46C848F34D9A1C52.avi,1133,18,1732,3,599,2
0X46C85F22B3CC9971.avi,1277,61,2056,46,779,2
0X46D2C668D5E324C4.avi,700,42,1017,29,317,2
0X46D3DFF945D068E6.avi,1601,59,2817,45,1216,2
0X46D6ADEBB2724045.avi,1100,88,1771,68,671,2
0X46D6E363FD24E7D8.avi,1802,90,2794,74,992,2
0X46D8CDB35FD5072.avi,615,43,900,31,285,2
0X46D9701BDA5EBEF4.avi,590,104,942,84,352,2
0X46DAAD3656224448.avi,1523,95,2732,83,1209,2
0X46DD6F251FB476EC.avi,872,170,1461,153,589,2
0X46DDEFA74CDB0EBD.avi,1122,26,1859,0,737,2
0X46E076385E2BD694.avi,1793,120,3166,90,1373,2
0X46E0DDFB5E35C490.avi,1124,47,1758,36,634,2
0X46E335EDE6F8E5AD.avi,1798,79,2696,63,898,2
0X46E845D4F2348D4.avi,1094,161,1499,139,405,2
0X46EB0F531C3EE3A2.avi,1441,82,2175,68,734,2
0X46EB76C70B65EA5B.avi,1639,19,2360,5,721,2
0X46F0756996349.avi,1175,127,1496,109,321,2
0X46F177DC7B92CEA6.avi,1951,121,3328,102,1377,2
0X46F641FCE4FFCF0B.avi,1578,62,2441,49,863,2
0X46F890593D02A068.avi,1106,89,1763,75,657,2
0X46F9633AC34FF38E.avi,1890,120,2257,102,367,2
0X46F9944BBD295961.avi,1438,98,2393,82,955,2
0X46FA0CE0A00866D0.avi,1069,170,1679,158,610,2
0X46FA118F433C5C36.avi,1314,55,1618,36,304,2
0X46FD77D3DC9F4026.avi,879,100,1430,73,551,2
0X46FF014B4D866466.avi,1139,96,1590,79,451,2
0X4700367736428EE9.avi,1033,72,1643,54,610,2
0X4700E4911EF3C56A.avi,1206,115,2016,100,810,2
0X4701B85B6B446BB8.avi,1675,43,1940,30,265,2
0X470253DB6CB105B3.avi,910,141,1353,125,443,2
0X4703E1BFF89C0301.avi,1799,69,2506,52,707,2
0X4704159CFC29D4C3.avi,1185,67,1590,56,405,2
0X4707425BAF59515F.avi,1238,87,1536,71,298,2
0X4709E6A8CFF415E8.avi,1327,100,1975,85,648,2
0X470C3A06C890B2B3.avi,1169,74,1405,65,236,2
0X470CD51F9B5DF85C.avi,767,94,956,76,189,2
0X470FA78D91CC7397.avi,985,113,1661,93,676,2
0X471783E22BC7C7C1.avi,1160,65,2064,48,904,2
0X471837C15FA962D2.avi,1336,41,2102,27,766,2
0X4722C9BF04CEEB25.avi,1659,72,2262,47,603,2
0X47241688479B3A90.avi,2291,83,3804,76,1513,2
0X4724AC020BB043C4.avi,1022,59,1560,42,538,2
0X4724EF4A6021488E.avi,2220,162,4144,142,1924,2
0X4726A11E93B9DE90.avi,964,54,1326,41,362,2
0X472BE363F86E6CDB.avi,928,97,1792,79,864,2
0X472DDCEC92FE7A59.avi,1144,63,1532,51,388,2
0X472E440353556195.avi,1182,112,2194,92,1012,2
0X4735E8CE35BE2A3.avi,843,68,1353,53,510,2
0X4742152D0E22F043.avi,1142,122,1854,103,712,2
0X4746C7E35E560E3F.avi,898,65,1347,50,449,2
0X4746D69940479A7.avi,1841,72,3226,61,1385,2
0X474B0F4E6590E8A8.avi,914,64,1431,50,517,2
0X474DD406384555D8.avi,1252,161,1509,148,257,2
0X4751BDCD16AA2343.avi,1626,50,1897,35,271,2
0X47525086CF1B329F.avi,937,85,1656,65,719,2
0X475268C075FF7737.avi,1252,49,1717,34,465,2
0X47531256525CE22B.avi,1293,67,1973,48,680,2
0X475585257AE2E722.avi,1377,118,1874,100,497,2
0X475685CC25B59A31.avi,971,122,1526,95,555,2
0X475911107C069CD2.avi,1040,49,1235,39,195,2
0X475B14E7CDFC143D.avi,987,58,1619,46,632,2
0X475BAF471615BAC2.avi,667,81,1143,66,476,2
0X475C1DE9B186E5D1.avi,1043,73,1675,56,632,2
0X476320C5BDCD5BA6.avi,980,73,1669,57,689,2
0X47652348BF1687F2.avi,1291,67,1992,52,701,2
0X476641FB702A0EDF.avi,795,63,1282,45,487,2
0X476749AF0E3C3D5D.avi,756,55,1121,40,365,2
0X476AA915D8E928A.avi,1015,107,1641,90,626,2
0X476B330DE1073521.avi,1057,18,1702,4,645,2
0X476B36561AE2A0D2.avi,1208,100,1807,81,599,2
0X476F7A75F09C0B5B.avi,1136,97,1896,84,760,2
0X477211790541ED15.avi,1396,52,2426,37,1030,2
0X47760ED572E13C7A.avi,2061,176,2135,159,74,2
0X4776D370A544B906.avi,683,141,1110,115,427,2
0X4779BE071DEE725B.avi,538,58,765,44,227,2
0X477A5498A9228272.avi,1822,52,2352,38,530,2
0X47827D50EA4F700C.avi,1107,66,1789,46,682,2
0X47847D0C76E816E7.avi,1650,86,2665,70,1015,2
0X4785E9CF6784D185.avi,1261,149,1805,131,544,2
0X47864FA3C28A0D7E.avi,1784,52,2240,34,456,2
0X47902A34F32E05B8.avi,1117,65,1873,47,756,2
0X479254EA39F54EE8.avi,656,55,1147,36,491,2
0X4796B510866E9AF5.avi,1057,176,1646,156,589,2
0X4797A8A850B26898.avi,1212,95,1883,77,671,2
0X47A36F58EC5766A0.avi,606,55,878,38,272,2
0X47A97790F0C53CC4.avi,460,104,695,90,235,2
0X47AB20C78E2DC818.avi,1935,18,2561,5,626,2
0X47B3F561C23EFC83.avi,1093,90,1644,74,551,2
0X47B7FB9C26D31A01.avi,1030,167,1662,155,632,2
0X47B93384CF91E71E.avi,838,94,1351,75,513,2
0X47C11DD3EBCA4358.avi,1629,52,2112,37,483,2
0X47C3A2C6F7337211.avi,1405,140,2169,124,764,2
0X47C5BD5581B2636.avi,1074,143,1905,125,831,2
0X47C61AE147E6645B.avi,1230,18,1940,1,710,2
0X47C69408C25944D5.avi,959,58,1358,43,399,2
0X47D04CC0EEE7F1EC.avi,1607,52,2369,38,762,2
0X47DBEA2F11240016.avi,1056,18,1569,3,513,2
0X47DE6565CC0A74F0.avi,754,89,1265,75,511,2
0X47E00F696D481DE7.avi,998,102,1647,86,649,2
0X47E115F8D0A797EE.avi,1210,65,2143,49,933,2
0X47E5C10C8132FFB2.avi,1024,67,1551,44,527,2
0X47EDDE2F8004F754.avi,1143,8,1614,0,471,2
0X47F00D882D730416.avi,1120,52,1649,36,529,2
0X47F34619DCEFCDC9.avi,1094,116,1913,99,819,2
0X47FC02860FC36935.avi,2038,59,3401,44,1363,2
0X47FC0610DB80051A.avi,1571,163,2067,150,496,2
0X47FC5FBFF53B0AD8.avi,1972,59,2976,47,1004,2
0X47FCF3189BE29C79.avi,1018,103,1631,86,613,2
0X480291080E3DD3EE.avi,1107,16,1779,0,672,2
0X4803F7D876C339CF.avi,1101,44,1863,30,762,2
0X480A7B6D54009BF8.avi,985,63,1571,44,586,2
0X480F3C8E8D43D621.avi,1106,148,1736,133,630,2
0X4812581D45B5FFC5.avi,1036,120,1691,100,655,2
0X4816823BCF1EDFC6.avi,1202,141,1889,122,687,2
0X4817AC0DD12566F8.avi,1150,68,1887,51,737,2
0X4817C5B6DA01BD03.avi,947,99,1554,84,607,2
0X48182B4ADA3FFE0E.avi,1854,18,2514,0,660,2
0X481CC400687B5EBF.avi,1101,93,1785,77,684,2
0X4821B047209D5A54.avi,2551,62,2829,36,278,2
0X4827A66C595F8E76.avi,1098,164,1592,145,494,2
0X482848939C63FAA8.avi,1605,87,1938,67,333,2
0X482BB41895F1974D.avi,799,49,1187,31,388,2
0X482E380A512BB6E4.avi,889,120,1400,103,511,2
0X4834F567A2EAED1C.avi,1722,91,2284,71,562,2
0X483BF2DFD6CDFD0A.avi,3096,57,3488,45,392,2
0X483D8D5364D95CAF.avi,1306,78,2015,57,709,2
0X483DBCA3562BA53B.avi,771,75,1215,56,444,2
0X4840DCB7E1FD00F7.avi,1136,149,1891,133,755,2
0X48451904D8FEA4C6.avi,1066,96,1592,83,526,2
0X484A7AD1C7FCF417.avi,1021,59,1565,45,544,2
0X484B7E454D147B.avi,915,82,1439,61,524,2
0X484D1623FDD8A749.avi,1993,77,2258,64,265,2
0X484D532533D59798.avi,1197,64,1820,44,623,2
0X484F1CB40EAD34A9.avi,894,68,1408,53,514,2
0X4851ABCA6F1C46AD.avi,1219,45,1843,37,624,2
0X4859CCA5F75542D1.avi,853,153,1284,129,431,2
0X485A11110AA338D0.avi,1340,108,2112,92,772,2
0X485CE172721DFD8.avi,1239,88,2093,66,854,2
0X4860838E68AACEB4.avi,1615,110,2587,93,972,2
0X4868DEBC55A12E1B.avi,1112,78,1749,56,637,2
0X4868F081436C4E7F.avi,924,18,1437,1,513,2
0X486FA2FEA63A167A.avi,1193,55,1805,37,612,2
0X48761851D94C1763.avi,610,93,949,77,339,2
0X487AD58712D5936A.avi,1185,135,2000,121,815,2
0X487B52623BC14C25.avi,1796,101,3191,84,1395,2
0X487BE41D13192D63.avi,1511,81,2092,69,581,2
0X487CC25D3120FE8D.avi,2608,73,3104,58,496,2
0X487D527B99627548.avi,934,122,1474,110,540,2
0X488191DE8CF0E63B.avi,1298,71,1700,54,402,2
0X48832D83C5EA9C32.avi,2004,83,2595,67,591,2
0X4886855CBADF5BB3.avi,1435,57,2075,40,640,2
0X4887AAE8BCAC9286.avi,1780,65,2952,50,1172,2
0X4888320B67665CA8.avi,1456,45,2362,32,906,2
0X48886D77793F5850.avi,952,168,1519,143,567,2
0X48888B44E3758571.avi,1239,15,2247,1,1008,2
0X4889B480C7F3DE83.avi,1669,61,1753,49,84,2
0X488A8BD8F6A78FF8.avi,990,105,1519,93,529,2
0X488A9E8C9FA6EB57.avi,1868,112,3294,93,1426,2
0X488B0786FF0F086A.avi,3001,292,3383,276,382,2
0X488B410FB47B4A07.avi,629,92,915,77,286,2
0X48905E6FBAB24E3E.avi,1574,64,1988,45,414,2
0X489167E14B9C014A.avi,1682,49,1977,36,295,2
0X4891812FCC8C95E2.avi,897,54,1457,40,560,2
0X4892E16D5D95CD31.avi,1099,53,1844,37,745,2
0X489D45892048716E.avi,1832,86,2727,66,895,2
0X489D6ED1143046F2.avi,1179,67,1975,47,796,2
0X48A48CC20E69F8E2.avi,1125,98,1794,83,669,2
0X48A4F255004328E7.avi,626,107,946,95,320,2
0X48A59BC77070770F.avi,1288,68,2047,51,759,2
0X48AB3B6BB64769CF.avi,2039,51,3398,32,1359,2
0X48AEC7223D38243F.avi,1992,40,2379,28,387,2
0X48B303AFA90A828C.avi,760,71,1215,50,455,2
0X48B308E0C21D4B85.avi,979,16,1587,0,608,2
0X48B321DB37448DE9.avi,912,141,1508,122,596,2
0X48B6FCFA36098E11.avi,975,89,1360,66,385,2
0X48BBF30A7546656A.avi,1133,54,1711,27,578,2
0X48BD9C2CC57340F5.avi,1320,61,2117,46,797,2
0X48BFAB6CDE750792.avi,1454,55,2254,40,800,2
0X48C35748D6FE9BD.avi,655,50,1012,32,357,2
0X48C5E7FC78E0B3C3.avi,2260,90,3762,73,1502,2
0X48C692E19E840EB8.avi,1018,115,1715,94,697,2
0X48C706997F5917E1.avi,1260,112,2412,97,1152,2
0X48CBBF7A0777B553.avi,1385,112,2058,94,673,2
0X48D0C45E9175BCE4.avi,938,62,1621,45,683,2
0X48DFC126ECE35F6.avi,687,96,1129,80,442,2
0X48E089AA482624B6.avi,1071,44,1741,35,670,2
0X48E948163E52C138.avi,1274,144,2062,132,788,2
0X48E96C890A4B8718.avi,1983,137,2775,106,792,2
0X48ECC3432A84187D.avi,1188,70,1795,57,607,2
0X48EE9F14AAE3EE3F.avi,906,124,1487,108,581,2
0X48EF4B8D2F830E37.avi,833,100,1209,81,376,2
0X48EF57DA13FC7FB.avi,1152,18,1842,2,690,2
0X48F44CF772604CB1.avi,1084,74,1653,60,569,2
0X48F785ADBEE3A124.avi,1659,73,2135,57,476,2
0X48FB28BF9BD812DE.avi,956,69,1427,54,471,2
0X48FDAE89721A2522.avi,1260,63,1732,45,472,2
0X48FEAA4071907A5F.avi,2082,78,2553,59,471,2
0X490155F11EF9C102.avi,1531,155,1740,140,209,2
0X490212526E6630EF.avi,856,16,1319,3,463,2
0X49055E259A033164.avi,1282,64,1980,43,698,2
0X490D0EA790DF7EE.avi,1131,75,1756,61,625,2
0X490FC9C6C17960BD.avi,1210,69,1916,49,706,2
0X49110DEED5E41E90.avi,1635,55,2484,39,849,2
0X491140370364F803.avi,1111,64,1859,55,748,2
0X491631C533031846.avi,1224,69,1798,52,574,2
0X4917A8741F962DC4.avi,1389,68,2013,48,624,2
0X4918DDB4B3AE8FC7.avi,2158,68,2900,50,742,2
0X49215CF6782C83B3.avi,1816,55,2781,38,965,2
0X49219BA9202C833A.avi,1156,76,1920,60,764,2
0X4922C566511C69B.avi,1003,79,1590,59,587,2
0X49258D5237927836.avi,1081,46,1815,36,734,2
0X492686F58624C49.avi,1084,110,1752,93,668,2
0X492B188B388D9C73.avi,754,55,1229,43,475,2
0X492F0DE600BCCCF6.avi,1705,54,2293,37,588,2
0X49326C4925025FBA.avi,1293,58,1709,43,416,2
0X4932FA4F98E5A311.avi,1151,22,1758,0,607,2
0X4937270C8599D8E3.avi,1130,132,1885,114,755,2
0X493771B14EDCFD4E.avi,1265,72,1985,54,720,2
0X4937A3E14F356EA8.avi,1212,175,1909,158,697,2
0X4937EFDC69F9E448.avi,1121,87,1808,72,687,2
0X49390CABDE34F630.avi,1673,81,2720,59,1047,2
0X493E34208D40DBB5.avi,1003,101,1289,91,286,2
0X493FECF89E87F1D0.avi,885,75,1374,55,489,2
0X4941EC81FA24A165.avi,837,64,1501,50,664,2
0X49422B590F116D76.avi,878,42,1262,31,384,2
0X49469A3E124DF90E.avi,1211,64,1610,41,399,2
0X49493213513922AB.avi,1030,102,1608,89,578,2
0X49494A45C6E49E0A.avi,1704,18,2925,0,1221,2
0X49551699F203E3F.avi,964,113,1674,96,710,2
0X495E462D0A659507.avi,912,74,1485,55,573,2
0X496081D42911B9B3.avi,1426,72,1753,57,327,2
0X4961E7D210D25ED8.avi,771,15,1321,2,550,2
0X49620F7B3E4CA28A.avi,929,65,1402,61,473,2
0X49644314B8335790.avi,2236,70,2844,52,608,2
0X49678CDE9243313E.avi,1256,93,1780,79,524,2
0X496A6570C645044C.avi,1192,63,1968,44,776,2
0X496C4F738B83C8FB.avi,974,58,1475,48,501,2
0X4970B5821D88BFCC.avi,631,89,1021,75,390,2
0X4975C1A2007A07F5.avi,1151,63,1681,45,530,2
0X4977ADFA42FCC6F2.avi,1740,102,2535,82,795,2
0X4979A9E814D3706E.avi,990,64,1534,49,544,2
0X497E354B515F4FE.avi,745,110,896,100,151,2
0X497E9DBC82C3D62C.avi,762,65,1243,50,481,2
0X49801A85ABE0FDEE.avi,2102,66,2570,40,468,2
0X4980924D1EFF7026.avi,942,90,1488,80,546,2
0X4981E927C1497B77.avi,1320,65,2275,47,955,2
0X4984EEE2795FCC18.avi,2205,85,3145,71,940,2
0X49852F59C8BEB29B.avi,1263,78,1594,62,331,2
0X498E73266178CB27.avi,1237,94,2007,74,770,2
0X498F356AD182EFAA.avi,972,75,1580,59,608,2
0X499747D399335BDA.avi,1017,110,1525,92,508,2
0X499BA59C531FFB3D.avi,1078,58,1702,42,624,2
0X499DF9F90F827205.avi,1530,69,2767,48,1237,2
0X49A0A8D281B8EA27.avi,1055,61,1571,46,516,2
0X49A2D5E5E1DAB5D0.avi,1873,50,3069,42,1196,2
0X49AA5AE78CD7E71F.avi,1159,50,1469,40,310,2
0X49ACC5C1965C1584.avi,1834,93,3118,77,1284,2
0X49B0D943B9388FB6.avi,2221,62,3000,45,779,2
0X49B360CA6BB04B97.avi,1201,94,1858,78,657,2
0X49B7A10D057F78CC.avi,912,57,1619,42,707,2
0X49B7DDE85ED0816F.avi,1283,15,1910,2,627,2
0X49BA35AEA9408653.avi,1647,50,1917,31,270,2
0X49BD5FBFC1A1E10A.avi,1291,82,1558,66,267,2
0X49BDFC05CEC434.avi,986,90,1635,77,649,2
0X49BE2A3124C97300.avi,783,49,1112,36,329,2
0X49BF970124381C81.avi,1528,21,2525,1,997,2
0X49C36B1EE9B8899C.avi,2221,64,2564,43,343,2
0X49C3F8C98AD65DEF.avi,963,138,1680,124,717,2
0X49C47E44816223A9.avi,967,88,1480,74,513,2
0X49C62C647514D46A.avi,1481,63,2041,50,560,2
0X49C65367B00E4D2A.avi,1102,122,1829,105,727,2
0X49C74443F2369C33.avi,1073,50,1625,36,552,2
0X49CAA8810D3D80CD.avi,3392,69,3908,52,516,2
0X49CE160322B691A7.avi,875,98,1438,81,563,2
0X49CEF0778309C672.avi,952,136,1619,117,667,2
0X49D808E62B917785.avi,1262,134,1766,112,504,2
0X49DBF6C7D320DBB9.avi,934,120,1413,94,479,2
0X49E1293560BCBC12.avi,1952,23,3112,3,1160,2
0X49E22F656F26A6EB.avi,1124,62,1855,48,731,2
0X49EC1927F5747B19.avi,1541,107,2202,110,661,2
0X49EC1EFA6775E370.avi,1102,79,1562,66,460,2
0X49EC98DBE77F6C94.avi,1414,134,2225,116,811,2
0X49EDDBE4F26EB4E9.avi,548,71,1043,128,495,2
0X49F240B6D6F355F.avi,963,43,1210,30,247,2
0X49F9930439F79E9A.avi,1431,82,1835,55,404,2
0X49FD1A0005AA0D07.avi,1303,177,2320,148,1017,2
0X4A02A8CE52565FB9.avi,632,56,925,43,293,2
0X4A063C378FE634E1.avi,901,145,1430,128,529,2
0X4A0B8B249A18FC1C.avi,1536,88,2345,68,809,2
0X4A0C7C0FE8253F6E.avi,1352,141,1939,120,587,2
0X4A0CD8CE170B824A.avi,1072,52,1219,34,147,2
0X4A0E87C1BB42B16D.avi,1404,108,2047,90,643,2
0X4A0E967B4D0C7A71.avi,1254,70,2023,57,769,2
0X4A11C148E80CABDE.avi,469,52,788,32,319,2
0X4A120EA254F8C48B.avi,1222,145,2195,131,973,2
0X4A121E9371A35313.avi,1506,67,1935,55,429,2
0X4A134402A0DA7805.avi,944,89,1320,73,376,2
0X4A18018C9EB31709.avi,1140,64,1502,48,362,2
0X4A1A9413B0697A3D.avi,1030,149,2029,129,999,2
0X4A1E66BA1F5A32CB.avi,2207,67,2803,54,596,2
0X4A2A840A571C7468.avi,1200,99,1883,83,683,2
0X4A2C2049EAB5E378.avi,1270,19,2032,1,762,2
0X4A2D1333CC39F29B.avi,1811,135,3044,120,1233,2
0X4A31252226254DF.avi,1342,51,2116,40,774,2
0X4A317939C584CC0D.avi,1085,72,1660,57,575,2
0X4A3198A53976E7B3.avi,1162,48,1692,33,530,2
0X4A33F1C96141477.avi,1108,69,1717,51,609,2
0X4A35EEBF2751AE5C.avi,1024,70,1632,52,608,2
0X4A3623EE62D009F0.avi,980,75,1601,57,621,2
0X4A3A43D8373D9CB2.avi,1468,102,1801,85,333,2
0X4A4190933DB9D3F2.avi,1138,65,1679,47,541,2
0X4A423F4A126B0CC0.avi,883,97,1253,81,370,2
0X4A497C867371D86.avi,1009,170,1611,154,602,2
0X4A49AE73D48ED549.avi,1557,17,2028,2,471,2
0X4A4BAD2CF6E771EF.avi,1324,114,2166,101,842,2
0X4A4F385A385C35E8.avi,1230,78,1879,65,649,2
0X4A50992FC6CE05CB.avi,1071,167,1899,149,828,2
0X4A51D81E85B39997.avi,1955,14,2402,0,447,2
0X4A59A40F68222623.avi,1211,58,1855,44,644,2
0X4A59BE63FB51A4C4.avi,1242,65,1715,48,473,2
0X4A5B9DD5E6B03105.avi,1834,90,3101,70,1267,2
0X4A5C8A696DE2C287.avi,1458,137,2372,123,914,2
0X4A6184500426A482.avi,1179,135,1856,113,677,2
0X4A6300E2E21BB965.avi,1424,58,2314,42,890,2
0X4A6673C3B23FE5D4.avi,1110,82,1779,64,669,2
0X4A66A42C88E9C43E.avi,1255,155,2105,132,850,2
0X4A67C7061D12E437.avi,1134,139,1336,121,202,2
0X4A6B1963809D914F.avi,910,15,1766,0,856,2
0X4A6B7B77F43D03BF.avi,1033,59,1256,42,223,2
0X4A74EC6C63124A3D.avi,971,102,1512,83,541,2
0X4A792B82556BDA0A.avi,888,69,1464,50,576,2
0X4A79886D8A617331.avi,1345,65,2370,47,1025,2
0X4A7A08B4859C2466.avi,1731,108,2018,85,287,2
0X4A7A4FAAE293863A.avi,670,62,1047,49,377,2
0X4A82F51E7B0BD0B3.avi,1194,70,2025,55,831,2
0X4A86772242CB975.avi,1303,43,1466,30,163,2
0X4A86B3D9A1460493.avi,901,72,1510,53,609,2
0X4A8AD1EA88C671DE.avi,1248,78,1772,92,524,2
0X4A8BD43F7D5D5A1D.avi,708,51,1173,37,465,2
0X4A8E2CDD51954420.avi,3847,74,4456,50,609,2
0X4A8E3E2FB03F2A52.avi,1099,103,1783,87,684,2
0X4A90CC99C48AC524.avi,802,68,1170,58,368,2
0X4A922ED4E6FD062E.avi,994,128,1684,106,690,2
0X4A94E80ECE238D5D.avi,1087,43,1819,32,732,2
0X4AAB5FF288E161A4.avi,1579,112,2545,89,966,2
0X4AAB72A545D59B3C.avi,802,235,1334,220,532,2
0X4AAE1006E3BED4E3.avi,1417,52,2210,39,793,2
0X4AB5A5C9DDFB0619.avi,1136,115,1932,95,796,2
0X4AB6898CED6FCBF7.avi,853,54,1409,38,556,2
0X4AB89A6D9C9B4EAC.avi,2141,65,2528,50,387,2
0X4AB98BB972E5ACEB.avi,935,107,1534,89,599,2
0X4ABB170F5E95C0A0.avi,941,52,1444,42,503,2
0X4ABC1176D3D625B4.avi,1232,62,1938,43,706,2
0X4AC474B089EFC824.avi,1087,110,1744,93,657,2
0X4AC8A1036351CD7A.avi,1379,119,1917,100,538,2
0X4ACCB4F9F816D5E9.avi,807,22,1100,4,293,2
0X4AD47C3103D9FD6D.avi,2959,75,5236,55,2277,2
0X4AD48990409BEA7F.avi,794,68,1276,49,482,2
0X4AD5767864F972AF.avi,1375,59,2161,43,786,2
0X4AE10D9EF94811BA.avi,1539,17,1840,2,301,2
0X4AE13510C2FEE40E.avi,747,50,904,39,157,2
0X4AE44D9414344C78.avi,1011,55,1505,37,494,2
0X4AE4981D62FD4A2F.avi,904,126,1440,104,536,2
0X4AE79DABBD8D1F6D.avi,1101,66,1667,49,566,2
0X4AE815B9D7942730.avi,780,80,1020,64,240,2
0X4AE85C73AA12C02F.avi,2630,118,2989,99,359,2
0X4AEB420BC16F865B.avi,808,53,1270,40,462,2
0X4AF0B1C1E9B8A1A1.avi,997,105,1447,89,450,2
0X4AF13F1F6DDCD882.avi,708,90,1022,75,314,2
0X4AF15C56DD02C3C0.avi,1234,139,1623,119,389,2
0X4AFA0E75120A4E8D.avi,1558,41,2357,29,799,2
0X4AFA30A014892014.avi,896,102,1256,89,360,2
0X4AFFD0B23897952C.avi,1095,75,1917,56,822,2
0X4B071CB75AAF67A7.avi,1786,20,2587,1,801,2
0X4B07B1AA398DDD94.avi,1047,69,1657,52,610,2
0X4B082E613A87C172.avi,1304,96,2017,79,713,2
0X4B09D05622E61B48.avi,644,44,879,34,235,2
0X4B0A82F5ED5679DA.avi,1033,66,1601,47,568,2
0X4B0FE3095BD77020.avi,601,52,933,40,332,2
0X4B11E88B93EDBFDC.avi,667,90,1141,72,474,2
0X4B122FA0EEEDA898.avi,1297,19,2031,1,734,2
0X4B1424E2649E16B1.avi,1822,68,2827,60,1005,2
0X4B166078B705F934.avi,1459,90,2237,71,778,2
0X4B19A8E80BA019E9.avi,1145,121,1859,99,714,2
0X4B1A9E16A188C018.avi,1117,145,1711,120,594,2
0X4B1E3D75434F6785.avi,996,91,1519,75,523,2
0X4B1EC0E5119B249C.avi,1284,68,1769,49,485,2
0X4B21BE4FEAF4ABC1.avi,2723,146,3802,128,1079,2
0X4B2656CCE4C71467.avi,1242,116,1982,99,740,2
0X4B2690203CB2F7BB.avi,901,65,1457,48,556,2
0X4B26F81BD69BD461.avi,1031,137,1725,118,694,2
0X4B29EC30C3786EBC.avi,1839,74,3518,56,1679,2
0X4B2E0364719FD6A9.avi,1304,136,2030,116,726,2
0X4B2FC6E0DEDCA073.avi,1589,111,2312,93,723,2
0X4B39E73ABDB57B68.avi,866,82,1487,67,621,2
0X4B3A70F6BD40224B.avi,1275,54,1949,112,674,2
0X4B40434A5615B2BA.avi,1301,126,2167,108,866,2
0X4B41FE94F65ED4FC.avi,1433,82,2249,66,816,2
0X4B47B78A1356F3A8.avi,1525,18,2350,2,825,2
0X4B4A468566EB1E0E.avi,3185,14,3774,5,589,2
0X4B5151BFF0CF1234.avi,832,62,1252,46,420,2
0X4B525C2573A90917.avi,1110,16,1470,3,360,2
0X4B5599EB2B1B6383.avi,1820,125,3312,104,1492,2
0X4B565D14EC8C7DB6.avi,1641,150,2665,112,1024,2
0X4B584BB69E09EAD1.avi,2430,90,2675,75,245,2
0X4B58EABEDE38896B.avi,2086,45,2332,29,246,2
0X4B59AFFC9928548B.avi,1130,67,1909,46,779,2
0X4B5BEC383832FB9F.avi,1404,73,2175,55,771,2
0X4B5F467657C70230.avi,1152,88,1979,71,827,2
0X4B64537E074E1D57.avi,1470,70,2054,50,584,2
0X4B64ED4B0848592.avi,912,70,1396,53,484,2
0X4B68039EFC700669.avi,1061,104,1447,92,386,2
0X4B698168EA103F9.avi,2081,59,3273,42,1192,2
0X4B79F74D02C77B91.avi,1285,93,2001,81,716,2
0X4B7C480E6B6C5F4C.avi,1804,75,2123,55,319,2
0X4B7D5DF79FE55378.avi,1716,85,2298,69,582,2
0X4B847FE977316E0.avi,1273,95,1938,71,665,2
0X4B87A05615A53E5F.avi,1011,79,1556,65,545,2
0X4B89B49E15E14D26.avi,1463,59,1698,37,235,2
0X4B8CD0B98CEB8EAB.avi,1445,214,2331,184,886,2
0X4B95C69A063EB22D.avi,1372,124,2088,105,716,2
0X4B9C09C64E8081E1.avi,1654,77,1938,45,284,2
0X4BA70A790EF786BE.avi,1465,145,2265,126,800,2
0X4BA8D894A4CAC20A.avi,789,123,1193,106,404,2
0X4BA9D17E8AB2AF4E.avi,1032,59,1729,43,697,2
0X4BAA83546BB9380D.avi,1059,74,1860,58,801,2
0X4BB050017DDF609.avi,1378,47,1968,36,590,2
0X4BB3993C8A5A8977.avi,2106,100,2721,78,615,2
0X4BB8DC3E68BEB02F.avi,1294,60,1694,42,400,2
0X4BBA9C8FB485C9AB.avi,816,0,929,71,113,2
0X4BC28F2815304567.avi,781,106,1192,93,411,2
0X4BC813EAB8928F95.avi,756,84,1023,73,267,2
0X4BCA2D411679E784.avi,892,51,1588,40,696,2
0X4BCC5BA7C5470944.avi,1191,73,2012,58,821,2
0X4BDB73AF3B7D95B0.avi,1114,41,1629,29,515,2
0X4BDC800A2389AD0C.avi,1333,11,2023,0,690,2
0X4BE3ED1D238EEAB9.avi,1325,54,1547,37,222,2
0X4BE905008004907A.avi,790,49,1222,38,432,2
0X4BF0DB86A9010424.avi,1972,60,2488,42,516,2
0X4BF119F934981194.avi,1017,161,1552,146,535,2
0X4BF33294A3CAE042.avi,1596,181,2528,163,932,2
0X4BF3DE30B4F6B86.avi,1841,109,2856,89,1015,2
0X4BF459CB177B8BE1.avi,1138,71,1920,54,782,2
0X4BF559BFA7DAD2E0.avi,1632,115,2945,99,1313,2
0X4BF6DA4F93352E9F.avi,1046,59,1809,40,763,2
0X4BFB0BF04447A0DD.avi,1532,83,2277,58,745,2
0X4BFC06E24046BAC2.avi,1346,149,2144,133,798,2
0X4BFD23141A6091C5.avi,566,14,716,0,150,2
0X4BFD28E76C66C41C.avi,1521,93,2244,71,723,2
0X4BFDE46ED7B401A1.avi,1505,57,2412,43,907,2
0X4BFE78C4BEC7AA93.avi,1775,192,2667,168,892,2
0X4BFFC22FACA59CF4.avi,1443,77,1824,61,381,2
0X4C017259B103AAEE.avi,957,113,1598,98,641,2
0X4C02937ED93C6C82.avi,779,105,1186,79,407,2
0X4C03123EFAA5067B.avi,964,126,1990,107,1026,2
0X4C03A878AB261E5.avi,722,101,1153,84,431,2
0X4C0A0D74EBABE209.avi,1153,89,1951,75,798,2
0X4C10037D22ABEC73.avi,795,49,1247,39,452,2
0X4C1361334313836F.avi,2178,82,3399,64,1221,2
0X4C1780A7FE432F57.avi,1337,60,1567,47,230,2
0X4C1851D41B1A615A.avi,1454,39,1864,27,410,2
0X4C2335075A96DD85.avi,1390,72,2391,54,1001,2
0X4C237A567F5002FC.avi,1070,20,1745,3,675,2
0X4C26D3921A0BB05C.avi,1175,69,2016,55,841,2
0X4C28BDBE546E6B12.avi,1476,160,1870,143,394,2
0X4C340319107C4943.avi,1108,101,1951,83,843,2
0X4C371F553F658F4A.avi,840,76,1212,55,372,2
0X4C3886781B19B953.avi,1654,18,2796,3,1142,2
0X4C3D1288ECBB8117.avi,708,57,1022,44,314,2
0X4C3FFA0312ADF0DA.avi,1113,55,1772,35,659,2
0X4C4591D9CB3DDDE8.avi,1793,17,2998,0,1205,2
0X4C4655AD4584F866.avi,1203,62,1716,47,513,2
0X4C468BD8DD069AA8.avi,1191,102,2056,89,865,2
0X4C49B523268655BE.avi,1335,144,2013,128,678,2
0X4C4AB1371DF72873.avi,854,107,1060,91,206,2
0X4C4D6F2D3455F022.avi,1245,123,1711,105,466,2
0X4C52576367EDE50B.avi,1447,84,2443,67,996,2
0X4C53CDD47193BEC7.avi,1062,65,1693,49,631,2
0X4C568666D11BB71.avi,860,125,1416,112,556,2
0X4C576D3B38DCAF3B.avi,843,71,1284,57,441,2
0X4C5B58DD6DEE9F41.avi,938,72,1429,53,491,2
0X4C5EA0992F006638.avi,1808,76,2109,60,301,2
0X4C6A28C4F6FAF44D.avi,1474,62,2458,48,984,2
0X4C6B4EA851FB7CD5.avi,937,117,1502,104,565,2
0X4C765C6A4C61E31.avi,1412,124,2144,106,732,2
0X4C78FD4E271DC686.avi,912,97,1738,83,826,2
0X4C79C1C85A865778.avi,1095,55,1614,38,519,2
0X4C7BB6C1C92781B0.avi,1146,75,1927,64,781,2
0X4C7CA272E540FDDE.avi,1028,100,1513,83,485,2
0X4C81F018685C5333.avi,1762,12,2323,0,561,2
0X4C8DA84ECA696012.avi,920,118,1346,102,426,2
0X4C8EB73366ADC960.avi,1344,24,1999,6,655,2
0X4C940AC8C0605D65.avi,1156,56,1955,43,799,2
0X4C9A1284B8E67C07.avi,1172,125,1895,112,723,2
0X4C9BF2EEFE6D8E03.avi,1032,73,1517,57,485,2
0X4CA58914A47D6EB8.avi,1346,97,2103,77,757,2
0X4CA5974AE29AD2C2.avi,1394,95,2069,75,675,2
0X4CA6C598613CA480.avi,937,70,1388,59,451,2
0X4CAF7FFD0699140A.avi,875,142,1389,124,514,2
0X4CB123C86AF06E35.avi,2146,44,2404,34,258,2
0X4CB1C43A0DA06048.avi,1054,18,1621,3,567,2
0X4CB68B0128EC8BB8.avi,904,98,1407,88,503,2
0X4CB87C3FC67B831.avi,908,67,1369,50,461,2
0X4CB88DECE22155BA.avi,1578,95,1942,83,364,2
0X4CBB408C0D18223.avi,1237,115,2119,98,882,2
0X4CBF0A6F0C972863.avi,1409,71,2195,51,786,2
0X4CC16E6750678D36.avi,1046,65,1679,47,633,2
0X4CC17C774BE7BE21.avi,2090,109,3494,91,1404,2
0X4CC6569F80929A0E.avi,1425,90,2146,73,721,2
0X4CC65CE3ECC83EDD.avi,767,117,1060,98,293,2
0X4CC680B82F171A82.avi,2077,61,3184,46,1107,2
0X4CCB0ABB54AAD290.avi,973,329,1417,312,444,2
0X4CD499A12AA116A9.avi,2010,64,2356,46,346,2
0X4CD637D93B06D6A7.avi,1194,135,1804,113,610,2
0X4CD7A96E08866F11.avi,1121,60,1913,46,792,2
0X4CD93C570A5BAD1B.avi,989,15,1536,0,547,2
0X4CDA2C041B3645A3.avi,1376,108,2145,90,769,2
0X4CDEDC3CA72436A1.avi,1985,73,3271,54,1286,2
0X4CDFBF74BE06CD79.avi,942,63,1544,46,602,2
0X4CDFD3195FA16B22.avi,1199,56,1655,40,456,2
0X4CE086FD09C0C80E.avi,1417,92,2346,76,929,2
0X4CE0E0E7010773C4.avi,1242,107,1874,86,632,2
0X4CE54541BBDDE3E.avi,1434,110,2349,88,915,2
0X4CE57216AF8F1E10.avi,1306,17,2262,4,956,2
0X4CE72E5392DFF72E.avi,1613,71,2098,96,485,2
0X4CEA5093E58402D2.avi,824,60,1366,42,542,2
0X4CEDA292EED01C94.avi,819,15,1219,4,400,2
0X4CF1BE8C472DCA51.avi,671,87,975,74,304,2
0X4CF43EB60D67F4FA.avi,903,42,1394,29,491,2
0X4CF5A561E4FD6401.avi,1274,130,2109,112,835,2
0X4CF9BACA68AB1338.avi,1452,72,2287,52,835,2
0X4CFB6BEA6D0C437F.avi,786,54,1335,41,549,2
0X4CFBE71C31434362.avi,905,55,1412,41,507,2
0X4D01E74191B49611.avi,804,106,1274,90,470,2
0X4D0222E0ECAF62B5.avi,919,117,1486,102,567,2
0X4D0291520E75CD23.avi,1304,71,2068,57,764,2
0X4D05415F9703CA47.avi,2073,83,2971,54,898,2
0X4D09A013097FCCB2.avi,933,204,1667,182,734,2
0X4D0A1712CDE848D1.avi,1041,10,1390,3,349,2
0X4D0F3CBCB6A77DD3.avi,1074,76,1574,57,500,2
0X4D13B86CE7623A02.avi,950,158,1578,140,628,2
0X4D160D96C3F7E1FC.avi,1157,43,1415,38,258,2
0X4D17A70DB464D7EB.avi,1120,55,1455,36,335,2
0X4D1EDDDF9C8A03B1.avi,1705,72,2685,53,980,2
0X4D1FA00A1C115E77.avi,1439,133,1822,118,383,2
0X4D28224289EE89D5.avi,1287,172,1551,159,264,2
0X4D2A1A1E92532688.avi,982,96,1640,81,658,2
0X4D2A66B9939577A8.avi,888,178,1521,155,633,2
0X4D2EB11276654447.avi,1904,74,2117,64,213,2
0X4D2EDFADE5E20671.avi,920,95,1434,79,514,2
0X4D2FF488DD4EC6BD.avi,577,40,899,30,322,2
0X4D382FD37FF3BE9A.avi,755,42,1120,34,365,2
0X4D383DD98BD6CD12.avi,2398,68,3116,50,718,2
0X4D386EB1CFBBF2E0.avi,1245,61,1456,45,211,2
0X4D3941FA34D265A1.avi,1738,72,2179,56,441,2
0X4D45DB40C07ABDB4.avi,978,95,1431,82,453,2
0X4D49F2F1D9FCA7B1.avi,686,112,1072,99,386,2
0X4D4A878E7156F2F5.avi,1480,116,2262,96,782,2
0X4D4AD8BFA119E9C6.avi,821,67,1589,52,768,2
0X4D4EB3BBA778944F.avi,971,43,1088,33,117,2
0X4D5698D867CAB134.avi,1789,58,2013,45,224,2
0X4D5875A78CDB6134.avi,1224,114,1767,93,543,2
0X4D5A130C23487046.avi,1256,139,2041,122,785,2
0X4D5D1CAEDFF330B3.avi,1096,69,1742,51,646,2
0X4D5F0870E57D20B0.avi,1286,62,2146,46,860,2
0X4D5F56A5E5E65A2D.avi,900,46,1321,33,421,2
0X4D62E04895FF6E99.avi,892,159,1371,140,479,2
0X4D632FF0483C23DC.avi,1047,110,1789,91,742,2
0X4D63E7433E03AD51.avi,2303,152,3810,135,1507,2
0X4D7581C48FA515A6.avi,1149,72,1927,55,778,2
0X4D7A36B4D79C91BE.avi,1189,69,1635,56,446,2
0X4D7DE24F07975B44.avi,972,127,1638,107,666,2
0X4D7F997CE6456E59.avi,1043,17,1545,1,502,2
0X4D9831DA52FD3036.avi,777,50,1266,37,489,2
0X4D98AD1D14520724.avi,1431,112,1828,99,397,2
0X4D99A73E71A323B8.avi,1289,79,2207,61,918,2
0X4D9BF9D205C0FB63.avi,1101,75,1910,58,809,2
0X4D9D753FBE44EB57.avi,897,53,1382,41,485,2
0X4D9DC3BA4B7C8E52.avi,1070,146,1809,128,739,2
0X4D9E5AC44BA7A1A2.avi,1001,62,1708,50,707,2
0X4DA5545E836ACC84.avi,950,94,1476,77,526,2
0X4DA7FB1F092BD92B.avi,940,59,1328,42,388,2
0X4DA94E47D07B0048.avi,1720,87,2319,65,599,2
0X4DAA75CD814E3D63.avi,1014,87,1641,66,627,2
0X4DAA863D22C7C527.avi,955,56,1541,42,586,2
0X4DAC23C28ADA5AD4.avi,972,61,1601,33,629,2
0X4DAE17608E513F21.avi,858,60,1238,40,380,2
0X4DAF2BC7AD5242BF.avi,850,148,1299,131,449,2
0X4DB13082260E993.avi,961,110,1443,92,482,2
0X4DB4EF7CCB391976.avi,980,64,1447,44,467,2
0X4DB983F2F26967CD.avi,687,36,1221,27,534,2
0X4DBB637F38A94042.avi,1590,118,2758,101,1168,2
0X4DBBB860A9E16B60.avi,860,112,1328,98,468,2
0X4DC29CB827A32F23.avi,1023,65,1565,48,542,2
0X4DC2A9679CFE55D6.avi,1226,121,1556,95,330,2
0X4DC501859B8AD03A.avi,1600,73,2683,49,1083,2
0X4DC564B166185106.avi,1299,173,1896,155,597,2
0X4DC5C0B02078DAA5.avi,1165,46,1747,37,582,2
0X4DCB41CC1C9FA1DB.avi,962,70,1622,54,660,2
0X4DCB44704D75BCB4.avi,977,56,1421,32,444,2
0X4DCC1EBE5B2828F7.avi,923,87,1351,72,428,2
0X4DCDEBC261FBDD2C.avi,1797,76,2528,64,731,2
0X4DD35ADBF5157AE9.avi,1052,102,1751,130,699,2
0X4DD6FBB2172E0495.avi,1026,19,1579,3,553,2
0X4DD7357E4FC5C36C.avi,967,17,1777,3,810,2
0X4DD8B4E886B58857.avi,1285,67,1955,51,670,2
0X4DD8FD6672F5D940.avi,990,12,1590,3,600,2
0X4DDA207C5F52679D.avi,1606,113,2805,97,1199,2
0X4DDD7E9274D55C14.avi,824,108,1511,93,687,2
0X4DE81216AF40A1C6.avi,1010,79,1331,60,321,2
0X4DE88A7BC4B1CDCF.avi,839,69,1346,52,507,2
0X4DEAED0369D251DE.avi,1343,109,2082,82,739,2
0X4DEF7AC168F77831.avi,1657,18,2243,3,586,2
0X4DF2096646154C2C.avi,1390,174,1853,151,463,2
0X4DF27EE90B259A5.avi,1039,310,1651,281,612,2
0X4DF45F03A54748E8.avi,1116,64,1769,51,653,2
0X4E002858AD8C3D79.avi,1301,93,2337,69,1036,2
0X4E028970F071735B.avi,1922,15,2393,4,471,2
0X4E04DE86F469A5F.avi,2226,75,2529,62,303,2
0X4E071B7E41E2AD3C.avi,1452,78,2566,59,1114,2
0X4E08FFB6EE737DF7.avi,785,144,1314,127,529,2
0X4E0955151AB91800.avi,1799,180,2680,160,881,2
0X4E0BC2C036E928B1.avi,1701,58,2437,45,736,2
0X4E0D41E5066CDE8A.avi,1454,52,2277,40,823,2
0X4E0EC31DCD9CFD67.avi,2572,63,3282,47,710,2
0X4E10843EF877019F.avi,1016,113,1549,100,533,2
0X4E10CC5FB8883477.avi,1077,57,1748,44,671,2
0X4E165469F6219CA.avi,1306,80,1989,62,683,2
0X4E16DBD27618153.avi,913,78,1523,65,610,2
0X4E1BF109C3950D1A.avi,771,59,1243,49,472,2
0X4E1CF95FB15B1B41.avi,988,60,1754,45,766,2
0X4E20A4C205622D65.avi,855,109,1320,97,465,2
0X4E2793B64C6E1697.avi,1140,62,1900,48,760,2
0X4E2D6ABB908ECD0E.avi,968,88,1631,75,663,2
0X4E320712C667E02.avi,1602,62,2506,47,904,2
0X4E33F81AADBB343F.avi,1365,81,1637,65,272,2
0X4E3854D3B444A40.avi,1228,73,1939,51,711,2
0X4E38E030A745C3A7.avi,980,98,1680,82,700,2
0X4E399F38CE822B3D.avi,1115,131,1845,116,730,2
0X4E3C5105B7264BCB.avi,1473,134,2244,115,771,2
0X4E3D22FB4AFDEEE6.avi,2079,62,2662,37,583,2
0X4E3E54697AC86829.avi,1041,119,1670,99,629,2
0X4E3F9006EAE3AF6A.avi,960,114,1591,97,631,2
0X4E40C59987FB86E4.avi,1190,73,2071,56,881,2
0X4E412E462075485D.avi,911,15,1311,0,400,2
0X4E464B347B6CF96D.avi,1864,103,2712,66,848,2
0X4E4813A99BD6F4B4.avi,2551,58,4241,44,1690,2
0X4E4A2D91D3CCA44B.avi,1133,161,1886,147,753,2
0X4E4C81F9E47142B2.avi,1204,77,2152,58,948,2
0X4E4FDDC1BB14AC83.avi,746,52,1123,38,377,2
0X4E52A90E5831E39F.avi,2312,49,3468,33,1156,2
0X4E54F636B1924B21.avi,1435,113,2151,103,716,2
0X4E5765C29D7D4621.avi,1004,60,1293,39,289,2
0X4E5A25A73BE58A0.avi,996,59,1550,39,554,2
0X4E5A974D6675B7DA.avi,1006,65,1601,45,595,2
0X4E5DF72148AC9F4F.avi,1292,134,2210,118,918,2
0X4E5E3D56B330AAF7.avi,1311,48,2104,33,793,2
0X4E621F66A326C49E.avi,1236,131,1505,120,269,2
0X4E62C3793DAEB84C.avi,854,284,1291,267,437,2
0X4E665209F941789A.avi,1599,82,2648,68,1049,2
0X4E67A3282A2BD57C.avi,1080,84,1934,65,854,2
0X4E69D799006FE37A.avi,1076,33,1714,22,638,2
0X4E6C958D54DCB463.avi,1175,103,1864,90,689,2
0X4E6CD95441F3C2D4.avi,1107,60,1553,42,446,2
0X4E6D554241E2AEDF.avi,1048,198,1678,185,630,2
0X4E725B5FD89411A7.avi,685,86,1134,62,449,2
0X4E75F3A54E92EE54.avi,878,40,1100,28,222,2
0X4E7832F9B39AD0E7.avi,1174,99,1571,86,397,2
0X4E7BAF8F68BD8886.avi,745,107,1222,89,477,2
0X4E7C9CA0AD861665.avi,1070,112,1504,93,434,2
0X4E7CB9094C0B9DE1.avi,646,36,955,25,309,2
0X4E81E783F4DB5B74.avi,951,56,1229,75,278,2
0X4E81ED16535A1BB7.avi,1020,108,1302,93,282,2
0X4E853239612456E5.avi,638,49,984,32,346,2
0X4E8ADDABFF433B57.avi,1987,170,2399,154,412,2
0X4E8DE76280B1445B.avi,1321,155,2098,142,777,2
0X4E90F05CC9B09307.avi,1188,66,1835,47,647,2
0X4E9306F55F5359D7.avi,977,59,1596,39,619,2
0X4E937E2B7BE93AF2.avi,1171,87,1597,74,426,2
0X4E9496513479C330.avi,2741,56,3461,32,720,2
0X4E97DA06A513F89A.avi,943,73,1387,62,444,2
0X4E984664E70238.avi,977,17,1403,1,426,2
0X4E98FC62B0018096.avi,1561,17,2169,3,608,2
0X4E99E59B60D1BE5B.avi,1316,170,2282,147,966,2
0X4E9A560DF17EE46B.avi,934,138,1347,122,413,2
0X4E9D55E9C61DB47A.avi,1050,53,1646,39,596,2
0X4E9F08061D109568.avi,1046,1,1087,59,41,2
0X4EA00E9FC42DD0D8.avi,866,106,1359,93,493,2
0X4EA078CC4E65B6A3.avi,3650,61,4043,42,393,2
0X4EA55CD0DC56E02E.avi,1917,108,3274,92,1357,2
0X4EA563488AF67C53.avi,631,90,910,81,279,2
0X4EA5AB16CEFE6434.avi,853,149,1321,133,468,2
0X4EA6D34C1F46366F.avi,1888,16,2543,2,655,2
0X4EA930D226D84AD8.avi,1487,91,2441,71,954,2
0X4EB1153ED4780B7E.avi,1330,62,2097,47,767,2
0X4EB202C225CEFF2.avi,1534,116,2392,97,858,2
0X4EB557C6A109190C.avi,754,61,1122,46,368,2
0X4EB55F5BF786BF5C.avi,1824,53,3172,40,1348,2
0X4EB91AA00350C857.avi,1177,90,2185,75,1008,2
0X4EBADC5362794865.avi,791,130,1375,116,584,2
0X4EC43FBE6C1D6028.avi,1861,61,2423,42,562,2
0X4EC51376FE531C3A.avi,1576,53,2115,39,539,2
0X4ECADC034CB56EF4.avi,1950,116,2437,97,487,2
0X4ECECBC46D4ACCB7.avi,1651,17,2516,2,865,2
0X4ECF7AF58277874E.avi,1805,19,2665,3,860,2
0X4ED08C40FFA580E3.avi,827,177,1407,167,580,2
0X4EDACB406C98305C.avi,1590,18,2558,1,968,2
0X4EDDCC9262193618.avi,2473,60,4320,41,1847,2
0X4EDEDA9675BBA279.avi,2012,114,2473,103,461,2
0X4EE64D666DF75107.avi,1399,122,2298,105,899,2
0X4EEC1E7FEF4A8451.avi,1179,60,1933,45,754,2
0X4EEC273ACACB8DC1.avi,1139,135,1535,117,396,2
0X4EED91FDB02D72F9.avi,983,64,1688,50,705,2
0X4EEE65C7A3051C53.avi,652,19,1126,3,474,2
0X4EEE7DF904544AD2.avi,826,55,1201,38,375,2
0X4EEF887DA3A46D5B.avi,1099,135,1778,116,679,2
0X4EF738B9EC34D664.avi,2110,17,2554,0,444,2
0X4EF859DB4F6D52D4.avi,1332,103,1954,89,622,2
0X4EF94579D05665F7.avi,754,141,1241,121,487,2
0X4EFB94EA8F9FC7C2.avi,1698,17,1859,0,161,2
0X4EFBD2666D844938.avi,963,60,1485,43,522,2
0X4EFF3AFD2E70D8B.avi,2252,60,2461,43,209,2
0X4F001FE7C65DEB60.avi,1245,64,2005,51,760,2
0X4F00AAFE5870A218.avi,1162,35,1877,25,715,2
0X4F01C58EAA0EAF38.avi,1520,71,2164,58,644,2
0X4F02DBDF1B8E730A.avi,607,43,867,28,260,2
0X4F0312061571DC46.avi,1057,130,1546,116,489,2
0X4F052EF179738E8.avi,1095,64,1920,47,825,2
0X4F068B5E4772C3B1.avi,1503,68,1873,53,370,2
0X4F07C596C53C9A0E.avi,1244,82,1427,67,183,2
0X4F07CA07E28A03F2.avi,902,60,1608,42,706,2
0X4F0A56451DADD1E8.avi,1549,131,2040,112,491,2
0X4F13D40DFB6D079F.avi,818,104,1348,88,530,2
0X4F151B857306CD84.avi,786,104,1371,87,585,2
0X4F15F814B6C4AC07.avi,1192,151,1434,135,242,2
0X4F1634C33E5A0522.avi,1148,108,1891,90,743,2
0X4F1931029A1D9934.avi,1758,71,2449,55,691,2
0X4F1B9F3892A85EB7.avi,881,55,1435,42,554,2
0X4F1C516BC97B41EE.avi,1467,95,1757,79,290,2
0X4F1F34E939FC2557.avi,876,78,1291,65,415,2
0X4F20288846F54AAD.avi,1001,99,1714,87,713,2
0X4F2FCFDBC0A1DD38.avi,1352,20,2171,3,819,2
0X4F2FF2F686A266C3.avi,1124,61,1903,46,779,2
0X4F30FC9068E8FE43.avi,952,176,1435,162,483,2
0X4F331FB817B1F3BE.avi,795,61,1374,49,579,2
0X4F38559E6842E6B9.avi,1219,121,2000,109,781,2
0X4F3D2A57AE67F1BA.avi,969,61,1651,45,682,2
0X4F3E4E3D41B3880F.avi,1056,106,1583,92,527,2
0X4F3EA3910326F0CC.avi,1098,76,1778,58,680,2
0X4F3FE52D34FEC127.avi,707,52,1185,39,478,2
0X4F421A5FB2E90A22.avi,1395,57,1617,40,222,2
0X4F4419A0DFA94461.avi,880,97,1386,85,506,2
0X4F47E30FDD6BE447.avi,1383,120,1763,108,380,2
0X4F48415B343A0D90.avi,1289,82,2288,68,999,2
0X4F4BB57DAEE2B13E.avi,1152,59,1685,45,533,2
0X4F4D1ACDEAAD616D.avi,872,136,1366,117,494,2
0X4F4F64C47B366DC9.avi,971,118,1400,99,429,2
0X4F536E88702468E5.avi,1048,75,1787,57,739,2
0X4F5499DDFF536F69.avi,2068,120,2761,86,693,2
0X4F55DBA9FA2C8A16.avi,1125,18,1548,2,423,2
0X4F582A71F1FF7D0D.avi,1038,77,1660,64,622,2
0X4F599EF3B97B2074.avi,874,51,1368,35,494,2
0X4F5AC6C6E87FE738.avi,1706,53,1976,39,270,2
0X4F67102FD11ACB40.avi,1625,114,2358,97,733,2
0X4F6A027D4F2767D2.avi,920,129,1392,116,472,2
0X4F6EAF6EA9D0D4AA.avi,1179,105,1922,91,743,2
0X4F75447642EB2B26.avi,1287,51,2159,37,872,2
0X4F7741E1C11B62D0.avi,1067,94,1812,80,745,2
0X4F78BDF6D975B3F4.avi,1661,74,2660,59,999,2
0X4F8669AE1E9EF98A.avi,1281,71,2219,55,938,2
0X4F881958C896CE48.avi,915,18,1502,2,587,2
0X4F8859C8AB4DA9CB.avi,1091,22,1206,1,115,2
0X4F89846030713617.avi,1264,122,1822,106,558,2
0X4F8A67FD2D22326D.avi,1006,54,1540,38,534,2
0X4F91266598DC110C.avi,1013,22,1604,4,591,2
0X4F919DE23C2FA6E2.avi,1124,115,1915,95,791,2
0X4F940270E621C80F.avi,1474,50,2044,37,570,2
0X4F963A8803EE27E1.avi,1332,19,2212,0,880,2
0X4F96D302CB820C76.avi,988,113,1742,97,754,2
0X4F98D02DFC3B1946.avi,945,92,1474,76,529,2
0X4F9A4229C54DA391.avi,1050,60,1773,46,723,2
0X4F9AAFE15DEFF1DD.avi,1446,20,2320,2,874,2
0X4FA293CB5DA42464.avi,1316,81,2036,65,720,2
0X4FA94B7C48199688.avi,896,69,1552,51,656,2
0X4FAB297B6620A2AB.avi,1644,152,2630,136,986,2
0X4FACABF5BA7D337.avi,1265,114,1911,104,646,2
0X4FAD323C9963C4C5.avi,1156,61,1953,46,797,2
0X4FB1EC855B216E1A.avi,985,113,1457,99,472,2
0X4FB7C9EF56491F44.avi,1893,64,3239,41,1346,2
0X4FB86E58433D484.avi,2008,59,2208,42,200,2
0X4FB8E429239BF340.avi,1202,56,2047,45,845,2
0X4FBBACA1DE70DD6.avi,945,117,1407,98,462,2
0X4FC889C80C584428.avi,694,87,1117,69,423,2
0X4FCDB057B0CDE7DF.avi,1364,63,2033,46,669,2
0X4FCE535BE53FAB25.avi,1079,122,1864,102,785,2
0X4FDA647A573CBE00.avi,1228,102,2001,88,773,2
0X4FDFAA192A4C1A34.avi,1171,56,1611,42,440,2
0X4FE2CBC9422F019B.avi,1533,146,2258,123,725,2
0X4FEC9915044DD151.avi,1109,14,1487,1,378,2
0X4FF3346B3C8EC3AB.avi,1131,58,1770,43,639,2
0X4FFC94D07CF61F1D.avi,1479,99,1712,77,233,2
0X500329C3351ED572.avi,1484,101,2251,65,767,2
0X500FC4E8716B0A8F.avi,1176,63,1526,97,350,2
0X50123D34D2500DE7.avi,2257,68,2964,49,707,2
0X50138BF24E34070.avi,709,87,1097,75,388,2
0X501B99B68693CCE1.avi,1835,82,2920,65,1085,2
0X50249BC3755317E9.avi,1672,78,1932,60,260,2
0X50273065E4D6B4ED.avi,1693,103,2954,94,1261,2
0X502AEA12E5BBB9D2.avi,1293,110,2184,87,891,2
0X5031E6955F4365B4.avi,1692,130,2639,110,947,2
0X503525FC85147E0C.avi,847,80,1424,67,577,2
0X503BD718C4BF61C3.avi,1138,66,1915,47,777,2
0X50427F902D83EA24.avi,1282,104,1778,87,496,2
0X5042C6AB36212224.avi,2267,89,3021,69,754,2
0X505828C7FAF08FAF.avi,1032,56,1496,37,464,2
0X5069F73ECE751F8B.avi,1401,60,1888,40,487,2
0X506A4B034D096FD7.avi,1414,118,1941,103,527,2
0X506EEAD6511D811C.avi,1147,62,1777,51,630,2
0X5070727F1ECC8DD4.avi,1070,67,1576,54,506,2
0X50718C14D74E7486.avi,1616,125,2428,110,812,2
0X5071B146A249B859.avi,1032,54,1896,38,864,2
0X507257F3C2959527.avi,1321,50,1951,37,630,2
0X5077E67FD3C011C.avi,1261,61,1847,43,586,2
0X507C7C082EA6B68F.avi,1523,106,2257,87,734,2
0X50807FBC49B44ED4.avi,4047,58,6303,43,2256,2
0X5083D1646DF2023E.avi,1038,65,1679,37,641,2
0X50843AB0C28327D4.avi,915,112,1399,101,484,2
0X508601D38C7D0090.avi,1157,16,1813,5,656,2
0X5089EB6EC06D2181.avi,2191,106,2755,85,564,2
0X508FD6CD0EA0699D.avi,1417,89,1920,71,503,2
0X508FE72264BBC1D2.avi,1069,98,1556,81,487,2
0X5090FDBDC644DDBB.avi,1138,93,1860,74,722,2
0X50915122F649829D.avi,1401,98,2214,84,813,2
0X50974B4CA53CDE5A.avi,1105,77,1550,60,445,2
0X5098726A21007991.avi,1068,166,1370,139,302,2
0X509943F2C5C692C1.avi,1071,60,1896,46,825,2
0X509B4E8F6B3C73F7.avi,1101,65,1417,49,316,2
0X509C9EE624629703.avi,1027,52,1592,37,565,2
0X50A01D7C0D1E0E45.avi,955,70,1583,49,628,2
0X50A161F5290B4A01.avi,1398,86,1633,75,235,2
0X50A22335DC1C7A37.avi,837,52,1590,39,753,2
0X50AA85E1108DD28D.avi,1168,168,1887,153,719,2
0X50AB04A900534867.avi,1362,114,2101,99,739,2
0X50ADAC3EEB4348E3.avi,1099,63,1799,45,700,2
0X50AF86577B0E0C0.avi,1346,17,1521,3,175,2
0X50B19C247881BBAD.avi,640,85,1083,63,443,2
0X50B2490FF86A89ED.avi,1482,83,2067,65,585,2
0X50B4E37239529E65.avi,1202,81,1723,67,521,2
0X50C66E404592BE7.avi,936,67,1495,52,559,2
0X50D4A9CD65B07152.avi,1646,161,2042,148,396,2
0X50D89DBCD571E45A.avi,1458,93,2395,77,937,2
0X50D9093629F3BA7B.avi,1450,71,2002,54,552,2
0X50DA3CD732256F5C.avi,832,53,1038,38,206,2
0X50DCD68550B88271.avi,1247,63,1852,46,605,2
0X50E1A609EDB71DDE.avi,1496,102,2133,88,637,2
0X50EFCFC1C29B956D.avi,871,52,1298,38,427,2
0X50EFE29884414EC2.avi,1376,157,1952,139,576,2
0X50F1A619EA4634A1.avi,1212,57,1720,39,508,2
0X50F2DBBCDE495383.avi,1080,95,1699,80,619,2
0X50F561E08B87FD73.avi,951,53,1523,43,572,2
0X50F967F1598F990.avi,1520,106,1878,88,358,2
0X50F9F19FB81D504C.avi,992,59,1588,46,596,2
0X5100C0F7F0AF1B58.avi,1134,17,1983,0,849,2
0X510159059AAA7201.avi,1706,99,2116,85,410,2
0X5107F84375998635.avi,1160,69,1856,51,696,2
0X51097AF8AA3331ED.avi,848,17,1148,1,300,2
0X510CBB5CB06F937B.avi,871,221,1272,213,401,2
0X510DF8DD83561A78.avi,1089,54,1717,40,628,2
0X510F6BFB4FBA32E.avi,1523,70,2026,51,503,2
0X510FF9F679F312C2.avi,1638,57,2565,41,927,2
0X51150E423F255843.avi,1253,117,1812,97,559,2
0X5115DAC6AB92DF56.avi,1282,75,2075,54,793,2
0X511728C63B70B4B1.avi,1728,121,2324,104,596,2
0X5118B4340358A520.avi,1211,23,1809,2,598,2
0X511C9798FB92301C.avi,1665,60,2420,32,755,2
0X511D25AE9C39685C.avi,595,49,884,36,289,2
0X5121D9B6B28A9A0D.avi,1008,269,1517,244,509,2
0X512232C545DBCE9F.avi,949,108,1216,97,267,2
0X5122FEA094776B90.avi,1641,60,1960,40,319,2
0X5125B39CB59E5FBE.avi,1326,52,1935,35,609,2
0X5126AE3A3650D66B.avi,1566,85,2073,72,507,2
0X51276E90BFD4E4C0.avi,753,119,1254,97,501,2
0X512845940E60D485.avi,1871,151,3188,131,1317,2
0X512A035A01A6C549.avi,876,96,1456,83,580,2
0X512A516AACF78DAB.avi,1330,62,2109,43,779,2
0X512A75F626846DD1.avi,691,73,1107,55,416,2
0X51327FBFD448A550.avi,908,61,1544,42,636,2
0X513338EB70290591.avi,1398,102,1635,86,237,2
0X513547F80FE92CA6.avi,1146,94,1714,75,568,2
0X5135B2283BB69AF3.avi,1624,19,2427,2,803,2
0X51387CAC8388DCAC.avi,1449,116,2311,102,862,2
0X513B9DFACA291153.avi,1489,125,2133,107,644,2
0X513CB49F4AFD54BB.avi,1056,127,1747,112,691,2
0X51472543858384F2.avi,1207,62,1733,46,526,2
0X514AE6D7248D0A2A.avi,1358,80,2153,63,795,2
0X514E30A308ED7C61.avi,1696,176,2525,155,829,2
0X51533857C7611936.avi,1412,83,2477,62,1065,2
0X5153747D26CD85F4.avi,1061,147,1554,129,493,2
0X51556AE74D21038E.avi,912,142,1407,123,495,2
0X51574834DE0DBDA.avi,1712,123,2588,104,876,2
0X515B00307A98E6F9.avi,1512,138,2090,124,578,2
0X515B3FC559BDA78C.avi,1258,78,2394,63,1136,2
0X515B9D79337A52A8.avi,904,43,1445,28,541,2
0X515BE303CDEBF73D.avi,1523,94,2442,67,919,2
0X515FB01ECBD93661.avi,1000,112,1545,97,545,2
0X5169B30FBF1908B0.avi,1046,128,1643,114,597,2
0X516A825179C202F9.avi,1310,67,1910,46,600,2
0X517063CA3BDBF3DA.avi,1720,75,2174,52,454,2
0X5171ECAA55C8BBA.avi,2315,19,3997,0,1682,2
0X5175AED2558B83E6.avi,1182,92,2002,66,820,2
0X517B9EA7B3FBEE17.avi,675,81,946,72,271,2
0X517DACB0D4E4274.avi,974,102,1459,89,485,2
0X517DB959DDA30D1F.avi,1174,138,1890,122,716,2
0X518BC58DF231D061.avi,3104,80,3291,64,187,2
0X5191570E6D6CCBC6.avi,1096,70,1543,48,447,2
0X5193979B5CD463D0.avi,2405,120,3678,101,1273,2
0X519483F9EFA0B20E.avi,2414,53,3645,31,1231,2
0X51A155A49796F621.avi,1337,113,2259,97,922,2
0X51A72288BC365D50.avi,960,99,1595,75,635,2
0X51A7D5E3CC58EB01.avi,1226,86,1947,73,721,2
0X51AB3FD231602B33.avi,1349,103,2184,73,835,2
0X51AF557A09FB40DA.avi,1522,144,2692,130,1170,2
0X51B29B65CD38C69E.avi,821,15,1305,1,484,2
0X51B5B37B6F4A8CA8.avi,933,145,1453,122,520,2
0X51B8DEE8747AFD9F.avi,2380,130,3825,113,1445,2
0X51BA813A5E8A6986.avi,1624,134,1976,115,352,2
0X51BB2250DB2403D5.avi,1359,117,1753,99,394,2
0X51C04B6508D13507.avi,1663,75,2306,49,643,2
0X51C33D62976C86E7.avi,928,44,1419,31,491,2
0X51C7B722CB637F8.avi,1399,116,2407,98,1008,2
0X51C9BBFB660CF100.avi,1801,85,2919,67,1118,2
0X51D2CBF603A4689D.avi,2153,64,3401,47,1248,2
0X51D385BFAEB40339.avi,1039,89,1817,73,778,2
0X51D66652BDB24941.avi,2167,56,2516,32,349,2
0X51D8A66B24FD69CA.avi,1322,70,1926,57,604,2
0X51DBEF15E61B4374.avi,1348,43,1648,28,300,2
0X51DC2AFCF509252E.avi,1348,53,1889,38,541,2
0X51DD9336133AA9A3.avi,865,74,1319,56,454,2
0X51DEA404C6DAE247.avi,1397,59,1965,50,568,2
0X51DF5916C8A5E638.avi,1727,61,2094,48,367,2
0X51E57CEE1EFF9453.avi,1909,66,2837,47,928,2
0X51E6A6EC8684036C.avi,1145,131,1985,114,840,2
0X51EBAEFBADEB15E9.avi,3237,103,3488,86,251,2
0X51EDA76C5B32BFB6.avi,1318,21,1626,3,308,2
0X51EEF0AF4CF6A039.avi,1283,70,1730,49,447,2
0X51F0878231E80676.avi,949,77,1490,67,541,2
0X51F276725BEE4BF9.avi,1826,19,2594,0,768,2
0X51F3A05DB9647C01.avi,2767,142,3678,108,911,2
0X51FD3D57BA8323F2.avi,1239,67,1868,50,629,2
0X51FE69873DAD3A42.avi,838,40,1543,30,705,2
0X51FF8C85CC1C6EC7.avi,1095,52,1733,36,638,2
0X52014FFC1A469302.avi,945,66,1337,52,392,2
0X520169BA78B3FD6A.avi,922,81,1320,65,398,2
0X520285C7C42A3A71.avi,1142,57,1761,44,619,2
0X5203FF5095E5A01.avi,1087,19,1728,0,641,2
0X5204CC14B02919D5.avi,2446,126,3831,97,1385,2
0X52060B6BF382C4B4.avi,1477,71,2406,54,929,2
0X5206D35DE3795342.avi,1938,107,2268,90,330,2
0X5206F9D88064AFE8.avi,1898,106,3036,90,1138,2
0X5208E6FA65C27BC5.avi,896,119,1345,101,449,2
0X5210A2AE344C6131.avi,982,54,1493,39,511,2
0X5216E8EAC6638EC5.avi,1955,116,2344,94,389,2
0X521D37449979E761.avi,833,86,1312,67,479,2
0X521EA8A95B25BF85.avi,1101,52,1619,41,518,2
0X5222169EED25C8D8.avi,1394,17,2134,0,740,2
0X5225E58471150AD3.avi,1152,67,1634,49,482,2
0X5226FB3272760299.avi,845,60,1255,43,410,2
0X52297761808D2976.avi,1145,122,1605,105,460,2
0X522E7EC5D8AA4628.avi,1592,79,2901,56,1309,2
0X522EE1FAE9E44660.avi,1272,18,1882,1,610,2
0X523258F4875D1051.avi,952,52,1624,35,672,2
0X5232F0CB5A9F5EFE.avi,2785,72,3024,53,239,2
0X5233D810FA8D90D0.avi,1013,127,1624,110,611,2
0X5235A82128C7DA89.avi,1331,59,2020,42,689,2
0X5238017D9647223F.avi,935,40,1589,28,654,2
0X523FA0DDFF2B86ED.avi,1470,105,1914,88,444,2
0X523FF4ADB265D1D7.avi,1333,65,1671,48,338,2
0X5242792A4F7179CB.avi,1182,111,1797,93,615,2
0X52440183F6E99858.avi,983,17,1718,1,735,2
0X5245782BC86D72CF.avi,1147,105,1858,90,711,2
0X524BD73B9BA0994B.avi,1270,55,2007,43,737,2
0X524E096EBA4915EA.avi,1571,110,2407,89,836,2
0X5250AF044F67C35B.avi,1976,99,2591,83,615,2
0X5250BFB3A5B5DE5D.avi,1290,54,1453,42,163,2
0X5251B40D3A1CD1D6.avi,977,68,1542,50,565,2
0X525504B5A2CB1678.avi,1123,58,1858,42,735,2
0X525A6043720EEE80.avi,1229,119,2080,101,851,2
0X525B53BB23B6BFFF.avi,794,58,1290,43,496,2
0X525F4337010EACD0.avi,1220,102,1872,87,652,2
0X525F58503C9356EE.avi,1191,72,1368,53,177,2
0X526147E29A61A557.avi,1132,71,1685,57,553,2
0X52619FC2739EB1F1.avi,601,19,862,0,261,2
0X5263B7448345F313.avi,963,94,1580,81,617,2
0X52640461AE729391.avi,1363,69,1934,52,571,2
0X5266458976482657.avi,605,49,1009,33,404,2
0X52681CFFD5B749CC.avi,1425,116,2263,98,838,2
0X526BA02D476E9274.avi,1332,73,1829,93,497,2
0X5271A44429C406DE.avi,1271,15,2296,3,1025,2
0X52741F3A8E09E79C.avi,1785,72,2051,55,266,2
0X52749A08918D145.avi,992,227,1685,206,693,2
0X527F41D680422536.avi,749,113,1278,100,529,2
0X52832AF3B2EE7826.avi,1465,79,1889,55,424,2
0X5284C8C05B0255E9.avi,1181,61,1817,49,636,2
0X528747A45FEF978E.avi,1301,74,1956,54,655,2
0X52894A1293DC3698.avi,1307,135,2127,116,820,2
0X5294006E7295A9D3.avi,809,136,1234,121,425,2
0X5295198F216052C5.avi,1734,177,2494,155,760,2
0X52A19EE2EB43DCEA.avi,770,86,1229,75,459,2
0X52A92D8D4C0BB36B.avi,1885,105,1911,96,26,2
0X52AB5E2861E64C14.avi,789,130,1383,111,594,2
0X52ADAC369E93CF52.avi,1486,65,2399,50,913,2
0X52B0FFBD0E252F79.avi,1233,62,1886,45,653,2
0X52B18B65394F13D1.avi,1044,123,1362,111,318,2
0X52B3311CBAFB526B.avi,921,65,1401,56,480,2
0X52B45CBAAC8373DA.avi,1375,86,2403,71,1028,2
0X52BBC4F30524BEB6.avi,893,121,1462,91,569,2
0X52C8E34676F66ADB.avi,1548,90,2091,63,543,2
0X52CBA0C16FD4CD3D.avi,1020,60,1631,47,611,2
0X52CC0BAB001C7C06.avi,1692,78,2063,66,371,2
0X52CDBA521DF75946.avi,935,19,1311,1,376,2
0X52D0359294EEDEA7.avi,1091,73,1615,58,524,2
0X52D27E1752D12960.avi,985,124,1419,104,434,2
0X52D4906BB576A5F5.avi,1234,109,1809,99,575,2
0X52D557F8B05D9D23.avi,799,48,1286,35,487,2
0X52D5600CFB02C68A.avi,898,16,1678,3,780,2
0X52D59CA57FAC5D8A.avi,2115,156,2452,141,337,2
0X52DD020FA81C5911.avi,797,16,1247,2,450,2
0X52E6FB1ABC9979AA.avi,1279,101,2265,84,986,2
0X52E72FE599012A73.avi,1273,107,2090,99,817,2
0X52E865A8C311F559.avi,981,80,1413,53,432,2
0X52EE1C53A1BC9F16.avi,1441,102,2319,85,878,2
0X52F3BB17DC1CC0EA.avi,806,56,1334,40,528,2
0X52F59CC4F973172F.avi,1856,50,2150,31,294,2
0X52F78B094464709B.avi,952,52,1606,35,654,2
0X52F97576E094322B.avi,987,47,1493,36,506,2
0X52FDE4342ACD5331.avi,1936,18,2996,0,1060,2
0X52FEE70BDB811E9B.avi,755,56,1330,36,575,2
0X5304E93805A039EC.avi,954,65,1523,50,569,2
0X5305BF4F8A3780B0.avi,1210,63,1962,47,752,2
0X53086AFB52330C89.avi,1316,118,1765,101,449,2
0X530DFA010BC9EE5A.avi,805,49,1240,38,435,2
0X53105275386CE431.avi,983,100,1675,78,692,2
0X53138007E8FCB197.avi,1258,59,1855,41,597,2
0X531443B0071CDBE7.avi,1151,109,1806,82,655,2
0X5314F4555E935D32.avi,919,152,1399,135,480,2
0X532255A0D06AF53D.avi,1417,148,2454,133,1037,2
0X532260359751DBB.avi,2075,61,2369,49,294,2
0X5323F2A87FB33D5.avi,871,147,1286,132,415,2
0X5324777137DAAF06.avi,2813,76,3182,61,369,2
0X532728AF419C2BD4.avi,1337,111,2084,95,747,2
0X53293E0FFF92E26A.avi,1571,105,2378,87,807,2
0X5331DF8AF33FA880.avi,919,72,1473,48,554,2
0X5333CEAC223AB6D0.avi,692,65,1018,52,326,2
0X533498EF6F72192.avi,526,74,797,59,271,2
0X53352F8300F75CEC.avi,1025,126,1761,109,736,2
0X53403DC4C4526AC3.avi,649,98,1206,79,557,2
0X53412B6864809F46.avi,897,67,1494,49,597,2
0X53432F9602925B2E.avi,1175,116,1880,100,705,2
0X53434964FF756E9A.avi,827,84,1416,71,589,2
0X53491FA3CDC950C1.avi,1116,82,1725,64,609,2
0X5349865A317C7B59.avi,2078,53,2609,34,531,2
0X53499C56E6465674.avi,934,136,1587,117,653,2
0X534A45D607A13527.avi,4931,57,5346,45,415,2
0X534B7A1F00C0869C.avi,1099,139,1694,121,595,2
0X534C9F54153DA440.avi,1580,55,2546,30,966,2
0X534F8C502A462B60.avi,1223,119,1874,105,651,2
0X5352D23D6CB2673C.avi,917,70,1314,55,397,2
0X53552FB88892AC31.avi,694,47,1055,34,361,2
0X5359A0AEC9FD8C36.avi,1304,96,1702,84,398,2
0X535B7884988ACFBC.avi,1160,79,1648,58,488,2
0X535C51E9C2EE35F1.avi,806,66,1261,51,455,2
0X535C97BB939E71C4.avi,1548,20,1882,0,334,2
0X53640FEE8C415E2A.avi,1060,108,1785,92,725,2
0X53654922C42D0581.avi,1001,109,1555,81,554,2
0X53665CE9C3E14600.avi,1467,50,1777,36,310,2
0X53666FBFC3CC3583.avi,1591,119,2295,100,704,2
0X536907DD9FB81B8E.avi,1965,59,2306,43,341,2
0X5369F6C63E8B5DF5.avi,1010,65,1607,49,597,2
0X536F4846A4B7D0F9.avi,1283,70,2405,52,1122,2
0X536FF5B8DA04D5A9.avi,1290,141,1926,130,636,2
0X5374EEB8E8E1650C.avi,851,66,1421,50,570,2
0X53766395EDD20AF4.avi,877,21,1348,3,471,2
0X537E0C66F1BC068B.avi,1062,49,1561,35,499,2
0X5384FB77E5EA44DB.avi,828,73,1419,55,591,2
0X5386330F2823CD9A.avi,1283,126,2296,111,1013,2
0X5389ED952B455A33.avi,751,58,1299,43,548,2
0X538CA13B226682A9.avi,1470,136,1809,119,339,2
0X538EE4B6099DF1CC.avi,1291,59,1986,41,695,2
0X53935BDDDDEAC8BE.avi,2218,106,3747,88,1529,2
0X539386FD2B2033D5.avi,1280,66,1938,53,658,2
0X539A371D00A8183E.avi,1700,19,2541,0,841,2
0X539C8A97334B092C.avi,1945,79,2357,68,412,2
0X539CB3C4DC98A2A2.avi,1243,77,2085,59,842,2
0X539FF77627188BF8.avi,1571,55,2056,44,485,2
0X53A0FEF8F35BDBDC.avi,1030,56,1699,38,669,2
0X53B6D6024241698C.avi,1451,66,2138,48,687,2
0X53BD50EB0C43D30D.avi,890,85,1463,51,573,2
0X53BE187CA129F29.avi,1105,106,1685,91,580,2
0X53C185263415AA4F.avi,1397,25,1835,37,438,2
0X53C2C17D229F3C15.avi,1255,71,2261,57,1006,2
0X53C64FBBD36CD7ED.avi,1331,59,2238,45,907,2
0X53C694BBD38E22BF.avi,932,12,1570,0,638,2
0X53C69D7485C75891.avi,1335,86,1975,69,640,2
0X53C84BFA9447BEE8.avi,1149,129,1966,118,817,2
0X53C87632CB74A529.avi,958,57,1532,40,574,2
0X53CDAEEF7BDFBFB2.avi,874,99,1322,79,448,2
0X53CDFF78C91C7385.avi,793,60,1256,43,463,2
0X53CE02247441397F.avi,871,46,1362,33,491,2
0X53D2957F996CF868.avi,996,83,1759,71,763,2
0X53D35BCC24F3C358.avi,1001,84,1570,67,569,2
0X53E07181682C4F8A.avi,1953,119,2748,100,795,2
0X53E1375C97572B46.avi,1397,66,1949,50,552,2
0X53E56B91AA00FA9D.avi,739,68,1203,52,464,2
0X53E9F9A7FB8F3310.avi,993,61,1656,47,663,2
0X53EEA5419A7890EC.avi,1142,94,1667,80,525,2
0X53F8BDD78E95B9FC.avi,1141,16,1740,0,599,2
0X54033ED5CBA33FFC.avi,1381,102,2751,83,1370,2
0X5404DDC9EBCC99AC.avi,1345,64,1767,45,422,2
0X5406E97A85CAEB10.avi,790,70,1411,48,621,2
0X5407651AF7E19AD1.avi,1928,24,2591,4,663,2
0X5407BBC70D8C2668.avi,1030,135,1602,111,572,2
0X5408E0317663E31D.avi,1574,123,2050,108,476,2
0X540A087A5D8BA000.avi,1205,57,1837,43,632,2
0X540A0C3A3D6FE15E.avi,1087,129,1714,114,627,2
0X540C108EF0C4BC0A.avi,1150,61,1730,40,580,2
0X540CEAFF8921F79A.avi,1134,77,1968,60,834,2
0X540DB65A86CE2AE9.avi,1481,56,2261,41,780,2
0X540FDA7545A0BE0D.avi,1016,102,1646,91,630,2
0X5411B84B15B3E3D3.avi,1284,73,2083,57,799,2
0X541432A2F24BA7A4.avi,1224,17,2038,3,814,2
0X5418A371914B3AAD.avi,1396,51,1916,38,520,2
0X541C0693140E6AD0.avi,918,33,1195,18,277,2
0X541CBDC87C8A9938.avi,1514,86,1829,66,315,2
0X5420B85CEA2D0031.avi,1156,100,1935,84,779,2
0X542269B9EE51A992.avi,1054,118,1739,101,685,2
0X542C044A1CD63BB5.avi,1054,17,1675,1,621,2
0X542D2E472E2F1679.avi,718,71,1250,51,532,2
0X5432781F699FAD85.avi,1157,207,1878,187,721,2
0X543AF83606F3A663.avi,906,57,1606,44,700,2
0X543FF08F5AEED836.avi,984,81,1578,73,594,2
0X5440A5C9A8CACA49.avi,1292,47,1880,28,588,2
0X54426A036FD34753.avi,4076,129,5123,101,1047,2
0X54442FC8E9CB9471.avi,1229,84,2019,67,790,2
0X5445E6F3C13CBD31.avi,808,85,1380,64,572,2
0X544FD7AD28A89E2.avi,1244,129,1636,109,392,2
0X545052C74517595D.avi,1483,55,2707,37,1224,2
0X5451814C7D5751EE.avi,1018,55,1650,40,632,2
0X545A13EBCAB66563.avi,1099,56,1859,41,760,2
0X545A872618190FB2.avi,890,60,1573,44,683,2
0X545AE8E42396264B.avi,2100,67,3443,49,1343,2
0X5463B4BB0B291919.avi,982,72,1475,50,493,2
0X5468C7D7A31C7B4E.avi,1242,132,2025,114,783,2
0X54698C3D37232417.avi,902,48,1286,33,384,2
0X547038301E3979F9.avi,852,46,1421,33,569,2
0X547103856DCD6CB5.avi,1958,82,3151,64,1193,2
0X547240BF9319AEB2.avi,1229,89,2132,82,903,2
0X54753D541D22E2A6.avi,1052,69,1808,53,756,2
0X547722DDE523BEA8.avi,885,79,1403,63,518,2
0X5477359C84D56656.avi,1597,83,1984,68,387,2
0X5478D5A9213C8100.avi,2090,118,2913,95,823,2
0X547B565B7E7D71E0.avi,1158,179,1821,164,663,2
0X547BE4F7E93BBD8E.avi,1088,69,1765,50,677,2
0X5482AE6485A16527.avi,1607,32,2293,20,686,2
0X5488B4989668C529.avi,964,84,1631,64,667,2
0X54929E074AA52477.avi,936,48,1301,33,365,2
0X5496FF752FDE2035.avi,1158,55,1856,75,698,2
0X549DC9EF35C8C4E1.avi,1618,50,2179,31,561,2
0X549E4D1EF55F1A8E.avi,1139,69,2151,46,1012,2
0X54A01EB69B2856E5.avi,1535,90,2328,77,793,2
0X54A17A345854DE4F.avi,1508,80,1884,64,376,2
0X54A1D14B31268CC6.avi,1856,117,2377,101,521,2
0X54A2D65EAE28F52.avi,997,48,1599,31,602,2
0X54B01A56E95D4A2E.avi,1320,79,2065,35,745,2
0X54B116C8FC863906.avi,825,136,1347,119,522,2
0X54B16EA56C850E86.avi,641,82,1170,62,529,2
0X54B172E349A11249.avi,971,55,1406,44,435,2
0X54B48701142030FC.avi,1296,19,2038,2,742,2
0X54B60ED35AF2106C.avi,1123,129,1880,115,757,2
0X54B663CB7EDDFDCE.avi,2155,61,3357,44,1202,2
0X54B71D4AF64D761C.avi,1174,156,1602,136,428,2
0X54B8B2249BC8D627.avi,1062,72,1695,53,633,2
0X54B9C80F509BBF38.avi,1574,60,2522,40,948,2
0X54BB6DC418E39712.avi,2048,111,3028,92,980,2
0X54BDACF8BA99714A.avi,1064,112,1727,95,663,2
0X54C421A80132E0C1.avi,774,49,1266,35,492,2
0X54CA4BDAF8C19A6C.avi,1484,60,1865,40,381,2
0X54CB2267CB8CEBBB.avi,1057,78,1514,66,457,2
0X54CD126B0C4D7D78.avi,1108,63,2105,46,997,2
0X54CDBDAA77A5FD1F.avi,1494,72,2546,104,1052,2
0X54CF7E6850392CF3.avi,1561,75,1672,62,111,2
0X54D24B12375DA7A9.avi,1534,119,2357,94,823,2
0X54D663188563F412.avi,1066,66,1635,47,569,2
0X54D8BECFC523ACC0.avi,1713,19,2666,2,953,2
0X54DB8759A3F32BB7.avi,1736,70,2409,51,673,2
0X54DF4907CC51E612.avi,1011,61,1718,47,707,2
0X54E4998C51F9E270.avi,727,48,1196,35,469,2
0X54E58ED86243D0B1.avi,2473,69,3396,46,923,2
0X54EA74B9F2F612A3.avi,1307,146,2061,116,754,2
0X54F30BAC1CA08CA5.avi,910,63,1303,48,393,2
0X54F3797A02026F4.avi,773,21,1281,15,508,2
0X54FBE65372BC873.avi,1042,84,1557,63,515,2
0X55002DEF59DB3DD2.avi,1296,65,1862,53,566,2
0X55058C5F4D7952FC.avi,1348,69,2128,52,780,2
0X55068EDD14C46A52.avi,794,19,1310,0,516,2
0X5508A93688262E41.avi,1453,129,2450,111,997,2
0X550D53D5EC185F5B.avi,1665,63,3281,45,1616,2
0X55108601E603EE28.avi,1869,101,2046,86,177,2
0X5511D9A61EB4B90.avi,2075,90,3224,71,1149,2
0X551726008E92B23D.avi,924,99,1558,85,634,2
0X5519060A689F206.avi,1851,45,2109,33,258,2
0X551C98C8FE6B51A9.avi,1745,16,2715,3,970,2
0X551E297304F24B60.avi,1052,112,1780,48,728,2
0X55232922CC7FEEED.avi,4003,63,4595,43,592,2
0X5525679C7CAF9ACA.avi,1007,72,1581,54,574,2
0X552D2BEC02396DD4.avi,1272,120,1941,104,669,2
0X552F06BFE42062D8.avi,1036,59,1726,41,690,2
0X552F28636AF60E12.avi,1066,58,1768,41,702,2
0X552F36A6E92D7FE8.avi,1053,51,2010,35,957,2
0X55306990D785541A.avi,977,134,1628,115,651,2
0X5530A07BC4EB238F.avi,1495,81,1952,61,457,2
0X55324702AE57AF6D.avi,594,58,865,40,271,2
0X5532CED62BAB6882.avi,939,17,1581,1,642,2
0X5537710165616E3F.avi,1241,59,1740,42,499,2
0X554436B8E190C6C8.avi,2248,102,2836,90,588,2
0X5544FBF1BA5A9A61.avi,874,108,1382,94,508,2
0X554AC1E23B17F678.avi,1703,104,2612,92,909,2
0X554BA85E872B3ADC.avi,955,78,1470,66,515,2
0X554E1E7CA898F04B.avi,999,19,1862,0,863,2
0X554F12E355AF8FF4.avi,767,12,1329,2,562,2
0X5551A05C97F8D56D.avi,1171,80,1904,60,733,2
0X5555BF5C1EDB9A9B.avi,1278,73,2233,51,955,2
0X555625C9E3EC6CEC.avi,854,86,1343,68,489,2
0X555876814CADAFA9.avi,922,105,1435,90,513,2
0X55622F196983BF6A.avi,1074,84,1738,73,664,2
0X5563B85DBBF1351C.avi,1974,24,2429,0,455,2
0X556778F52DA9C489.avi,1033,152,1859,133,826,2
0X556D518F0DA96477.avi,1106,77,1661,69,555,2
0X556EDE44066B12B8.avi,819,21,1282,2,463,2
0X556FD0F89DA85639.avi,1661,71,1916,52,255,2
0X5572CB2B3CEA5D9D.avi,1081,134,1803,121,722,2
0X5572F384EF9DD9FC.avi,1090,71,2026,53,936,2
0X55776F3806F893EA.avi,764,40,1301,29,537,2
0X557E1E735D23884B.avi,994,129,1604,113,610,2
0X5581B2D3B0328218.avi,1832,175,2842,155,1010,2
0X55822C238F9E5AD3.avi,1163,134,1992,114,829,2
0X55866DE7615EB0C5.avi,852,91,1331,69,479,2
0X558A2A6676BE7D36.avi,1569,66,2675,45,1106,2
0X558BBB9DC59ABE58.avi,1206,74,1611,60,405,2
0X558C8F3D27CEDA73.avi,1268,72,1892,60,624,2
0X558FCFDEDFCAFCD5.avi,963,19,1489,4,526,2
0X5590B39A15DFDEFB.avi,1061,70,1563,57,502,2
0X559321CCEEEF01DF.avi,1042,57,1733,43,691,2
0X55946D9966062EAB.avi,861,32,1072,21,211,2
0X5595939CF40AD617.avi,1186,20,2007,0,821,2
0X5596B9090BBECECC.avi,693,72,1069,53,376,2
0X559CBA3607FC7673.avi,1419,64,2482,49,1063,2
0X559FE34A6D107985.avi,1080,79,1816,61,736,2
0X55A40FE407A960E2.avi,934,60,1478,50,544,2
0X55A8DADE461043A7.avi,1334,123,2181,105,847,2
0X55AD49CFEDC55DA0.avi,910,90,1212,74,302,2
0X55AE4F5E25A9609F.avi,984,56,1758,39,774,2
0X55AEA1223ADFB9E8.avi,984,54,1405,37,421,2
0X55B0C7326EDA51B0.avi,842,49,1184,37,342,2
0X55B0F73B6D560359.avi,749,50,1254,35,505,2
0X55B28D6DC97FB5C4.avi,1432,65,1901,44,469,2
0X55B2FB1BDE1B809F.avi,1463,75,2360,53,897,2
0X55B49E2362323D1F.avi,981,42,1495,30,514,2
0X55B743099A8EC7BC.avi,711,77,1340,62,629,2
0X55BAE17B3063905A.avi,884,70,1222,53,338,2
0X55BD75ADD9A85ADB.avi,1231,70,1730,48,499,2
0X55BE2D4BC726F7B7.avi,1110,95,1962,81,852,2
0X55C0000B295E5100.avi,1184,74,1589,59,405,2
0X55C600641A1669E.avi,793,65,1363,49,570,2
0X55CA123768AEFB14.avi,1017,98,1372,82,355,2
0X55CFEE15BB86A841.avi,2218,238,3301,208,1083,2
0X55D3F7134FE08939.avi,800,68,1382,58,582,2
0X55D7CB901F53B25F.avi,1268,80,1903,64,635,2
0X55D7F567D55FE1F6.avi,874,87,1379,64,505,2
0X55D97A446839D999.avi,1816,79,2820,65,1004,2
0X55DD5AB1762EDCDA.avi,724,81,1173,57,449,2
0X55EF093BB97CF2D1.avi,2380,23,2592,7,212,2
0X55F05AC4B87FF7ED.avi,954,155,1463,134,509,2
0X55F34E78F82115A.avi,1893,85,3467,58,1574,2
0X55F5808EF06694A4.avi,1185,72,1929,52,744,2
0X55F8010A394F3756.avi,1540,74,2534,58,994,2
0X55FF5914AD9A8C52.avi,1405,71,1835,49,430,2
0X560279556FB69A44.avi,1243,108,2274,89,1031,2
0X5604847553919219.avi,2522,55,3045,41,523,2
0X5606683C2B5E4E3C.avi,1209,121,1885,105,676,2
0X56099E849EE89786.avi,1402,74,2334,49,932,2
0X560AC3ED5C9AA949.avi,2029,72,2598,55,569,2
0X560DCF7EA12DC533.avi,896,131,1425,118,529,2
0X560F4FD09C718326.avi,1160,114,1929,97,769,2
0X561479A7A64AF873.avi,831,115,1404,100,573,2
0X5617906D2ADFA252.avi,1153,19,1577,2,424,2
0X56196FF1812E8C2.avi,1353,138,2634,115,1281,2
0X561B0F7DC084235B.avi,1278,115,1789,104,511,2
0X561B176101B8763D.avi,1459,126,2351,113,892,2
0X561EA6D2BA7109CC.avi,1163,29,1879,2,716,2
0X562104499AF7434C.avi,1001,63,1379,45,378,2
0X5623423CD11DB981.avi,1049,61,1439,38,390,2
0X5628BF37F914D9D3.avi,1994,60,3142,36,1148,2
0X562D7CFA5BAE1A69.avi,1150,146,1698,131,548,2
0X562DD4BDA72895C5.avi,1160,19,1824,2,664,2
0X562F92891AEF1368.avi,2203,52,3686,38,1483,2
0X5634E7D1A1EF62FE.avi,1163,92,1765,78,602,2
0X5637911EE0FA79F3.avi,986,67,1479,51,493,2
0X563A4DE533398A77.avi,1898,23,3229,0,1331,2
0X563EE078BB4DBE66.avi,848,39,1304,50,456,2
0X56477376D54B5518.avi,1158,82,1860,67,702,2
0X564851F58C08D3CF.avi,1084,247,1704,230,620,2
0X5648DF28AE0A879F.avi,696,194,1094,178,398,2
0X56497E5A81DB483A.avi,1542,68,2319,53,777,2
0X564B7112D21AC297.avi,2235,68,2701,49,466,2
0X564D07499141655.avi,1333,67,1956,49,623,2
0X564F15765F05A7ED.avi,1680,45,1970,32,290,2
0X565CB99FA2247353.avi,1134,110,1801,91,667,2
0X566073CD81D42C71.avi,1270,105,1711,91,441,2
0X566816B89E817417.avi,1583,94,2573,76,990,2
0X566B56DBD9C76630.avi,1547,75,2245,51,698,2
0X566BCD122F004DBB.avi,761,117,1245,98,484,2
0X56708560343E424C.avi,1101,18,1793,2,692,2
0X56744939961E376C.avi,860,22,1304,5,444,2
0X56772AFC64BB2E21.avi,2721,47,2859,33,138,2
0X5678F14272EC915.avi,1585,86,1845,72,260,2
0X56797D174D34659A.avi,1955,140,2382,113,427,2
0X567AE5FEFC5CE4C6.avi,1741,128,2727,113,986,2
0X567C02D701B3C187.avi,1775,108,3214,94,1439,2
0X568003EF393E748E.avi,794,146,1393,125,599,2
0X5680EEA4E51CBF5E.avi,1043,19,1441,4,398,2
0X568183EB03D60A5E.avi,1480,86,2192,70,712,2
0X5681A0EC29CEDAFB.avi,1635,118,2604,104,969,2
0X5682461951253D12.avi,1032,107,1685,88,653,2
0X56832722695AD390.avi,1163,118,1984,103,821,2
0X56874CBB4CCD7382.avi,1613,137,2476,119,863,2
0X568C885819B16C0A.avi,1949,231,2325,211,376,2
0X568CB22448662BDC.avi,1120,19,1677,2,557,2
0X569083868ADC8519.avi,1119,110,1974,95,855,2
0X5694870433CABB5.avi,1229,16,2089,1,860,2
0X5699359D37175033.avi,1119,54,1595,40,476,2
0X569C32CA446F75CB.avi,1352,76,2194,54,842,2
0X569DEFF95A8A059F.avi,936,60,1605,43,669,2
0X56A3F4651716DAFF.avi,1197,52,1647,38,450,2
0X56AA2BDAB8C1F14F.avi,769,56,1151,45,382,2
0X56AEDD98E8E5A043.avi,816,141,1285,126,469,2
0X56AF18E9AFAC458.avi,1028,80,1361,67,333,2
0X56B33CBB233A00B9.avi,1066,66,1754,48,688,2
0X56B7224CF1210326.avi,749,88,1192,77,443,2
0X56B7729C43515690.avi,935,76,1416,61,481,2
0X56B7B0747C33B23A.avi,863,118,1295,97,432,2
0X56B9E97A265B9F6C.avi,1255,69,1948,51,693,2
0X56BAEFC36506EC74.avi,1067,99,1612,84,545,2
0X56BDAF0A20E92CF1.avi,1249,21,2097,2,848,2
0X56C0487D888C3C2E.avi,1385,55,1978,39,593,2
0X56C28776175F8548.avi,1389,173,2473,156,1084,2
0X56C97E9D6660C8B7.avi,755,106,1452,88,697,2
0X56D0F1AB970BFE4D.avi,1232,48,1966,35,734,2
0X56D7623C833287F2.avi,1155,119,1525,95,370,2
0X56D95E6BBB21D5B4.avi,657,21,1075,3,418,2
0X56E3DF133F5CF751.avi,851,20,1260,3,409,2
0X56E7A49CF36EA5F9.avi,1328,127,1943,114,615,2
0X56ECC2667F530B1.avi,939,135,1378,115,439,2
0X56F50AAB96844031.avi,1344,42,1731,30,387,2
0X56F9344331EA3B8.avi,997,81,1546,68,549,2
0X56FC2793F196F52C.avi,801,89,1195,74,394,2
0X56FC615935BD61AD.avi,1165,58,1832,45,667,2
0X56FD0409BFA202DF.avi,2485,64,3625,45,1140,2
0X570169A62E38E453.avi,974,48,1084,36,110,2
0X57049D79D2223947.avi,2490,88,3094,70,604,2
0X57068FCB2941B2B0.avi,1039,59,1702,48,663,2
0X5709B89606570BB5.avi,868,92,1453,75,585,2
0X570CF669C75084DE.avi,779,63,1337,49,558,2
0X57115FCDFC17AD13.avi,1172,88,1863,69,691,2
0X5711E76EE9E6D05C.avi,1528,108,2148,92,620,2
0X571A188810080076.avi,2005,80,2448,66,443,2
0X571FD5A3DF89F23E.avi,1755,58,2862,41,1107,2
0X572499FB5E263E98.avi,2714,164,3336,145,622,2
0X57294851359B9F2C.avi,1206,118,1664,94,458,2
0X572AEF5D9FB71D5E.avi,1181,105,2069,91,888,2
0X5732F683C370572F.avi,1076,58,1794,42,718,2
0X5737214D87C3C6A2.avi,855,58,1463,42,608,2
0X5737FD30335E04B2.avi,588,76,892,65,304,2
0X5739E698E8CF82B8.avi,1693,15,2394,32,701,2
0X573ACEFCBEEEBDB1.avi,1171,105,1916,90,745,2
0X5740370BFDBCB8C0.avi,1084,95,1773,83,689,2
0X57418E2E81370788.avi,909,108,1313,89,404,2
0X5746FD1045390A93.avi,1370,82,2146,69,776,2
0X5747C22B0A383B17.avi,1178,90,1846,71,668,2
0X574915FE8F47DA9D.avi,1338,44,1517,30,179,2
0X57496C7B6FB532F3.avi,1086,110,1713,94,627,2
0X575385417D2251F3.avi,904,109,1442,92,538,2
0X575A1E4C8C441849.avi,1184,87,1497,71,313,2
0X57614735C29E7850.avi,1022,57,1770,48,748,2
0X57638EDBA6862410.avi,1556,148,2329,131,773,2
0X5763B13F5E834682.avi,1838,103,2829,90,991,2
0X576CE75DB92A2833.avi,3275,75,3892,47,617,2
0X5770BC86E23F64A1.avi,1732,151,2929,129,1197,2
0X577895B05C084B1C.avi,907,72,1764,60,857,2
0X5782DC934099FAF7.avi,717,67,1088,45,371,2
0X5789708D8B711CE9.avi,2759,136,5036,60,2277,2
0X5789D0955145506E.avi,795,13,1185,4,390,2
0X578A64C447B18198.avi,1550,46,1871,29,321,2
0X578CD55FD7FA1FBC.avi,918,86,1405,69,487,2
0X579545295C91E0C9.avi,767,105,1334,84,567,2
0X57967E99CD78E8DD.avi,1716,67,2326,42,610,2
0X57998A179A216872.avi,1257,139,1925,124,668,2
0X579AA4481F4C4811.avi,1713,68,2750,48,1037,2
0X57A074E488CFB7AC.avi,1497,146,2095,124,598,2
0X57AD6F3761E27928.avi,699,72,1178,55,479,2
0X57ADA497F0EBEDF1.avi,1488,67,1809,51,321,2
0X57AF243EC526F96B.avi,1696,142,2411,128,715,2
0X57AF4D24B154C573.avi,4525,1,4931,15,406,2
0X57B106FE43F61E7F.avi,911,142,1415,126,504,2
0X57B2E99ECD4B98E1.avi,950,86,1458,71,508,2
0X57B3CE32DFE7E331.avi,999,195,1382,173,383,2
0X57B578504088002B.avi,1150,72,1965,57,815,2
0X57BBFCDCFCC7C65B.avi,772,60,1338,42,566,2
0X57C2A3A02FE8B21.avi,838,60,1446,44,608,2
0X57C34323F2863D98.avi,930,64,1582,48,652,2
0X57C52904B0175D71.avi,1623,139,2577,111,954,2
0X57C86935475E8DA1.avi,1190,50,1940,38,750,2
0X57CAE0E977EF3D47.avi,578,122,997,110,419,2
0X57D305C314C9E75B.avi,915,50,1362,36,447,2
0X57D44A1928229F95.avi,1083,75,1691,54,608,2
0X57D45309B5983032.avi,1233,61,1937,46,704,2
0X57D463CDA795B9E4.avi,1131,120,1456,109,325,2
0X57DC82A70105D85E.avi,1530,71,2112,53,582,2
0X57E2E5B50B2F0E9F.avi,1224,75,1926,59,702,2
0X57E5F01C8FBC44B2.avi,1317,55,1620,50,303,2
0X57E623AB38FB2122.avi,779,38,1030,25,251,2
0X57E6ED6156AD179.avi,1022,71,1656,52,634,2
0X57EE8E6B8C4E7F5.avi,1029,49,1601,35,572,2
0X57F0C4F8C24F34EA.avi,1076,15,1679,0,603,2
0X57FB35BD11EF937D.avi,1277,136,1717,114,440,2
0X57FE3361D451C871.avi,1294,129,2247,140,953,2
0X5806E874A6A5F13D.avi,995,686,1640,664,645,2
0X5807A3E41076EE92.avi,1165,64,1882,52,717,2
0X580C785A54010D31.avi,998,113,1593,100,595,2
0X580CEE48A5CB3F78.avi,852,114,1374,100,522,2
0X580E9EB1627EA2EC.avi,867,91,1345,78,478,2
0X5814C1D501200DBC.avi,923,63,1252,44,329,2
0X5816941DEDFD5EF8.avi,1977,68,2815,51,838,2
0X581C466FF21EA655.avi,933,138,1359,121,426,2
0X58234EC2ACE425BC.avi,641,36,785,26,144,2
0X582705BA9DF60331.avi,1105,13,1908,0,803,2
0X582990A8C81BACB0.avi,1156,16,2029,0,873,2
0X58328E6D19296808.avi,1733,118,2039,108,306,2
0X58338E94EAA6EFCE.avi,1013,77,1548,67,535,2
0X5834018E4FD4FBEA.avi,1702,80,2495,56,793,2
0X58344E9C7BAF1EFC.avi,896,60,1552,47,656,2
0X58381B534004F33A.avi,1213,57,1888,40,675,2
0X583C05A8EFEF7992.avi,1133,49,1786,36,653,2
0X583DA07459933891.avi,1745,143,2413,125,668,2
0X5843363A84693349.avi,965,87,1415,68,450,2
0X584739FD0DD86A50.avi,1052,15,1628,2,576,2
0X58476FD2C3A6A4D4.avi,940,116,1610,99,670,2
0X5849D369214E9D44.avi,926,52,1417,40,491,2
0X5862D7393B1702A1.avi,921,113,1424,96,503,2
0X5864696B49D8AEFA.avi,665,83,985,70,320,2
0X5864C38A349E78EB.avi,2708,51,2979,39,271,2
0X586512267FF12EFB.avi,1201,75,1915,54,714,2
0X58689D0656F5952E.avi,1314,110,2134,89,820,2
0X586F5B8D38894CA9.avi,2021,167,2362,149,341,2
0X5870E298D9583F01.avi,913,61,1413,43,500,2
0X58715681A919A46B.avi,1183,56,2022,41,839,2
0X5871F4CB38FCA3DD.avi,1262,67,1969,49,707,2
0X587790E0A7D9D232.avi,1434,66,2295,47,861,2
0X587BA6A4BB4E5419.avi,1090,67,1617,51,527,2
0X58839F3785AF3EA5.avi,973,97,1524,84,551,2
0X58871E2E411DF847.avi,892,47,1429,34,537,2
0X5888A01BFE3480D4.avi,2268,84,3670,69,1402,2
0X588B2DFAF08B8A55.avi,1452,79,1685,67,233,2
0X588C869314F5D067.avi,1503,10,2613,6,1110,2
0X588E162E5DD9DB03.avi,842,96,1436,79,594,2
0X588E3EACF2F064F3.avi,2383,74,3186,62,803,2
0X588FDBBA1B4732A1.avi,1486,148,2041,137,555,2
0X589473980BD8A982.avi,1008,57,1619,42,611,2
0X5896ABFE924AB523.avi,1244,64,1899,45,655,2
0X5898C1CFEA50CF3A.avi,1051,112,2003,94,952,2
0X5899680B2CF3DF20.avi,1460,150,2479,132,1019,2
0X589E6E8F092EF3D2.avi,857,95,1621,82,764,2
0X589ED00FEB9EA2CE.avi,1300,156,2260,139,960,2
0X58A4A57D6F79861D.avi,933,95,1451,84,518,2
0X58A857FB59CA0866.avi,1902,78,3165,62,1263,2
0X58B0DA957D4BC1EC.avi,1292,137,2346,120,1054,2
0X58B2C807C6950870.avi,1154,79,1446,64,292,2
0X58B3481E2ED23F3F.avi,1019,107,1489,91,470,2
0X58B97B8E78F555E5.avi,2472,170,2967,152,495,2
0X58C252BAD9120AAA.avi,1309,35,2269,4,960,2
0X58C8439D9869BF58.avi,961,60,1538,51,577,2
0X58C898AC23AFC561.avi,1031,57,1587,43,556,2
0X58C9A67666B969C2.avi,1942,53,3072,36,1130,2
0X58CB708D5F276CE1.avi,809,53,1295,35,486,2
0X58CC73CB241426DD.avi,1697,110,2075,94,378,2
0X58CC8340AFE517B.avi,1327,101,1963,91,636,2
0X58CEE9E828EEF7CB.avi,1554,74,2197,53,643,2
0X58D04EA94BD2181B.avi,1936,82,2665,66,729,2
0X58D3DFC9AE85338E.avi,1072,59,1660,45,588,2
0X58E0C4426D076B8B.avi,1133,94,1767,79,634,2
0X58E0D85ABA2FFF6E.avi,1443,42,1589,28,146,2
0X58E3A1FBB2C9A8D1.avi,1559,149,2770,116,1211,2
0X58E68FF5E366ADAD.avi,852,177,1411,158,559,2
0X58E8A4A0DB059360.avi,3492,60,3779,47,287,2
0X58E9941E544B4437.avi,1269,108,2082,90,813,2
0X58EA08A90D21496D.avi,1265,92,2155,68,890,2
0X58EA44DD398ACEDF.avi,1577,135,1836,116,259,2
0X58EBB19DD908A04.avi,1176,61,1982,45,806,2
0X58F1C5FCF1CDAB4D.avi,1304,109,1590,90,286,2
0X58F7EC389A5FA5AE.avi,900,65,1484,48,584,2
0X58F81331AC8DFB28.avi,909,61,1532,43,623,2
0X58F8B32F2F4BB1FC.avi,1066,84,1757,66,691,2
0X58FAA29103D77749.avi,1124,66,1891,48,767,2
0X58FABBD1452885A9.avi,987,101,1724,82,737,2
0X58FDB3BA0B623121.avi,718,61,1025,49,307,2
0X5906DC737114DBF1.avi,1204,62,1851,34,647,2
0X5909C0C23F72F79F.avi,1716,99,2966,83,1250,2
0X590E3EC2C55BE57D.avi,3287,72,3945,49,658,2
0X590E81D4160A19D3.avi,996,56,1314,44,318,2
0X5910AD8CFCEBCFBE.avi,1041,126,1470,100,429,2
0X591ECF81428086F5.avi,1362,65,1844,57,482,2
0X5921D38ED2B4AFD.avi,976,98,1471,80,495,2
0X59221E655A0BEB5F.avi,1145,86,2190,71,1045,2
0X5929F010F6E0B599.avi,2004,25,2698,3,694,2
0X592B7FFFAB37E75.avi,1060,56,1615,39,555,2
0X592BC78654B44045.avi,1562,96,2347,76,785,2
0X592D63DA4757CEFF.avi,1196,113,1572,96,376,2
0X592EF931C5408F76.avi,1403,92,2415,75,1012,2
0X592F2897A11F51ED.avi,813,120,1385,107,572,2
0X592F522398D46067.avi,792,60,1398,102,606,2
0X5932549C293D414.avi,628,53,988,36,360,2
0X5934A7755DBA992F.avi,1559,119,2439,101,880,2
0X59381CEC5E5E999E.avi,1456,47,2260,33,804,2
0X593E7BA6491DC8CC.avi,955,70,1439,50,484,2
0X5940511FDA9E382A.avi,2072,101,2928,84,856,2
0X594171E23BEE91B3.avi,1403,65,2085,46,682,2
0X5942BAEA791A0AB8.avi,1091,51,1599,36,508,2
0X5947CC66C2E5AB66.avi,765,113,1240,86,475,2
0X594EE4FCD0F9B2A7.avi,1499,176,2310,163,811,2
0X59526B3C70A1B54D.avi,998,87,1408,72,410,2
0X595745DC191C9400.avi,1137,65,1893,50,756,2
0X595A8E44AB630A80.avi,1171,77,1866,59,695,2
0X595CF8F19E1EC5C1.avi,2221,23,2685,3,464,2
0X595D5EB09B62A91C.avi,1099,129,1862,114,763,2
0X595ECA5F232566EE.avi,1126,62,1453,48,327,2
0X595F9CFE560DEF4A.avi,1014,68,1723,53,709,2
0X59671F285804943A.avi,1527,71,1582,89,55,2
0X596782EB29F20A7F.avi,1309,59,1959,43,650,2
0X5969A32C106156ED.avi,1151,48,1749,36,598,2
0X5969D01C13D8D7A8.avi,669,116,1080,99,411,2
0X596D82CEC244AD7B.avi,1250,14,1561,3,311,2
0X596F693EAFBE7717.avi,1295,74,2066,51,771,2
0X597141ABAB17D04A.avi,1498,59,2267,43,769,2
0X597330338F81277E.avi,2085,71,3047,53,962,2
0X5977A2AAB900A179.avi,1052,75,1615,60,563,2
0X5977AE444B36CEBF.avi,1049,43,1313,32,264,2
0X598838470DE81F43.avi,751,54,1326,39,575,2
0X598C59061017AD74.avi,848,72,1307,50,459,2
0X598CCC65250BED12.avi,1283,123,2101,105,818,2
0X5999F4973DBFB6D.avi,1423,76,1829,55,406,2
0X599C81E46591FA88.avi,828,114,1257,101,429,2
0X599DDBAEABB5B464.avi,534,62,965,45,431,2
0X59A016EB2FC57E32.avi,1210,62,1414,45,204,2
0X59A388EB10F25B7D.avi,1251,127,1907,109,656,2
0X59A575CBF3DC8109.avi,1726,125,2869,98,1143,2
0X59ADE18C22F4FF43.avi,1937,97,3086,80,1149,2
0X59AFDDD0D3C041FA.avi,1749,84,2530,65,781,2
0X59B142CE6B0B50C3.avi,876,57,1278,42,402,2
0X59B44F5607C628B1.avi,989,98,1824,83,835,2
0X59B507E8C14DA46B.avi,1543,54,1658,69,115,2
0X59B7069E192FA63B.avi,1078,54,1681,38,603,2
0X59BA9AE7BA8C825A.avi,1296,20,2003,4,707,2
0X59BB0313F22D6C09.avi,1129,24,1682,2,553,2
0X59C4CE70C4F55317.avi,1730,91,2819,76,1089,2
0X59CCE27D1E9CA779.avi,1472,73,2431,56,959,2
0X59CF66815205182B.avi,1191,171,1857,149,666,2
0X59D1140D8320A782.avi,2295,73,3243,56,948,2
0X59D547708F149EC7.avi,844,56,1468,38,624,2
0X59D5F41F45601E03.avi,1275,62,2561,17,1286,2
0X59D638BE286CF4A9.avi,1185,146,1759,127,574,2
0X59D7DC35A07FCCA8.avi,1375,16,2124,2,749,2
0X59D7E398048E854A.avi,922,20,1417,0,495,2
0X59DBBB5F624D0A21.avi,2420,64,3867,43,1447,2
0X59E3868FDA8BC941.avi,1281,112,2152,94,871,2
0X59E39FE1CBF2559F.avi,1400,66,1527,53,127,2
0X59E764F4C40CE1BC.avi,1062,66,1798,46,736,2
0X59E816BD4AEDF902.avi,1805,18,2580,2,775,2
0X59FA68B7EDBFE685.avi,3249,44,3599,29,350,2
0X59FB7CD1B07254FB.avi,1356,65,2172,47,816,2
0X59FBCBE4E44F7F6D.avi,2912,68,4705,52,1793,2
0X59FD3A9503414674.avi,887,44,1267,32,380,2
0X59FD42635ECD7331.avi,1307,117,2072,100,765,2
0X59FFBB1606082730.avi,968,67,1481,46,513,2
0X5A0136769BFA8729.avi,811,88,1315,80,504,2
0X5A02C1075DC56CD1.avi,1116,114,1772,96,656,2
0X5A043A25D7DE2119.avi,1629,83,2463,68,834,2
0X5A0750FDDF8BB7FD.avi,2308,137,2702,117,394,2
0X5A09A88B11AC098B.avi,900,70,1327,52,427,2
0X5A1414E405ADE260.avi,1472,147,2562,135,1090,2
0X5A25AAA2FE2A0137.avi,2303,87,2685,72,382,2
0X5A2A86B8340602FB.avi,888,90,1503,78,615,2
0X5A31A52541B52293.avi,915,15,1486,1,571,2
0X5A3377D9676EFB25.avi,1099,139,1692,119,593,2
0X5A36F3D64B1C022E.avi,874,20,1402,0,528,2
0X5A3CE5A17CF0E7F0.avi,1500,109,2104,91,604,2
0X5A3D0EB2779B5AE4.avi,1324,145,2175,119,851,2
0X5A3DD4EB5CEDEBC8.avi,1976,13,2167,4,191,2
0X5A3E12648EA593D7.avi,1006,20,1361,0,355,2
0X5A42AF943DBF7D48.avi,1124,142,1823,126,699,2
0X5A434CCEF78B3DF6.avi,624,47,990,32,366,2
0X5A47C55BDD6320C4.avi,1327,88,2250,73,923,2
0X5A49DD0806A586EC.avi,1070,161,1623,134,553,2
0X5A4BE58AF293D7E2.avi,2391,115,3822,98,1431,2
0X5A4E91B49647433.avi,1623,48,1916,32,293,2
0X5A4F73031A43B787.avi,1057,109,1930,96,873,2
0X5A50850240C956F4.avi,2123,115,2664,102,541,2
0X5A522E45FA4E6300.avi,2025,48,3418,35,1393,2
0X5A523C343EA4955C.avi,1552,48,1795,31,243,2
0X5A61E466361F893C.avi,984,18,1467,3,483,2
0X5A62768CE5183F05.avi,1644,158,2709,134,1065,2
0X5A63DFB4F51A3EF5.avi,1598,81,1878,67,280,2
0X5A71B9B8BA2DEF24.avi,909,105,1629,90,720,2
0X5A78C72546FA94FB.avi,1170,150,1892,133,722,2
0X5A790E6D24C6459C.avi,903,111,1482,91,579,2
0X5A79CEB906F6DDC0.avi,1084,102,1723,87,639,2
0X5A7C0A6808352598.avi,976,96,1517,74,541,2
0X5A7DCFE785461CBF.avi,1373,65,2177,45,804,2
0X5A81E9B6120301C2.avi,1106,149,1782,125,676,2
0X5A829DEE7FF13297.avi,1145,122,1909,107,764,2
0X5A862160D0762048.avi,1459,190,2184,159,725,2
0X5A87B593E38B6180.avi,1284,57,1878,41,594,2
0X5A887EDA76C326E9.avi,2144,99,2787,86,643,2
0X5A8D9673920F03FE.avi,1497,96,1705,87,208,2
0X5A8DC9E4EC4968C4.avi,1206,60,1855,46,649,2
0X5A8FDE1B4DFD812B.avi,1426,65,2089,45,663,2
0X5A93E061159C9378.avi,1397,12,1881,3,484,2
0X5A950A068EC29DF3.avi,894,15,1329,3,435,2
0X5A9796CCDA84D81B.avi,1212,185,1817,172,605,2
0X5A97B991A66ED479.avi,1485,94,2447,78,962,2
0X5A98767A8CA9C6E5.avi,1097,65,1716,48,619,2
0X5A991DDFE6209331.avi,971,130,1587,116,616,2
0X5A9D91F5E3591C4.avi,858,59,1329,43,471,2
0X5A9E8753F82B2C2.avi,1123,168,1719,157,596,2
0X5AA07A9EDFA136A4.avi,1370,57,2404,41,1034,2
0X5AA42E877A34343C.avi,1288,26,2068,3,780,2
0X5AA8BA5FDF19DE00.avi,1809,67,3300,51,1491,2
0X5AB0A4C9879E8122.avi,2604,141,3021,128,417,2
0X5AB4C1E0766C1301.avi,1256,67,1849,50,593,2
0X5AB4D8B4AAD49E4B.avi,895,59,1358,34,463,2
0X5ABA2E2F22CE770A.avi,1224,60,1666,43,442,2
0X5ABA71A482529148.avi,1548,72,1928,57,380,2
0X5AC51281F3F82853.avi,1212,127,1933,105,721,2
0X5AC82E1FBDF09C04.avi,1447,162,2139,139,692,2
0X5ACD4D6566521DE1.avi,1348,125,2007,107,659,2
0X5AD891D9DF126FE9.avi,2349,62,3247,45,898,2
0X5ADDDD65BF05427C.avi,1180,74,1899,54,719,2
0X5AE30E7828920A82.avi,1626,84,1927,64,301,2
0X5AE4C29227F096C1.avi,1362,74,1879,60,517,2
0X5AE597D0E98182FD.avi,1215,102,1980,83,765,2
0X5AEBAD574707A7D8.avi,1238,66,2141,46,903,2
0X5AED88B8F471EBF2.avi,2335,59,2694,42,359,2
0X5AF5A14F2D47FB44.avi,1078,55,1596,42,518,2
0X5AF5F4D6A5009696.avi,1905,103,2460,85,555,2
0X5AFC100934885C21.avi,1443,76,2613,51,1170,2
0X5AFD38843B50FE00.avi,1446,128,2592,112,1146,2
0X5B01B459045231D8.avi,1073,73,1606,51,533,2
0X5B0675C0754E2C41.avi,769,50,1424,35,655,2
0X5B0DAEFE452D4F2E.avi,943,57,1587,38,644,2
0X5B0E31F05985CD68.avi,1843,29,2257,3,414,2
0X5B0FF6323B769A36.avi,1338,19,1641,0,303,2
0X5B10B8EF336047D5.avi,2851,64,3301,48,450,2
0X5B11C88A9BEA16A1.avi,1650,80,2842,66,1192,2
0X5B1A54EA0582FEB.avi,966,125,1693,111,727,2
0X5B1AF37FB6799661.avi,1529,73,2527,45,998,2
0X5B2165383F6FB790.avi,1471,90,1786,75,315,2
0X5B239BAF568E5D96.avi,1403,110,2079,93,676,2
0X5B272B9FE759F096.avi,1170,59,1826,40,656,2
0X5B281D3A9CC32337.avi,912,77,1474,55,562,2
0X5B2C3BAF98374B17.avi,1461,130,2343,110,882,2
0X5B2ED564F5F520B8.avi,1951,94,2953,80,1002,2
0X5B437B04F1B9248F.avi,647,66,1173,53,526,2
0X5B486FEDFEF43494.avi,711,66,1150,47,439,2
0X5B4D0D38F575846D.avi,1925,8,2441,22,516,2
0X5B4FC85CF6045C88.avi,1488,119,2629,103,1141,2
0X5B55C81391366432.avi,1680,165,2519,147,839,2
0X5B597AB91860C164.avi,804,62,1395,49,591,2
0X5B5A271E756F4794.avi,1104,74,1797,53,693,2
0X5B5C0F6F8005A4BB.avi,1199,144,1895,126,696,2
0X5B5C6BF6542C213C.avi,820,63,1435,53,615,2
0X5B65F2E4BE4274FB.avi,1107,62,1956,43,849,2
0X5B669448D3486974.avi,844,70,1301,52,457,2
0X5B6FCBB75BF8FCB7.avi,2663,69,3431,84,768,2
0X5B72422497E29451.avi,965,16,1502,1,537,2
0X5B7385C417F7F182.avi,1321,52,2084,37,763,2
0X5B7855A063C00985.avi,1703,53,2708,36,1005,2
0X5B787E051A2A714F.avi,877,107,1438,90,561,2
0X5B7B5EF7F3E283B2.avi,1024,57,1545,44,521,2
0X5B7DCEC4D8C1E6BB.avi,1942,60,2443,43,501,2
0X5B82F3AB4A965E2B.avi,1592,113,1880,94,288,2
0X5B8551F76C584EE5.avi,2518,111,2954,92,436,2
0X5B88342AB24EEE40.avi,1370,61,2211,45,841,2
0X5B8C506AC0A3CB4B.avi,985,29,1588,2,603,2
0X5B942F1EA8824606.avi,1942,18,2666,44,724,2
0X5B9B6E6A33D4BF36.avi,2463,74,2881,46,418,2
0X5B9C0EEB93E0BE10.avi,1181,66,1883,46,702,2
0X5BA0316D390284D6.avi,905,56,1592,44,687,2
0X5BA13657704CDD76.avi,974,60,1740,44,766,2
0X5BA6C5333369EBF9.avi,1079,11,1745,0,666,2
0X5BAA2D1ACBA618B9.avi,2474,75,3062,61,588,2
0X5BAA60FB400B73A6.avi,1019,55,1698,41,679,2
0X5BAB6F2DF148AB55.avi,1239,50,1325,36,86,2
0X5BAC4129957FC22A.avi,2085,128,2883,108,798,2
0X5BAD1B2D17E1169E.avi,1675,61,1857,37,182,2
0X5BB0F7EC8D6E54C0.avi,795,57,1510,43,715,2
0X5BB1D4B303FB2548.avi,1168,70,1573,57,405,2
0X5BB42E2E63912CA9.avi,1414,122,2234,99,820,2
0X5BB5950E48DCABA2.avi,903,43,1204,30,301,2
0X5BB7CFFD105A3FAE.avi,1398,76,2251,56,853,2
0X5BBA205CF1389388.avi,1133,114,1758,84,625,2
0X5BBB947BE9B5CD3E.avi,1703,40,2778,27,1075,2
0X5BBDD38A52132F51.avi,807,82,1287,61,480,2
0X5BC084DE4595DDA9.avi,1083,96,1401,83,318,2
0X5BC4CD6E32784809.avi,1267,69,2018,51,751,2
0X5BC7BE982A4B59D0.avi,976,81,1437,66,461,2
0X5BCCA6A21A48BA1C.avi,1546,69,2578,52,1032,2
0X5BCD54C82F8D582D.avi,1653,108,2447,90,794,2
0X5BCFC1AB74430ADC.avi,2383,67,3813,53,1430,2
0X5BD28538796B42E1.avi,1359,56,2280,42,921,2
0X5BDB93DFF509755C.avi,1101,114,1791,100,690,2
0X5BDE274D50326F51.avi,998,86,1109,70,111,2
0X5BE1EB81D547BB00.avi,1796,56,2866,41,1070,2
0X5BE6B8A080E4AAF3.avi,1111,121,1792,105,681,2
0X5BED87AA6A6DE3C.avi,1123,55,1805,42,682,2
0X5BEFB1201A511970.avi,716,44,1137,31,421,2
0X5BF53B5D9E37CF85.avi,1306,138,2345,118,1039,2
0X5BFC2EC0D445EA65.avi,1652,66,1974,57,322,2
0X5BFC4BEBE8BF82CC.avi,1006,42,1501,30,495,2
0X5BFDF06DBFF53A0A.avi,2360,90,3151,71,791,2
0X5C00619340A86EAA.avi,3690,67,4090,46,400,2
0X5C006EA7B061D14E.avi,1547,74,2573,54,1026,2
0X5C04297CE92F9474.avi,1633,44,1867,32,234,2
0X5C0458BF2E4CF6C7.avi,863,25,1379,3,516,2
0X5C05336F5F0ABF6F.avi,1187,104,1820,87,633,2
0X5C0622310D51F2EA.avi,1135,49,1618,34,483,2
0X5C07652BAE8C7302.avi,1048,85,1579,74,531,2
0X5C0BCAA2FB4FF1B4.avi,955,118,1202,98,247,2
0X5C0D8A8607A0BCD8.avi,1331,80,2118,64,787,2
0X5C0E4F3C27ED9B85.avi,1339,54,1947,36,608,2
0X5C0FD8B1175151FA.avi,1920,59,2738,43,818,2
0X5C103167BD77DE9C.avi,1066,152,1562,133,496,2
0X5C12941016554219.avi,907,56,1379,43,472,2
0X5C13832F252936F7.avi,1374,203,2468,165,1094,2
0X5C1E8311A4AA5E96.avi,2382,71,3390,50,1008,2
0X5C2093C65B92C741.avi,896,164,1462,145,566,2
0X5C20947D2D3C0638.avi,1176,102,1808,85,632,2
0X5C253FDBCD0E300A.avi,969,100,1608,82,639,2
0X5C26378213CC3D5E.avi,963,61,1481,52,518,2
0X5C27FE43EBDF4484.avi,923,20,1542,1,619,2
0X5C2959CAADE171C9.avi,903,66,1411,47,508,2
0X5C3401A02A219AB6.avi,1362,65,1916,50,554,2
0X5C363EB9E7B8D2D7.avi,961,66,1654,49,693,2
0X5C36C47474E66354.avi,1138,84,1679,75,541,2
0X5C3B081C1D5BC264.avi,870,59,1447,44,577,2
0X5C3E19EC804AB89A.avi,836,122,1397,106,561,2
0X5C41AF3F25757D5B.avi,638,46,1128,32,490,2
0X5C433F9E3BA1E2DF.avi,1084,36,1675,25,591,2
0X5C43DB9C3DA8C861.avi,1890,130,3026,111,1136,2
0X5C48A57102118A57.avi,664,51,1092,38,428,2
0X5C4DAA1DF7F8CA25.avi,866,130,1451,112,585,2
0X5C53EA56AC3783CF.avi,1108,49,2093,35,985,2
0X5C55673175514E32.avi,3603,115,4169,98,566,2
0X5C565C7D7CF4A489.avi,1221,74,2056,59,835,2
0X5C58323A222761B2.avi,1777,139,2476,121,699,2
0X5C5B9906DC0D9057.avi,1396,110,2221,98,825,2
0X5C5F3F8BD96C3437.avi,949,59,1650,45,701,2
0X5C6E9BA3AC1B4ECB.avi,1455,55,1896,43,441,2
0X5C70DA5DA096EBF8.avi,1169,140,1776,121,607,2
0X5C72AD9624A40A3A.avi,1759,83,2859,61,1100,2
0X5C732BCF53162A65.avi,930,65,2224,66,1294,2
0X5C753484DB492ACA.avi,859,123,1422,112,563,2
0X5C763FA1B573D7A8.avi,1919,104,2275,94,356,2
0X5C7B3A4A12245C5E.avi,1608,63,1957,48,349,2
0X5C7D9604189AB703.avi,974,72,1518,54,544,2
0X5C7F6275DDC3DB94.avi,830,92,1417,81,587,2
0X5C80C526C8437CF6.avi,807,73,1286,59,479,2
0X5C814528DCE46509.avi,2210,62,3401,44,1191,2
0X5C8171EDE5E95BCD.avi,1148,61,1692,48,544,2
0X5C81C3B8CCCE3B1D.avi,1242,121,1854,105,612,2
0X5C82DDEEA7B83F66.avi,1185,67,1869,49,684,2
0X5C85CE60422E8717.avi,989,32,1601,4,612,2
0X5C89E0348E49D500.avi,1757,105,2261,87,504,2
0X5C8E74E8A72B2CCE.avi,1517,126,2690,109,1173,2
0X5C8FBD78D13B887F.avi,1144,63,2017,46,873,2
0X5C92D4C03C058F68.avi,1284,71,2192,52,908,2
0X5C953D8682D4E34B.avi,587,71,845,42,258,2
0X5C98E42CEB827219.avi,1040,61,1774,49,734,2
0X5CA1BF7D104E3F20.avi,1270,97,2298,86,1028,2
0X5CA2B7ACC72E7089.avi,862,127,1522,114,660,2
0X5CA86377C2EDF210.avi,2394,99,2840,79,446,2
0X5CA9EC597BD1151A.avi,1150,13,1869,0,719,2
0X5CAA16702850040C.avi,1177,67,2004,45,827,2
0X5CAF9C965AB286BB.avi,1017,59,1284,43,267,2
0X5CAFBD8F2F8DC00B.avi,738,70,1213,51,475,2
0X5CB4E030D0C4F388.avi,1042,83,1418,65,376,2
0X5CB4FCCE5C545733.avi,1202,15,1882,0,680,2
0X5CB575476EC80F28.avi,1001,67,1459,48,458,2
0X5CB89319A7E13712.avi,836,80,1262,63,426,2
0X5CB89528DF79490D.avi,615,60,1001,39,386,2
0X5CBA5F10CE173C78.avi,1913,106,3117,90,1204,2
0X5CBCDC46C155136.avi,1807,77,2529,62,722,2
0X5CBF8B43EFDD7D6E.avi,1996,89,2222,73,226,2
0X5CC16B5FA6C18B06.avi,2109,105,3444,94,1335,2
0X5CC6EB5C62ABD303.avi,2072,118,3223,101,1151,2
0X5CC9462160833E16.avi,2065,103,3562,74,1497,2
0X5CCAAAD2D61ACFE9.avi,1353,83,2078,68,725,2
0X5CCC89BCE8721F66.avi,957,64,1480,46,523,2
0X5CCF81D7227F7671.avi,1119,152,1383,162,264,2
0X5CD36D24B82283A8.avi,1517,26,2429,2,912,2
0X5CD3BB239816DE46.avi,1229,20,2186,2,957,2
0X5CD9E4FC7E803411.avi,990,101,1514,86,524,2
0X5CDCA095B4FB6100.avi,662,58,1184,43,522,2
0X5CDFC7FFCE29EC42.avi,1334,63,1745,45,411,2
0X5CE06D8A08BD9C7.avi,1159,63,1803,48,644,2
0X5CE16B7E824B54DD.avi,1034,51,1620,39,586,2
0X5CE35FD20E949C11.avi,2658,113,3274,96,616,2
0X5CEAF8CCDF0F1DA1.avi,1117,191,1368,175,251,2
0X5CEFEEEA65D39669.avi,1130,106,1622,90,492,2
0X5CF840808AC3A51D.avi,1392,70,2223,52,831,2
0X5CFB1249B6E7AB45.avi,1260,69,1928,52,668,2
0X5CFB2DE05E52418E.avi,725,57,1183,50,458,2
0X5CFD1C355DE93894.avi,2301,82,2870,67,569,2
0X5D0DFD26F454D74C.avi,1084,59,1736,41,652,2
0X5D103E4500F4E03B.avi,705,135,1107,119,402,2
0X5D13B00A9C834084.avi,1276,58,1994,39,718,2
0X5D159B26B4AFC43B.avi,1057,50,1522,33,465,2
0X5D15F6BD0B9D5CE2.avi,1872,111,3103,96,1231,2
0X5D19F61D8DD2A327.avi,1019,95,1781,78,762,2
0X5D1C4DB993CBEB5F.avi,801,43,1454,31,653,2
0X5D20C54CD929741.avi,1543,13,2713,0,1170,2
0X5D278EA9617E43F0.avi,1163,59,1761,40,598,2
0X5D29CF199E85BCE7.avi,881,111,1440,96,559,2
0X5D2CD9603F554C22.avi,809,68,1263,49,454,2
0X5D2DE43B30BAE113.avi,2194,66,2542,42,348,2
0X5D2F019F366E4CB0.avi,1170,76,1770,60,600,2
0X5D2F7405A43DB64D.avi,1190,65,2006,48,816,2
0X5D38D994C2490EAE.avi,1391,90,1897,75,506,2
0X5D3A01DA317E6D4C.avi,927,95,1556,78,629,2
0X5D3A4E695699D345.avi,1936,84,2422,71,486,2
0X5D3BE1C6F1BDBF8.avi,1771,113,2099,100,328,2
0X5D3D9A1B411AC0B6.avi,1878,167,2878,147,1000,2
0X5D4384C94F609882.avi,910,55,1566,38,656,2
0X5D453767BD555153.avi,769,123,1253,103,484,2
0X5D46AD1CAA0CD528.avi,795,84,1292,69,497,2
0X5D4CE41A2D8F067B.avi,1030,97,1681,83,651,2
0X5D4D12B2C125581C.avi,1041,12,1864,0,823,2
0X5D502551D07D4DA4.avi,1176,108,1423,92,247,2
0X5D50280B44A63430.avi,869,90,1030,77,161,2
0X5D50BBB7B29F5ED1.avi,741,43,1156,23,415,2
0X5D52AB9A6C8549D8.avi,1696,67,3092,47,1396,2
0X5D5897D9D7262386.avi,1160,61,1490,49,330,2
0X5D5AAA4D4A5C945E.avi,1046,66,1736,48,690,2
0X5D5EA202B6453DBE.avi,1812,155,2492,140,680,2
0X5D653441BD69A02E.avi,934,50,1530,33,596,2
0X5D6A1608E132B62A.avi,1172,67,1754,53,582,2
0X5D6C0055AEA9214F.avi,1300,60,1509,41,209,2
0X5D78417E9211CC18.avi,1998,65,2595,46,597,2
0X5D7A013C97D80D53.avi,1049,95,1609,81,560,2
0X5D7B0639FC5F0680.avi,1537,119,2449,100,912,2
0X5D7CE3C255D509DE.avi,1123,121,1626,111,503,2
0X5D7DED9EE53AFE49.avi,2741,76,4351,56,1610,2
0X5D7FCA50F8853C9.avi,1196,59,2005,45,809,2
0X5D803519EA68C681.avi,931,53,1430,37,499,2
0X5D81397DB541670A.avi,1730,57,1887,40,157,2
0X5D8CC617E26B46EC.avi,1019,17,1575,1,556,2
0X5D8E881ECEE5F36.avi,1238,70,1950,55,712,2
0X5D923AF380EB455C.avi,961,83,1452,65,491,2
0X5D96B22626F0D2AA.avi,1586,170,2440,150,854,2
0X5D989C293C8C2CE4.avi,2199,68,3455,103,1256,2
0X5D98E2C64E1625FB.avi,1150,84,1329,69,179,2
0X5DA482A6C4BDC535.avi,930,115,1508,100,578,2
0X5DA69748408F8E20.avi,866,54,1308,38,442,2
0X5DA9D6661907E7F0.avi,1059,67,1648,60,589,2
0X5DAB2DA5F776DE78.avi,1461,84,2321,55,860,2
0X5DAB9FDE7CC700DE.avi,2106,70,2616,56,510,2
0X5DAE4DC1DC55BB33.avi,1572,60,2412,46,840,2
0X5DAF04808611BAAB.avi,961,95,1574,78,613,2
0X5DAFCBD9AF45FE1D.avi,875,69,1458,54,583,2
0X5DB386B94F7C4BC3.avi,896,56,1546,42,650,2
0X5DB7742B2778FD6B.avi,1162,18,1731,2,569,2
0X5DB7FAB9B9BE5D9.avi,1245,54,1994,47,749,2
0X5DB9102BCAA695A1.avi,861,92,1507,79,646,2
0X5DB9401060BD9D0F.avi,1046,53,1610,39,564,2
0X5DB9B61F813D5FF1.avi,851,102,1209,81,358,2
0X5DC35F53CE78C741.avi,1163,37,1680,19,517,2
0X5DC400C55208AB98.avi,1031,79,1760,59,729,2
0X5DC558E6A9C2553D.avi,759,84,1354,66,595,2
0X5DC624BE02E6CDD.avi,1669,73,2714,54,1045,2
0X5DC8E85D737912F.avi,1321,45,2030,34,709,2
0X5DCB0201908CB27F.avi,2213,46,2484,30,271,2
0X5DCD1D381ED8E90A.avi,1098,88,1878,72,780,2
0X5DCD6E7750BE586B.avi,1854,120,2145,103,291,2
0X5DCF5EFD375418D2.avi,946,42,1370,31,424,2
0X5DD48C49365DBB71.avi,1069,66,1657,43,588,2
0X5DD9F952024DE8FC.avi,1522,16,2151,3,629,2
0X5DDDBEF2B4D91CD.avi,1543,68,2836,49,1293,2
0X5DDE9E68BB099303.avi,901,84,1353,72,452,2
0X5DDF6E147ADCC6B9.avi,1780,60,2043,39,263,2
0X5DDFEF522CF8131D.avi,986,143,1632,131,646,2
0X5DE1109B617C307E.avi,978,82,1430,66,452,2
0X5DE49DD1812E0E53.avi,2102,64,3751,47,1649,2
0X5DE6B657F04A3198.avi,1272,60,2024,45,752,2
0X5DEFDC9DAEB29CB.avi,872,61,1272,43,400,2
0X5DEFFABA480E1940.avi,1766,109,2588,95,822,2
0X5DF0F473022D31E2.avi,2793,170,3113,141,320,2
0X5DF2E3C335BD20EF.avi,910,66,1492,54,582,2
0X5DFC0C66C150F577.avi,1933,104,2796,87,863,2
0X5E002446A11D8489.avi,4319,71,4612,53,293,2
0X5E02AABEBE0408C5.avi,771,56,1266,40,495,2
0X5E0B75A0ABEBCB7E.avi,1257,25,2145,2,888,2
0X5E0D3394311A3DB0.avi,953,60,1464,44,511,2
0X5E112030E47CF091.avi,962,81,1392,64,430,2
0X5E12E1A64B74534D.avi,1695,118,2679,103,984,2
0X5E153A9644D6CB3E.avi,877,108,1405,94,528,2
0X5E184CFF23C01654.avi,2656,102,4230,85,1574,2
0X5E1A399B461F9D65.avi,1226,120,1808,102,582,2
0X5E1F93C96092699.avi,910,75,1393,55,483,2
0X5E212B2953D6257B.avi,1336,52,1917,37,581,2
0X5E225B4AE218833F.avi,1395,44,1703,34,308,2
0X5E22DFA2350C4782.avi,2677,100,3021,85,344,2
0X5E2543F97CDE7232.avi,1383,78,1898,62,515,2
0X5E27995327EB7725.avi,1021,78,1690,62,669,2
0X5E287E9190871DF2.avi,806,57,1251,44,445,2
0X5E3007301B69283C.avi,911,125,1494,102,583,2
0X5E32371377E0CF89.avi,967,86,1398,72,431,2
0X5E35565A56DAF332.avi,1045,66,1529,46,484,2
0X5E356E0DF8F55453.avi,1172,112,1715,96,543,2
0X5E3788FE379B291B.avi,777,142,1234,123,457,2
0X5E3A1E160562B7E7.avi,849,58,1459,40,610,2
0X5E3F73AAD75ED4BD.avi,1447,119,2307,102,860,2
0X5E41CFB1FB15279D.avi,1062,47,1853,35,791,2
0X5E45BACF9768908A.avi,1113,85,1643,65,530,2
0X5E46D41281E1995A.avi,844,20,1176,2,332,2
0X5E48A21DE491A78F.avi,1542,56,2014,40,472,2
0X5E5177D22560685E.avi,1039,64,1547,48,508,2
0X5E5373431FA7A041.avi,1001,16,1557,0,556,2
0X5E53F477513487D6.avi,833,53,1352,40,519,2
0X5E546A0DDFF0EDA9.avi,1032,82,1551,64,519,2
0X5E5C9EB6814282D7.avi,1149,60,2012,43,863,2
0X5E606BF217DA216C.avi,1137,52,1775,37,638,2
0X5E641D68EBD62FAC.avi,847,62,1464,53,617,2
0X5E64AA2424074480.avi,868,63,1289,51,421,2
0X5E671D0F5230CA9D.avi,2312,47,3469,31,1157,2
0X5E6CB8D263F993B7.avi,1233,69,1977,49,744,2
0X5E6F87BD8985C7ED.avi,968,87,1489,76,521,2
0X5E712CB224C8FDD7.avi,1451,62,2295,51,844,2
0X5E741B2B92850F19.avi,1157,95,1626,76,469,2
0X5E76ADAC714DF9D7.avi,1134,64,1767,47,633,2
0X5E77118AF4084B39.avi,1067,120,1569,101,502,2
0X5E7924276F62CCE6.avi,975,77,1607,57,632,2
0X5E7A214EF0BCDF91.avi,1227,76,1817,56,590,2
0X5E7E76986E672026.avi,910,137,1264,127,354,2
0X5E82DDFBC25E755A.avi,832,63,1257,45,425,2
0X5E857A59AF8D3FC7.avi,998,65,1524,48,526,2
0X5E8AB2A9ABFE32DE.avi,1056,66,1257,54,201,2
0X5E9020A8FCA5DD1D.avi,1577,19,2782,0,1205,2
0X5E9392E23CEAD967.avi,1031,114,1836,106,805,2
0X5E94B6F10B6B4BAF.avi,1333,81,2093,64,760,2
0X5E9623EDC1B57949.avi,992,61,1540,36,548,2
0X5E98971829C12431.avi,1256,19,1928,2,672,2
0X5E9AEFC0BAF4C623.avi,841,53,1391,38,550,2
0X5E9CA0D95225A239.avi,1614,66,2215,46,601,2
0X5E9CCD59BD6EDE82.avi,1446,116,2231,93,785,2
0X5E9D8DC455446AF2.avi,1038,97,1716,79,678,2
0X5E9DE6D454196225.avi,722,68,1227,51,505,2
0X5E9E8AD35D333062.avi,1017,47,1472,32,455,2
0X5EA17A007042B63C.avi,1182,45,1668,25,486,2
0X5EA2B15862C3C731.avi,1388,92,2377,80,989,2
0X5EA9017E606880F2.avi,1390,54,2086,39,696,2
0X5EABE6E6129D65D6.avi,1082,48,1821,33,739,2
0X5EAEC188BED7D1C4.avi,1085,96,1678,83,593,2
0X5EB091B7ACE3715E.avi,1655,52,1930,34,275,2
0X5EB1538110DC1DD1.avi,1548,66,2645,46,1097,2
0X5EB2063FDB36FFEA.avi,1928,63,3074,44,1146,2
0X5EB9A4515645E82F.avi,1153,122,2006,104,853,2
0X5EBAF494862BBD3A.avi,862,111,1302,99,440,2
0X5EBEECA55C0C6874.avi,821,93,1334,83,513,2
0X5EBF4BEB0CB630A3.avi,1075,44,1804,31,729,2
0X5EC277F47019A41.avi,1038,68,1454,49,416,2
0X5EC2E237164BE880.avi,1036,65,1492,53,456,2
0X5EC4ED845000D86B.avi,1945,19,2806,2,861,2
0X5EC7168075AF1BA4.avi,1592,94,2174,77,582,2
0X5EC8EAD631405070.avi,748,52,1145,35,397,2
0X5ECD55B830580E47.avi,857,111,1486,95,629,2
0X5ECF73A4906CB2BB.avi,695,80,1171,65,476,2
0X5ED20CE22B61EEB.avi,3506,16,3941,0,435,2
0X5ED542F7582888B9.avi,1211,45,2229,33,1018,2
0X5ED71DED6F063F9D.avi,1443,37,1933,28,490,2
0X5ED7410527085C8A.avi,1185,42,1815,29,630,2
0X5ED7D8B4C5E04559.avi,1064,20,1754,0,690,2
0X5EDDEA1B2AB83813.avi,664,63,1011,47,347,2
0X5EDF35043B9394FB.avi,1329,50,2094,36,765,2
0X5EE2390AFEA958E7.avi,1599,113,2440,86,841,2
0X5EE2857858E0E31E.avi,1153,54,1882,36,729,2
0X5EE96AA34060E43F.avi,1934,171,2292,154,358,2
0X5EED7E17AC927985.avi,1821,127,2415,111,594,2
0X5EF3AA26F477E5F0.avi,946,84,1605,68,659,2
0X5EF5ECDC62D658E3.avi,1541,184,2448,167,907,2
0X5F0602402478B90A.avi,1528,118,2058,103,530,2
0X5F079E27A83C0B8.avi,1638,58,2353,41,715,2
0X5F0D24B258388D8A.avi,1127,16,1960,1,833,2
0X5F0E22A55AB2E76A.avi,1738,46,2566,35,828,2
0X5F1003C57B850AB3.avi,1282,101,1915,87,633,2
0X5F12F829DE9997AD.avi,996,16,1479,4,483,2
0X5F1EC9AD081BBF4B.avi,998,62,1572,45,574,2
0X5F1F624CC0B3FE23.avi,1221,64,1944,44,723,2
0X5F20AE1435A6B695.avi,992,13,1667,2,675,2
0X5F2D3F92EECFA8D5.avi,884,71,1492,55,608,2
0X5F2E4B2D0CB4142D.avi,761,58,1190,43,429,2
0X5F2ECBF007EA81FC.avi,1331,61,1855,41,524,2
0X5F32DC0F9F9F9792.avi,1560,93,2419,73,859,2
0X5F34377891ED32EA.avi,1476,83,2242,71,766,2
0X5F353F8436745263.avi,1201,79,1941,58,740,2
0X5F39CB85ADCAA00A.avi,744,111,1226,93,482,2
0X5F39D3F256239FE7.avi,1153,86,1811,69,658,2
0X5F39F03B6B113B95.avi,1065,106,1792,88,727,2
0X5F3B72BA85B714EA.avi,1117,181,1878,159,761,2
0X5F3D04F591FED07C.avi,1083,61,1692,44,609,2
0X5F3F5EAB6FBC7672.avi,1740,80,2672,61,932,2
0X5F40FC2C2367EA92.avi,1784,19,2877,0,1093,2
0X5F4167C2888CCA6E.avi,1690,59,2266,44,576,2
0X5F41E6D608B38A9.avi,939,49,1675,35,736,2
0X5F42C272ABD66AE4.avi,1462,106,2004,86,542,2
0X5F4816B7130382CE.avi,1617,145,2568,127,951,2
0X5F48AC99F9E2CD25.avi,954,53,1623,39,669,2
0X5F4A6C5D0B52CB1D.avi,1026,48,1362,32,336,2
0X5F4B5FB16CE96C06.avi,1509,99,2436,90,927,2
0X5F4C295A8969E33F.avi,1236,18,1744,0,508,2
0X5F531849D180DED2.avi,1117,93,1909,77,792,2
0X5F5640713F873F54.avi,949,55,1591,39,642,2
0X5F5765C5B693F91D.avi,1103,49,1824,35,721,2
0X5F590C7F893948D1.avi,1237,124,1923,110,686,2
0X5F592AA5BA91F733.avi,1514,65,2580,51,1066,2
0X5F599F607D804C81.avi,1441,98,2269,81,828,2
0X5F5B9F5A80414884.avi,2143,57,3175,42,1032,2
0X5F5C118F20590038.avi,1176,27,2056,0,880,2
0X5F5C26021613D05C.avi,1384,99,2290,81,906,2
0X5F5E8594B9028EFE.avi,1043,79,1742,59,699,2
0X5F60579417AF2B21.avi,1695,79,1890,69,195,2
0X5F6521B0A37F45B0.avi,1528,92,2600,76,1072,2
0X5F69BF2FA33746C8.avi,786,67,1207,50,421,2
0X5F6DFF1FFF8D2BFE.avi,840,51,1401,32,561,2
0X5F6F8D308353F7CE.avi,1267,78,1793,60,526,2
0X5F72A5975CB4B31E.avi,1141,93,2014,73,873,2
0X5F79069BED47E4C6.avi,1101,134,1522,119,421,2
0X5F7A3F7ECEF71001.avi,1422,68,1881,52,459,2
0X5F7AB9B7BAD4A939.avi,794,60,1289,45,495,2
0X5F7F7043D608F24B.avi,1701,97,2553,81,852,2
0X5F82B5955E52718.avi,1075,117,1466,103,391,2
0X5F8388DE6166AD27.avi,1019,26,1653,1,634,2
0X5F8AF2961E9475B3.avi,1039,53,1587,36,548,2
0X5F8C726D21FDA787.avi,1226,59,2070,39,844,2
0X5F8FAC42E57B94CD.avi,705,94,1097,74,392,2
0X5F904F6B8EF34899.avi,1095,63,1423,48,328,2
0X5F905B70EFA3CB8F.avi,1718,99,2822,82,1104,2
0X5F91AE0375EB306B.avi,1334,64,2267,48,933,2
0X5F9248C06FAC691F.avi,1239,77,1766,61,527,2
0X5F92648A23C26089.avi,1162,47,1712,32,550,2
0X5F92B35F19F2778C.avi,1142,21,2030,1,888,2
0X5F9A892A7F5222F4.avi,859,148,1427,133,568,2
0X5F9B39788332C852.avi,783,160,1240,153,457,2
0X5F9DA73AAF7E7428.avi,1497,48,1755,37,258,2
0X5F9E72417A7A94D9.avi,1141,93,1882,70,741,2
0X5FA0D09981EB84F1.avi,1439,110,2264,94,825,2
0X5FA3A479D0505A61.avi,1255,55,1619,39,364,2
0X5FA790083ACE0F7F.avi,1181,171,1561,152,380,2
0X5FAFD4377E381228.avi,832,14,1377,3,545,2
0X5FB48001BCDB3E0.avi,994,60,1573,44,579,2
0X5FB52EE24AD4E07C.avi,2564,65,2925,48,361,2
0X5FBA39712E8BCEA6.avi,1290,16,2172,2,882,2
0X5FBBC76F7AD9FB4D.avi,1503,92,2607,75,1104,2
0X5FBC73FCF4098545.avi,1146,148,1923,130,777,2
0X5FBE580FA447E32F.avi,733,70,1167,50,434,2
0X5FBF7F1AFD7D17DE.avi,1074,161,1834,153,760,2
0X5FC40E07B2195664.avi,1591,19,2243,2,652,2
0X5FC7EA9FAD9F2429.avi,874,88,1184,72,310,2
0X5FC9BFA75DBC770F.avi,2071,141,2868,125,797,2
0X5FCC240D997BA3BC.avi,678,71,1112,58,434,2
0X5FCD756AC42FC6.avi,1325,104,2090,81,765,2
0X5FCE4BD2E5E26851.avi,1677,137,1805,125,128,2
0X5FCFF589A81B4B5E.avi,1618,18,2209,0,591,2
0X5FD2001CD8BCA24A.avi,1342,107,2114,93,772,2
0X5FD48AFE4017BCC.avi,1730,73,2867,35,1137,2
0X5FD68F47AE2AA638.avi,1253,134,1992,115,739,2
0X5FD81C7210683832.avi,726,73,1029,60,303,2
0X5FD94B2F57CB25FB.avi,1059,125,1951,107,892,2
0X5FDA14C54E57DB3E.avi,1222,120,1555,104,333,2
0X5FDC113292CB6B3C.avi,861,54,1265,40,404,2
0X5FDCAAC518A41715.avi,1623,63,2517,47,894,2
0X5FE2CC293BF88CCD.avi,1581,71,1921,60,340,2
0X5FE3EB348D80C6BE.avi,1326,92,2121,72,795,2
0X5FE4D902A22D3041.avi,1543,72,2814,56,1271,2
0X5FE6439A0CCEF482.avi,2151,30,2369,3,218,2
0X5FE8732DE9D96FD5.avi,2036,126,2791,112,755,2
0X5FEDCE3F39D06328.avi,1029,117,1619,101,590,2
0X5FF1487741A82553.avi,865,38,1551,27,686,2
0X5FF75E97ECDC71E8.avi,866,76,1355,64,489,2
0X5FF8D238E3A43BA9.avi,2571,106,2855,84,284,2
0X5FFEB2AD9B3A5E25.avi,871,100,1560,85,689,2
0X6000435AE572F06C.avi,1252,71,1824,55,572,2
0X60028DC7A7F31CE3.avi,791,56,1243,41,452,2
0X6004FEA607F2EB9C.avi,791,146,1202,135,411,2
0X6008D258A5B5E73.avi,2044,77,3255,55,1211,2
0X600BBB200766F979.avi,989,70,1518,50,529,2
0X600FA3ECBB488EAC.avi,1006,60,1569,43,563,2
0X60121B222FC4B4C4.avi,1167,160,1793,141,626,2
0X601A0FE2BA2F9F68.avi,1384,62,1702,45,318,2
0X601B706CC84025BD.avi,1596,88,2218,68,622,2
0X602005216EB0FAB3.avi,1098,20,1817,3,719,2
0X6020D0C5C256684D.avi,948,58,1447,43,499,2
0X602148BCD6E57281.avi,1039,219,1489,204,450,2
0X6022F9F42D2E8E06.avi,1168,104,2007,82,839,2
0X60232C8C3F8E33D5.avi,1492,15,2633,2,1141,2
0X602624BAE73DF1D0.avi,1034,128,1625,116,591,2
0X6029ADEDDBD5A8E7.avi,940,12,1517,0,577,2
0X602B5FA15C1B1391.avi,1712,93,2528,68,816,2
0X602DD210408CBD35.avi,1013,54,1481,37,468,2
0X60300FD6116E3023.avi,1014,98,1364,81,350,2
0X603072212882EC57.avi,1022,190,1655,171,633,2
0X603265F67987D61.avi,866,51,1355,37,489,2
0X6034BDAD7FE51795.avi,1058,22,1574,0,516,2
0X60361B7F301DEBB7.avi,982,65,1687,48,705,2
0X6037105349598904.avi,962,31,1264,15,302,2
0X603C4DE06BAD2DE.avi,1093,110,1675,90,582,2
0X60419B3EB3939EF0.avi,1429,122,2174,99,745,2
0X6043DEDF42873A99.avi,1761,95,2785,83,1024,2
0X604740AA1AC8E769.avi,1373,78,2063,59,690,2
0X6047605B3F7507A9.avi,1124,71,1640,58,516,2
0X60478355C2E0BB48.avi,954,57,1483,45,529,2
0X6047BEFB56F3FBA8.avi,907,56,1594,39,687,2
0X604F9762C755B48A.avi,1295,47,1919,31,624,2
0X6050E603BC35F0D.avi,1266,121,1274,125,8,2
0X6052BE44A33ADDFE.avi,1381,86,1866,69,485,2
0X605383A20B7C658F.avi,927,128,1346,114,419,2
0X605AAC45ACC879B4.avi,1193,17,1535,4,342,2
0X60616EC56172D3AE.avi,1014,92,1570,76,556,2
0X6062D547329B34C8.avi,1485,66,2046,45,561,2
0X60649A42C11E721B.avi,611,101,1151,88,540,2
0X606543C2636A46F9.avi,740,11,1168,0,428,2
0X6066F7CF79AD6EA2.avi,1241,65,2099,52,858,2
0X606B12A9CF68A876.avi,1015,76,1665,62,650,2
0X606B7F30476EEA0C.avi,1194,58,1781,44,587,2
0X606EAE26DB4E8B0F.avi,887,71,1414,49,527,2
0X60758344D1A615C7.avi,929,18,1410,0,481,2
0X6075BCC604236225.avi,1772,148,2577,130,805,2
0X607768213ECF3816.avi,1606,303,2066,283,460,2
0X6077DDC915D49EF4.avi,1164,107,1689,88,525,2
0X607994E451ABE328.avi,1066,56,1540,36,474,2
0X607D6FED035C7266.avi,2252,21,3344,0,1092,2
0X607D76B3B384B981.avi,1689,109,3178,91,1489,2
0X607F41470C215868.avi,1729,63,2501,47,772,2
0X6081A68BDA364282.avi,1318,55,2221,38,903,2
0X60824E65E2F8D4E4.avi,3360,63,3784,47,424,2
0X60879BF7C40D3E7F.avi,1391,67,2194,47,803,2
0X6089507F265F3867.avi,1126,49,1830,36,704,2
0X608CC80E40F3C7C7.avi,1190,36,1884,30,694,2
0X608CDE34163C8C6E.avi,2127,152,3012,136,885,2
0X608ED3201BB2F9A.avi,1562,106,2310,91,748,2
0X6093A86B26D1D702.avi,833,26,1159,18,326,2
0X60951C0848721E82.avi,1573,94,2639,76,1066,2
0X609BFE0CDDFB9E.avi,1150,123,1823,107,673,2
0X609D602D6AA2CE06.avi,827,68,1313,52,486,2
0X60A115AC08C5AA98.avi,1097,38,1661,24,564,2
0X60A1CB79D9C78AC4.avi,1063,81,1769,66,706,2
0X60A29B95CB50D7C8.avi,2258,131,2567,108,309,2
0X60A3D09BF576C9E0.avi,937,57,1449,42,512,2
0X60A3DA455577B5DD.avi,790,82,1249,64,459,2
0X60AC03ACF886B39.avi,1277,72,2117,56,840,2
0X60AC441DE6762A5C.avi,1004,98,1337,127,333,2
0X60B9AED929D32AE2.avi,1945,35,2210,27,265,2
0X60BD2CFEF17230C5.avi,1088,60,1718,43,630,2
0X60C1562BC81D2CFD.avi,1375,118,1521,102,146,2
0X60C2CB2D74D114DB.avi,1715,78,2754,41,1039,2
0X60C2DAE488E24E8C.avi,1826,111,2256,93,430,2
0X60CA87B38DB62D25.avi,890,16,1450,0,560,2
0X60CB0FCDB867416E.avi,1029,86,1607,59,578,2
0X60CBB487D539A682.avi,950,82,1614,63,664,2
0X60D12EB75747418E.avi,574,41,902,30,328,2
0X60D399F5596817FD.avi,1988,99,2459,85,471,2
0X60D4CF900E8AB3F1.avi,929,92,1621,79,692,2
0X60D51EC3F6430CD.avi,1602,69,2181,48,579,2
0X60DA39A95735153C.avi,1893,66,2458,47,565,2
0X60E2385E5BBB7D56.avi,781,64,1345,49,564,2
0X60E288E158D9E124.avi,1403,69,1693,51,290,2
0X60E313E6FCCDA537.avi,1247,67,1970,51,723,2
0X60E541E360EAC699.avi,882,130,1429,108,547,2
0X60E7BC3E1AEE124D.avi,541,72,815,51,274,2
0X60E8EFD910ABD27C.avi,641,63,1085,52,444,2
0X60EAA5FCA47FB694.avi,1039,44,1630,34,591,2
0X60EB9960DC4D3AAE.avi,1177,106,1519,88,342,2
0X60EBADBFFED44673.avi,1096,84,1859,66,763,2
0X60F0EBEA2ECCA7.avi,919,110,1468,94,549,2
0X60FA846306768D7A.avi,855,54,1332,41,477,2
0X60FB3BE1AD72FC10.avi,1344,85,1905,63,561,2
0X610001D2751C532F.avi,1220,77,1923,58,703,2
0X610039E9EFEE05C1.avi,1344,65,2001,49,657,2
0X610772D3F421D8D3.avi,1773,63,2401,50,628,2
0X610C81B6610DB1C2.avi,2173,74,3295,64,1122,2
0X61109ADAC48286FB.avi,1363,49,1882,32,519,2
0X6114052E1AFCB17F.avi,904,15,1505,3,601,2
0X6117B0541E9603CF.avi,1036,50,1507,28,471,2
0X611ECE95FA6631BD.avi,965,18,1518,4,553,2
0X61285FAE5B4098E3.avi,1219,75,2052,58,833,2
0X61290D261B4E1A2A.avi,1124,104,1781,82,657,2
0X612D302A7898B7B.avi,978,119,1605,101,627,2
0X613C65C873F42B48.avi,972,94,1568,78,596,2
0X613E15ACF68A8CD4.avi,692,74,1149,63,457,2
0X613F92D8E9051054.avi,1290,66,1907,49,617,2
0X6142773DC5AFEEE6.avi,718,30,1039,25,321,2
0X614667C1081DDA78.avi,1002,58,1723,44,721,2
0X61486985C6B1E049.avi,1391,120,2436,102,1045,2
0X61490A9A563BA496.avi,863,58,1279,45,416,2
0X614B3F106CA8115E.avi,1122,78,1824,61,702,2
0X6155412BB652E5B1.avi,1378,66,2584,47,1206,2
0X61587D736C90E3D4.avi,1793,85,2697,68,904,2
0X6158BD0A77933B5E.avi,1180,50,1772,32,592,2
0X615BECB59AC3A22A.avi,1506,78,2375,58,869,2
0X615D7146FC5C9460.avi,1532,68,2297,54,765,2
0X615DAAF2A2E00D4F.avi,1179,116,2169,104,990,2
0X61606A54D357AD12.avi,1156,127,1865,113,709,2
0X61621ADA8491FEE2.avi,2233,19,2911,1,678,2
0X6163E4FAB71D46F6.avi,1314,53,2467,36,1153,2
0X6164CF5637491D60.avi,1106,66,1849,52,743,2
0X61667A832FA493EC.avi,1038,54,1634,38,596,2
0X6166B74ED1E05A2F.avi,654,129,997,112,343,2
0X6168F0F0714C1C1C.avi,1187,77,1902,56,715,2
0X616B4664CD092CC4.avi,2140,158,2516,140,376,2
0X616F20C3E89D4CC2.avi,876,160,1380,139,504,2
0X6172BF6CBE1B8C63.avi,1078,63,1670,49,592,2
0X617470804AED8010.avi,1288,69,1980,52,692,2
0X6178BEFF04E5441F.avi,1366,58,2149,40,783,2
0X617D5C19D1A8FF89.avi,1246,18,2132,2,886,2
0X617DAA674148287E.avi,1167,132,2038,115,871,2
0X6182F7FF4D48777.avi,661,106,1099,89,438,2
0X618385631E2F91.avi,804,67,1413,50,609,2
0X6183BA1218A8B1E.avi,789,84,1288,65,499,2
0X61848F995A02B06C.avi,962,21,1404,6,442,2
0X6185F36B24251475.avi,1350,175,2046,158,696,2
0X618C08CFF808D832.avi,1236,125,2063,110,827,2
0X619010C76D709BCF.avi,767,60,1203,43,436,2
0X61970056C330866C.avi,1123,134,1878,116,755,2
0X6197221CFF744122.avi,1196,111,1761,96,565,2
0X619AAFC89B03A69F.avi,882,84,1422,75,540,2
0X619D735DD1D98D84.avi,1084,74,1766,57,682,2
0X619FFCEFBDF0CCF4.avi,964,95,1464,82,500,2
0X61A410BB1F05392A.avi,1319,74,2081,53,762,2
0X61A5A8A298CBB992.avi,963,90,1453,72,490,2
0X61AC0ADC7C9D98E0.avi,1413,191,2311,175,898,2
0X61AF888022B3E17.avi,1365,61,2133,41,768,2
0X61AFEA2C1EB13D90.avi,1219,129,1924,111,705,2
0X61B17DE63E91ABC1.avi,662,98,868,87,206,2
0X61B352290CDB2133.avi,983,50,1473,69,490,2
0X61B56FE2FAAE1DFE.avi,1212,65,2210,50,998,2
0X61B69402642621FA.avi,2354,167,3083,141,729,2
0X61B6E8FB5F3B7F28.avi,739,20,1159,2,420,2
0X61B7F331C88097E6.avi,991,50,1650,37,659,2
0X61BB4CE860D8FF7C.avi,1374,163,2038,147,664,2
0X61BCFDD03D7D72CC.avi,2223,77,2406,61,183,2
0X61C5D71CDDD1F6FC.avi,691,50,1174,38,483,2
0X61C7B5C2F114DA60.avi,866,70,1435,55,569,2
0X61CBB091699F9FAD.avi,1756,52,2778,32,1022,2
0X61D67DBEE3CA29C.avi,1560,78,2351,58,791,2
0X61D81D3A714A2CAE.avi,1987,78,3201,55,1214,2
0X61DBD51F03B76427.avi,1559,141,2327,124,768,2
0X61DD02434C3C63E7.avi,1514,46,2498,33,984,2
0X61E16B47E6FD8A4C.avi,1681,68,2696,46,1015,2
0X61E568C03C41267A.avi,998,141,1541,128,543,2
0X61E9FEC719B239A0.avi,882,74,1406,57,524,2
0X61EA0CBB056791FE.avi,1038,78,1327,56,289,2
0X61EB498F3D0E42F.avi,979,104,1531,88,552,2
0X61ED29875A107302.avi,2708,112,3214,92,506,2
0X61F021642A416187.avi,2245,60,3492,34,1247,2
0X61F17BA2035CC3FB.avi,1533,39,1987,30,454,2
0X61F438D1BB39E331.avi,1289,144,1800,124,511,2
0X61FBBED6FD9504DB.avi,975,74,1500,58,525,2
0X6200291BC8CEC0A8.avi,1800,17,2515,0,715,2
0X6200509F3CB51BF4.avi,1393,95,1862,82,469,2
0X62020DF45F8F65CF.avi,903,48,1336,33,433,2
0X620373BE146E6C3B.avi,2123,137,2545,125,422,2
0X620622F3C57A2D34.avi,1061,141,1614,128,553,2
0X62069BBDFB47067D.avi,998,138,1695,122,697,2
0X6210992ADCECE486.avi,1456,18,2275,47,819,2
0X62120394E2CFDA1C.avi,1040,140,1783,123,743,2
0X62120814160BA377.avi,2200,166,2666,203,466,2
0X62167C07ED3F8E50.avi,1238,149,2103,130,865,2
0X6216A1CA7F78D802.avi,1297,75,1881,57,584,2
0X621A5AF262880B0E.avi,1152,59,1557,45,405,2
0X621E8EA95716994D.avi,1143,17,2121,0,978,2
0X62232F7C971D7804.avi,893,22,1583,0,690,2
0X6223EE23BD172BD8.avi,1546,137,3212,106,1666,2
0X62281AB3009C0842.avi,1216,123,2090,112,874,2
0X62288B92A04EB557.avi,1379,93,2605,75,1226,2
0X6229CB36DB9F05A5.avi,892,91,1530,113,638,2
0X622CBB289D9ADCB.avi,2081,78,3337,67,1256,2
0X622E1E920459AF0B.avi,1314,62,2027,48,713,2
0X6231E19CD6477630.avi,876,88,1447,74,571,2
0X623553186A86B3F1.avi,1461,52,2496,38,1035,2
0X62363A0046BBD232.avi,2361,73,2932,57,571,2
0X62370545D10D6B3C.avi,900,69,1323,56,423,2
0X6237090A1B16DEFA.avi,1392,75,2001,53,609,2
0X623A44344DB4C3D9.avi,1196,105,1983,85,787,2
0X623F4667A42B8338.avi,924,47,1389,31,465,2
0X6242E545D9E88971.avi,1073,81,1621,65,548,2
0X62431BB9CF3A33EE.avi,809,59,1188,46,379,2
0X6243CDE6C761DC2C.avi,791,24,1311,1,520,2
0X6244378B616F4BF6.avi,1357,33,2235,6,878,2
0X624452DF15668C3B.avi,729,111,1223,96,494,2
0X6244974E7C452D0.avi,2503,114,3516,94,1013,2
0X62473A8FCF726A75.avi,2263,71,3846,52,1583,2
0X6248A53F54109542.avi,969,54,1498,37,529,2
0X6249ED892A1300E0.avi,1313,110,1681,91,368,2
0X624AF19C96CC325F.avi,1255,54,2011,42,756,2
0X624B1190D5E5D04D.avi,847,62,1253,46,406,2
0X624C7BEBC641CEDA.avi,874,110,1431,102,557,2
0X6252B9DC16FA14BD.avi,1296,123,1969,106,673,2
0X6254DB24438A055B.avi,1117,71,1795,55,678,2
0X62559BC253A97E51.avi,1925,20,3205,2,1280,2
0X626B5EC75243A0D3.avi,976,15,1626,4,650,2
0X62717DC37FD004CF.avi,1996,54,3206,38,1210,2
0X6272075AEC0BA960.avi,1529,70,1861,57,332,2
0X627232266CC3F5DC.avi,1140,167,1704,150,564,2
0X62731DCE5C886642.avi,1446,56,2213,44,767,2
0X62741A42E524CAD7.avi,1088,57,1657,41,569,2
0X6275BB18E7A8D320.avi,736,71,1089,57,353,2
0X6277D1C8274F5454.avi,699,99,1226,84,527,2
0X627A4DFBE5B59E7C.avi,1317,88,1906,73,589,2
0X627C3A92D257F19E.avi,2591,80,3221,60,630,2
0X627F73BBD2A57DEF.avi,1024,68,1619,49,595,2
0X6282B0330D95ED3F.avi,1352,144,1749,124,397,2
0X6283969D8953FECF.avi,912,109,1313,90,401,2
0X6286F6DFC7F835B8.avi,1079,53,1397,39,318,2
0X628BD140F1FC1557.avi,1420,74,2294,54,874,2
0X628E52E0848610F5.avi,945,78,1327,59,382,2
0X6290DAA1DBA189F9.avi,2206,86,2892,55,686,2
0X6294FD3F7487AA1D.avi,1873,64,2154,40,281,2
0X6296137ED4994429.avi,1353,154,2334,132,981,2
0X629BAD750FB326D1.avi,2213,20,3625,2,1412,2
0X629D824243E63810.avi,1205,129,1650,109,445,2
0X62A25E56B1AEE78B.avi,1339,87,2298,67,959,2
0X62A2EFEA0863B781.avi,1006,54,1699,37,693,2
0X62A98C9A5B58A031.avi,1142,78,1703,59,561,2
0X62AADFDC4467B5EE.avi,1228,70,2107,46,879,2
0X62ABD820E0F2FBD0.avi,1227,54,1936,36,709,2
0X62B37D47688D7F3C.avi,1517,62,1784,43,267,2
0X62B3D1284E90B92E.avi,1078,52,1758,41,680,2
0X62B760F36DAD3A27.avi,1482,103,1641,90,159,2
0X62BAD1AAAE139375.avi,1232,60,2041,46,809,2
0X62BE5E914D5C6FAE.avi,935,115,1451,99,516,2
0X62CA2DF80D04673E.avi,1472,52,2637,35,1165,2
0X62CFD637D29F0AF8.avi,2823,69,3357,49,534,2
0X62D0E438B69C344A.avi,909,133,1501,118,592,2
0X62D1775AFFC83C5A.avi,1038,75,1666,59,628,2
0X62D954A4644CE358.avi,1448,81,2032,71,584,2
0X62D9FBC429BB5C83.avi,1868,109,2232,91,364,2
0X62E2F987FDE1D54.avi,805,109,1240,91,435,2
0X62E6931F0936350D.avi,1179,119,1806,103,627,2
0X62EA10A73F0557B9.avi,1596,35,2402,21,806,2
0X62F8023D8467B4D5.avi,875,54,1213,39,338,2
0X62FFA6AFAF764AC0.avi,1141,123,1972,107,831,2
0X6300A58D8CF5363A.avi,819,71,1376,60,557,2
0X63065D5C24C3DE6D.avi,828,93,1239,74,411,2
0X630742E78187417.avi,869,73,1426,55,557,2
0X63088AEC76D7604D.avi,944,68,1493,43,549,2
0X630BF397D6215496.avi,836,72,1417,55,581,2
0X630FC0272AE524D3.avi,1293,21,1838,3,545,2
0X6311A3EA62D07100.avi,905,67,1553,46,648,2
0X63136117F9AD3DBB.avi,1248,85,1505,72,257,2
0X63155061FC7D2CB3.avi,1292,119,1971,100,679,2
0X63179AA447034992.avi,1283,67,1949,55,666,2
0X6317D4F7D0A23188.avi,903,110,1454,99,551,2
0X631F8BE60B6A906D.avi,2529,133,2896,114,367,2
0X6325022EA6862495.avi,881,115,1129,105,248,2
0X63252420012C79A2.avi,882,77,1337,66,455,2
0X6326541E9E879019.avi,1330,85,1618,72,288,2
0X632854AB56B55732.avi,1944,54,2098,39,154,2
0X63290B350833B632.avi,790,74,1384,64,594,2
0X632AD4E483D87CBD.avi,989,175,1624,153,635,2
0X632B8D7EB7551F43.avi,1261,60,1871,44,610,2
0X632DA7234D99F30B.avi,935,98,1498,82,563,2
0X632E6D2931E7704E.avi,1239,113,2326,97,1087,2
0X6332A156BE67C37E.avi,1132,52,1839,36,707,2
0X6333AD6F4B44CF29.avi,602,98,921,83,319,2
0X63350654272A9811.avi,1648,75,2187,66,539,2
0X63374545596F960E.avi,911,71,1256,58,345,2
0X63399D9E4FC71C87.avi,1090,47,1737,36,647,2
0X633BC22840D1D199.avi,1235,43,1782,26,547,2
0X633CC4D354E3419.avi,1590,43,2421,28,831,2
0X633E0E424144D38F.avi,1454,125,2299,106,845,2
0X633F7FD1EA0A3F2C.avi,2144,68,2602,52,458,2
0X6344130313AAE198.avi,1042,66,1773,47,731,2
0X63451086D7DCA911.avi,1467,69,2233,50,766,2
0X634BBF686F057DC1.avi,1143,86,1354,67,211,2
0X635245BE8BDD5C3B.avi,1259,43,1482,30,223,2
0X63599F4698755CC6.avi,1504,123,1894,106,390,2
0X635B3A98A1465315.avi,2116,75,3212,53,1096,2
0X6362AFA11DF8776.avi,966,124,1625,106,659,2
0X63669FF28E1B1D95.avi,1196,73,1944,56,748,2
0X63688D15225DA448.avi,1766,122,2645,102,879,2
0X636B7F7511BA829B.avi,1039,83,1546,61,507,2
0X63753ABBDD15107.avi,937,63,1491,45,554,2
0X6378B47399B56C39.avi,868,14,1077,3,209,2
0X6378E7F2202D8664.avi,791,55,1229,43,438,2
0X637941B5909C74C6.avi,1166,138,1674,120,508,2
0X637ADE9407BD0F0B.avi,713,73,1084,59,371,2
0X63800FF8C04208F7.avi,820,63,1348,54,528,2
0X638132579FB600C9.avi,1241,142,2025,129,784,2
0X6381C1737EEC6177.avi,1437,62,2065,44,628,2
0X63822A2B901BCE0B.avi,1237,39,1620,27,383,2
0X6382AE8EB4B73A3D.avi,1024,90,1449,105,425,2
0X6383E7D4E6CBF731.avi,1013,64,1403,51,390,2
0X63847BB266FD181A.avi,2010,64,2498,50,488,2
0X6388D094BE0DB303.avi,921,58,1578,43,657,2
0X638C6EE2A3F451E2.avi,602,61,1208,54,606,2
0X63922430844177C0.avi,960,16,1617,0,657,2
0X639419C07A6F4E33.avi,1140,157,1856,140,716,2
0X63A09D1D7547F9F5.avi,1435,60,1601,47,166,2
0X63A25BC012687C7B.avi,1281,54,1970,38,689,2
0X63A2FB5EC2E1389E.avi,1017,44,1557,30,540,2
0X63A4F48C162A36DF.avi,1208,109,2012,95,804,2
0X63A60FC760B18850.avi,919,217,1651,178,732,2
0X63A862F83C131D52.avi,1412,44,1937,23,525,2
0X63AAC8D84C8943CD.avi,894,119,1530,101,636,2
0X63ACB6EE3DB9AEA2.avi,912,73,1432,56,520,2
0X63AF6B967333B029.avi,1295,17,2111,2,816,2
0X63B0796D03779A29.avi,1989,72,2405,50,416,2
0X63B0B34DDE691EE7.avi,1421,98,1895,83,474,2
0X63C0C93E76565075.avi,4747,72,6895,56,2148,2
0X63C523280C2468E5.avi,1278,96,2146,82,868,2
0X63C937BD4B524E5B.avi,1159,19,1777,1,618,2
0X63CC93D7D9696690.avi,839,131,1336,113,497,2
0X63CF06323DEE2000.avi,1510,102,2734,82,1224,2
0X63CFB3C6EE79599C.avi,947,18,1418,7,471,2
0X63CFF3F10BD4D1E8.avi,1475,70,2439,53,964,2
0X63D04F4EEBAEBD3E.avi,1750,126,3251,106,1501,2
0X63D0E9E163F1A41A.avi,703,56,1085,44,382,2
0X63D186913EF56E46.avi,1273,61,2032,44,759,2
0X63D28BAEA7C66804.avi,1136,45,1728,31,592,2
0X63D855538102DCA1.avi,865,85,1315,67,450,2
0X63DAA4BAC6177001.avi,1290,85,2296,67,1006,2
0X63E41C64661C0696.avi,909,159,1683,140,774,2
0X63E434559D0852DE.avi,1139,85,1585,64,446,2
0X63E4C2DD767A2E7F.avi,1333,86,1622,67,289,2
0X63E4EABEC5781C.avi,745,65,1618,50,873,2
0X63E53A89D55764E3.avi,1665,51,2085,34,420,2
0X63E6231DF8337689.avi,1105,62,1653,48,548,2
0X63EFA5F7FFFB0014.avi,2001,101,2861,82,860,2
0X63F67FDA7F9B0C34.avi,1721,107,2372,95,651,2
0X63F79AE85D25960E.avi,1075,51,1550,37,475,2
0X63FD72B89AACC089.avi,990,88,1453,75,463,2
0X63FECBA90BA79F81.avi,1594,169,2720,151,1126,2
0X6400D44A81CDC666.avi,657,41,1224,31,567,2
0X6406F656D85D613.avi,1289,56,1784,39,495,2
0X64099CA1B1AE23FD.avi,860,17,1402,2,542,2
0X640B3C771632C834.avi,1607,207,2587,184,980,2
0X640BEAA86E433A60.avi,727,45,1214,25,487,2
0X640CE139BAA401B2.avi,1663,92,2856,73,1193,2
0X640DF0986ACFEB8C.avi,890,67,1420,46,530,2
0X641187BA5EAA4331.avi,1296,111,2003,94,707,2
0X64153B07B714C730.avi,944,49,1510,34,566,2
0X641675ED5FBFD2FB.avi,1023,61,1735,47,712,2
0X6418370A8B0A2187.avi,1842,167,2237,141,395,2
0X64188A16B85C8527.avi,1765,47,3201,35,1436,2
0X64196964401D2938.avi,958,56,1671,41,713,2
0X641D26A1B0745A7E.avi,1107,170,1694,156,587,2
0X6423EE8AA54159E9.avi,1103,141,1965,130,862,2
0X6426324539E692CB.avi,1523,110,2200,92,677,2
0X642AB0D752EAB589.avi,906,52,1479,38,573,2
0X642D54AB691E0FC0.avi,1211,87,1887,66,676,2
0X642E639A8CDE539B.avi,1483,141,1600,89,117,2
0X642E683AF1A5244C.avi,1136,63,1858,47,722,2
0X64342D77565BCE3.avi,1131,117,1877,103,746,2
0X64346E030157ED80.avi,1195,156,2055,136,860,2
0X643525F6DB08BF41.avi,872,45,1375,34,503,2
0X643B9D92868C371B.avi,986,14,1733,0,747,2
0X643D753BD3302E6B.avi,960,106,1668,92,708,2
0X64402E4398BFCFC2.avi,627,98,1000,80,373,2
0X6440E65AC7ED5668.avi,600,16,1000,0,400,2
0X644477CB728755E0.avi,1049,109,1617,92,568,2
0X64452FF284C03039.avi,1014,14,1582,1,568,2
0X6446D01F5B6E082.avi,2031,84,2279,70,248,2
0X6447EF85C60A98FC.avi,1256,174,2118,161,862,2
0X644EF08C46882EC3.avi,1177,57,1997,40,820,2
0X64567227AC006B23.avi,832,64,998,50,166,2
0X6456DAE3F9D1538B.avi,1424,106,2033,93,609,2
0X6456F968787519E7.avi,1960,98,3027,77,1067,2
0X6459870D85C30216.avi,1112,120,1731,104,619,2
0X645D545CEC6B682.avi,1374,62,1869,41,495,2
0X645DA49E73828690.avi,1145,81,1941,66,796,2
0X645F2FD9B7EB9211.avi,838,83,1406,66,568,2
0X6460CABD12C329D4.avi,2447,78,3334,61,887,2
0X6462C027F89C1319.avi,1834,65,2385,48,551,2
0X64645749B8E566B9.avi,1277,84,1977,67,700,2
0X6467B6237F51BCE.avi,1289,59,1877,43,588,2
0X6467DCE2362FB3B3.avi,2035,70,3297,49,1262,2
0X646CABD4DAB1BF83.avi,1231,93,1854,78,623,2
0X6471525F25F5395F.avi,962,96,1684,82,722,2
0X647499F6DA710D4F.avi,1131,140,1620,121,489,2
0X6475EE6823D4912D.avi,969,40,1440,30,471,2
0X647668461C467044.avi,998,54,1956,40,958,2
0X6478438459208AD5.avi,1099,45,1366,33,267,2
0X647970156BD4D14A.avi,1257,76,1837,57,580,2
0X6479BEFEFDB47B80.avi,1460,49,2245,34,785,2
0X647C3D4FCD2C623C.avi,952,66,1310,54,358,2
0X647C40B261C13DD4.avi,993,59,1629,44,636,2
0X647CDD011149BFBB.avi,1628,144,2739,127,1111,2
0X648EBE05D8EF7CFE.avi,1252,122,1554,104,302,2
0X64901E9D47895B5B.avi,990,123,1416,107,426,2
0X6493CA2C0B218D5D.avi,2483,133,3662,106,1179,2
0X64991BE928F68684.avi,1097,146,1846,125,749,2
0X64A9B5E4315CE2EE.avi,1770,131,2700,114,930,2
0X64AB025500AB6DBC.avi,794,158,1411,139,617,2
0X64ABDEF4276C88D0.avi,1548,116,2928,101,1380,2
0X64AD5CE84D6CC19E.avi,1353,64,2080,47,727,2
0X64B2B77B0C551FE4.avi,1131,48,1488,37,357,2
0X64B3193E01E9E5BA.avi,1501,106,1826,89,325,2
0X64B7294110706DC5.avi,1819,94,3170,79,1351,2
0X64C7A83C1CB202F2.avi,1114,105,1773,88,659,2
0X64C7EC2ED7DBD367.avi,2223,54,3462,39,1239,2
0X64C8728B8D1EC69B.avi,929,110,1530,95,601,2
0X64CA842A0F36035.avi,2546,64,4634,44,2088,2
0X64CAD12B7716CD96.avi,792,52,1250,36,458,2
0X64CD34F0EAB6D008.avi,1130,89,1869,67,739,2
0X64CD75A3087F44C.avi,1257,135,1610,111,353,2
0X64CD8BFE328160BA.avi,871,20,1373,4,502,2
0X64D192FDC5030E7E.avi,1032,122,1467,104,435,2
0X64D1B760B0B33F99.avi,1291,52,1991,39,700,2
0X64D572D8F917F0FE.avi,1341,59,1804,43,463,2
0X64D5C407FA568640.avi,1363,109,2368,95,1005,2
0X64D5CA3CF6F65F27.avi,1543,68,2119,50,576,2
0X64D81B504D7FF03C.avi,1166,56,1896,39,730,2
0X64DCDB6CC0B251FA.avi,808,69,1372,52,564,2
0X64E2FC6E99FAF669.avi,1481,74,2103,54,622,2
0X64E3F029012A62AA.avi,1449,154,1985,134,536,2
0X64E76A6139910CB9.avi,682,67,1001,51,319,2
0X64EE9FFA5DA69058.avi,784,78,1225,68,441,2
0X64FAE0A9E0740D03.avi,909,84,1579,70,670,2
0X65072FB226CAD3B2.avi,1094,72,1741,53,647,2
0X6507E201943B22B1.avi,1148,72,1881,55,733,2
0X650881B7ADEF9668.avi,933,179,1636,157,703,2
0X6508990DC3493349.avi,1269,60,2080,45,811,2
0X650A05F9B5D9F425.avi,1112,147,1747,134,635,2
0X650C78FAA0312711.avi,1062,14,1696,1,634,2
0X65115C498B497C14.avi,1137,118,1728,96,591,2
0X6517121A1CC175DC.avi,1070,22,1694,0,624,2
0X6518D5BFE63259EF.avi,963,71,1613,51,650,2
0X65208512A67B9529.avi,1080,64,1797,48,717,2
0X652153F7E83F458F.avi,730,60,1075,46,345,2
0X6524AC0A6E1ABC5C.avi,1140,103,1741,86,601,2
0X652774B9B23300A4.avi,1170,58,2005,40,835,2
0X6528D2CD71A27968.avi,921,52,1146,37,225,2
0X652B75C6FB4BE598.avi,1338,47,1606,29,268,2
0X652C7A5FA55C5201.avi,1109,168,1662,148,553,2
0X652ECB6DE3326FE9.avi,1876,151,2451,133,575,2
0X65308E5E0624A6C1.avi,1287,60,1617,44,330,2
0X653188DF2B81C1F9.avi,1891,62,2603,43,712,2
0X653267FDDD4EF0E7.avi,2296,129,2736,109,440,2
0X6532C54260D0231.avi,870,118,1254,130,384,2
0X6534AE7ED9A039EE.avi,1037,18,1636,0,599,2
0X6535F819C7185C51.avi,1183,18,1847,1,664,2
0X653C793B3F2B3510.avi,1571,67,2158,47,587,2
0X653CC913017A8C19.avi,1229,134,2080,114,851,2
0X6541D7939DEF6989.avi,884,58,1216,40,332,2
0X6544ED8E3D660B88.avi,1460,96,2077,77,617,2
0X6545D8FA38575CBF.avi,1103,53,1907,38,804,2
0X654B16581A5CE299.avi,1049,61,1688,46,639,2
0X654CBBC325689148.avi,1132,71,1965,55,833,2
0X655147B40196C1D3.avi,863,95,1308,71,445,2
0X65516451A2E52F44.avi,1321,88,2067,74,746,2
0X655399113DAA4ECC.avi,1790,0,1895,16,105,2
0X65552642DAE0A494.avi,1366,54,1912,41,546,2
0X65566D21DE3607C0.avi,932,82,1639,63,707,2
0X6560CC6E271F6D21.avi,2136,67,3543,51,1407,2
0X656705047098A5FC.avi,1596,70,2844,49,1248,2
0X656969EB60FFF3D0.avi,988,51,1453,35,465,2
0X65701772634F735F.avi,2743,67,3488,53,745,2
0X6570BEE903D51DFE.avi,908,54,1362,40,454,2
0X6570FEF9FC36D7C2.avi,1043,127,1790,110,747,2
0X657253CA562EF468.avi,1012,108,1446,91,434,2
0X65753CA4ABFD5B4D.avi,683,107,1126,90,443,2
0X6575ED8B607878CF.avi,2568,117,3049,99,481,2
0X6575EF6E0F584F4F.avi,2399,122,2614,105,215,2
0X657773E06E5DC8CF.avi,1820,57,3012,40,1192,2
0X657AF47EF22C6290.avi,1191,100,1830,82,639,2
0X657F7B916C0A37BF.avi,1103,105,1731,92,628,2
0X65834A48C2AB3649.avi,1574,118,2687,100,1113,2
0X6586C3F1D344FDFB.avi,1079,57,1463,39,384,2
0X65880EF54397293E.avi,1333,62,1841,46,508,2
0X658AC1BA93532526.avi,1231,118,2096,100,865,2
0X658AEA4B6FB6C69C.avi,1646,93,1933,75,287,2
0X658BF7B9A9C6B4DD.avi,983,64,1535,49,552,2
0X65903F79E0D91D80.avi,1361,79,1820,64,459,2
0X659315B077CFCAE2.avi,1274,47,2045,33,771,2
0X6595CCE63E8A9FB1.avi,1191,150,1968,132,777,2
0X6596000F8A23ADA8.avi,4484,73,5634,53,1150,2
0X6596D8BF8019271F.avi,1333,62,2137,47,804,2
0X659B94C54FB2A424.avi,1145,75,2123,55,978,2
0X659BBAF883211018.avi,874,113,1562,99,688,2
0X659D7C2040A17F30.avi,1239,121,2038,99,799,2
0X659F28A1D4054453.avi,927,52,1548,38,621,2
0X65A2ADCC7A35528F.avi,904,93,1413,79,509,2
0X65A4CFF0CDED342B.avi,917,66,1482,50,565,2
0X65A7AF6CE6C51FA4.avi,995,57,1624,42,629,2
0X65A93402E4FD359D.avi,851,93,1396,77,545,2
0X65A9AD514CAB60F6.avi,910,60,1553,44,643,2
0X65AA294CD0269E6.avi,1380,114,2327,97,947,2
0X65ACA3F8B770AAD7.avi,1065,148,1466,130,401,2
0X65ACFF71F3288CEB.avi,1951,105,2939,97,988,2
0X65AFBE7F72F33F56.avi,805,129,1286,114,481,2
0X65B1A716EEA8A06F.avi,1077,117,1804,101,727,2
0X65B23F659EFEE4B5.avi,1319,143,2140,128,821,2
0X65B2EFC3B8EFD35D.avi,1311,161,2262,142,951,2
0X65B33C7D1BA2303C.avi,960,69,1551,54,591,2
0X65B6646A8864CFF2.avi,1076,59,1585,41,509,2
0X65B7FD443008A7FE.avi,1108,162,1580,148,472,2
0X65BAA5953F13E76F.avi,772,67,1199,51,427,2
0X65BE4D7A748C3A2E.avi,1199,102,1771,81,572,2
0X65BFE57982B5CE91.avi,966,72,1473,56,507,2
0X65C05D708C373803.avi,843,86,1445,75,602,2
0X65C0691EFC9931F6.avi,1216,121,1831,100,615,2
0X65C488B49774AE48.avi,1023,119,1667,103,644,2
0X65D15BBB6891406A.avi,888,54,1458,40,570,2
0X65D85BE69D1D8F64.avi,1066,90,1658,75,592,2
0X65E1A5AE0862B8B6.avi,1047,66,1642,54,595,2
0X65E2A0A6C4CDBC1.avi,767,67,1150,47,383,2
0X65E605F203321860.avi,2825,32,3814,53,989,2
0X65E85D2F82BA872E.avi,861,126,1341,107,480,2
0X65E89AC890F1DC3F.avi,1040,133,1638,120,598,2
0X65EDD2669C886790.avi,1172,115,1806,98,634,2
0X65EFA6DFA62351C9.avi,1002,73,1848,59,846,2
0X65F1640C91221F37.avi,1398,74,2070,55,672,2
0X65F84656B24B5511.avi,2573,96,3216,82,643,2
0X65FAC9441FA92B93.avi,1408,127,2156,108,748,2
0X65FB2AC7E0207522.avi,875,58,1396,46,521,2
0X65FCF0CE7A00FB1C.avi,982,48,1468,35,486,2
0X65FE895469EFDA8B.avi,1006,70,1857,51,851,2
0X65FF0A025B2C71EA.avi,979,71,1561,52,582,2
0X660104EE65A0D28E.avi,742,17,1141,1,399,2
0X66050153ED5E08EA.avi,981,94,1613,81,632,2
0X660577E3B07A47CE.avi,1485,133,2761,116,1276,2
0X66095387FB014661.avi,924,68,1436,50,512,2
0X660DF8CADE3493DB.avi,1321,109,2111,93,790,2
0X6610463AD711E147.avi,1566,61,2632,46,1066,2
0X6610FEE0E4DB11B5.avi,1301,65,2241,46,940,2
0X661442FDB0CA1292.avi,1318,68,2058,50,740,2
0X66150B1C51FE2973.avi,1043,120,1574,105,531,2
0X661758A0D4DDE90B.avi,977,102,1642,85,665,2
0X661BF682DDCABEA3.avi,904,77,1474,61,570,2
0X6629C6225F411536.avi,1319,68,1855,43,536,2
0X662EF84E75806C27.avi,2288,60,2797,48,509,2
0X663231D707998E6.avi,1375,147,2246,130,871,2
0X66323769FB7ECD5D.avi,1158,44,1409,31,251,2
0X6634179FD03E7894.avi,974,112,1535,100,561,2
0X663BC386B0224ABB.avi,1408,20,2263,1,855,2
0X663D82EB24009DF8.avi,1763,118,3146,97,1383,2
0X663EF0126EB679DB.avi,1225,115,1977,98,752,2
0X66485513B1CFC9AE.avi,1159,71,1866,53,707,2
0X66498ED03F00B58.avi,755,123,1141,108,386,2
0X66513C273628711D.avi,1485,72,2524,55,1039,2
0X66589A55D172C35C.avi,1318,62,1699,45,381,2
0X665A80CE550ADFA.avi,1957,86,2814,62,857,2
0X665B15BB5ABDCCFF.avi,1277,70,1730,52,453,2
0X665E43AF6FE1563D.avi,861,54,1375,39,514,2
0X666344D2DD9224DE.avi,1177,142,1807,120,630,2
0X666349AB95E1677.avi,1009,101,1198,70,189,2
0X6664870503647CFB.avi,1730,59,2174,42,444,2
0X666873505855894.avi,1363,19,1817,4,454,2
0X6668ACFCA23901D4.avi,2123,47,2456,36,333,2
0X66740E6F2A2F90A6.avi,1040,82,1510,68,470,2
0X6675FE3D0AFC31BD.avi,1147,58,1720,41,573,2
0X66767284B72B3E78.avi,853,144,1251,122,398,2
0X667955B6FC13C36.avi,1033,38,1575,24,542,2
0X667B0BEE8F4F8F2D.avi,1057,131,1554,116,497,2
0X667B5B4810379555.avi,1297,54,1685,36,388,2
0X667FD7179D55F5AF.avi,868,145,1430,126,562,2
0X66823EEDB9A8D930.avi,1067,122,1431,110,364,2
0X6684E4B16D37E14.avi,1022,66,1578,47,556,2
0X668A7CAD095C1D4C.avi,1005,76,1245,61,240,2
0X668B799502EF644B.avi,1057,44,1602,32,545,2
0X669090C0E856365E.avi,769,74,1266,58,497,2
0X6691FC17FF306EA5.avi,2776,94,3441,79,665,2
0X6692B6CEE5DCCFC0.avi,1518,17,2046,0,528,2
0X66943CAFDC2AC478.avi,1166,100,1833,85,667,2
0X669833DEC464DE58.avi,2186,166,3808,151,1622,2
0X669B1F6BD601634.avi,1320,61,2138,43,818,2
0X669C85F4369B9F8F.avi,1006,82,1729,64,723,2
0X669DE1EFA9B175D9.avi,978,15,1601,0,623,2
0X669DF94C3BCCDE7B.avi,1014,56,1484,46,470,2
0X669FE870F1ACFC73.avi,739,67,1331,52,592,2
0X66A0A7C2D3B4B0A7.avi,791,142,1254,135,463,2
0X66A167447E7F1770.avi,1041,58,1368,42,327,2
0X66AB95639ED874F.avi,1631,89,2036,74,405,2
0X66AC005B83155AF3.avi,1026,68,1643,47,617,2
0X66B7661D9ADBD284.avi,1024,37,1484,30,460,2
0X66B9870579E61D28.avi,1062,78,1878,56,816,2
0X66B9D0727965351A.avi,1538,40,2219,28,681,2
0X66BA13935B0B974.avi,1121,80,2102,67,981,2
0X66C173C78E8F6EDF.avi,1749,89,3072,63,1323,2
0X66C8E103FFEE45DF.avi,1117,57,1660,46,543,2
0X66C8EAE88FFB77EE.avi,1282,76,1657,53,375,2
0X66CBBE76152663AE.avi,1137,69,1887,52,750,2
0X66CD8A146E264C5C.avi,1167,53,1685,36,518,2
0X66CD95FB321BF102.avi,1299,75,1856,55,557,2
0X66CE85713FABD830.avi,945,57,1504,46,559,2
0X66CF7DDCF1B8920D.avi,1622,18,1859,3,237,2
0X66D3177E10B63872.avi,838,56,1431,40,593,2
0X66D5B2636F084D50.avi,1771,122,2741,106,970,2
0X66D60CC6C281CAA7.avi,836,121,1155,100,319,2
0X66DAEF49CE746360.avi,4173,52,4749,37,576,2
0X66DC4A8DD37055CC.avi,1245,66,2004,50,759,2
0X66E313EF5B96FD96.avi,853,72,1288,59,435,2
0X66E92E721D27BF17.avi,710,53,977,33,267,2
0X66ECE3A29BB030DA.avi,1410,67,2314,49,904,2
0X66F56796903B5D4F.avi,1542,145,2596,129,1054,2
0X66F67400B4224304.avi,1610,118,2308,102,698,2
0X66F7B3D066CDBF3B.avi,1114,67,1444,49,330,2
0X66FA32EDB231FFC2.avi,1123,106,1607,93,484,2
0X66FB64B67D109199.avi,931,76,1530,60,599,2
0X66FC5D40C9D897B1.avi,1671,113,2429,94,758,2
0X66FD6E92F7ABD0CE.avi,1550,92,2254,73,704,2
0X66FDF9218D696E41.avi,797,127,1278,108,481,2
0X6703FCFAD2E7CBCA.avi,1758,66,2451,46,693,2
0X67062227EF11E9B7.avi,950,67,1400,49,450,2
0X670A0F9C14BDD4CE.avi,1186,162,1469,147,283,2
0X670CDE1D82BD7956.avi,1201,82,1660,63,459,2
0X6710BA6184204672.avi,1369,109,1877,90,508,2
0X6715D2C6A51FDC7C.avi,1022,113,1699,100,677,2
0X671A1682EAD51E03.avi,2022,80,2899,63,877,2
0X6720DAE21174550.avi,1015,167,1742,153,727,2
0X6721138DB497FCB3.avi,1511,66,2008,50,497,2
0X67258AC1999CA388.avi,916,111,1445,97,529,2
0X6728170DD8443536.avi,1277,59,1834,41,557,2
0X6728A3BFFD051355.avi,993,122,1333,106,340,2
0X672FD8B7D89552F6.avi,1012,99,1636,120,624,2
0X6732C1BF9A1903C.avi,818,98,1350,85,532,2
0X6732D6F83932DACA.avi,1031,66,1367,51,336,2
0X67335086CE434673.avi,1566,93,2124,80,558,2
0X67345337DA0C55CA.avi,1057,73,1539,55,482,2
0X673694C8A87D2876.avi,1374,125,2148,110,774,2
0X673B5192D6B9C4EA.avi,1218,104,2076,88,858,2
0X673D686D3E02F0D.avi,898,105,1533,93,635,2
0X6743FE92AFBB3FE5.avi,2284,45,2821,30,537,2
0X67445623181AB842.avi,1054,16,1886,0,832,2
0X6746F7566C8A2500.avi,810,69,1284,52,474,2
0X674BD01159859802.avi,567,18,905,6,338,2
0X674C03AD23D41BB6.avi,1144,109,1840,91,696,2
0X674D11613887E038.avi,1498,84,2541,68,1043,2
0X674D61E41CAB000D.avi,1150,125,1675,109,525,2
0X674EDFBC52AE7E3.avi,1109,48,1715,33,606,2
0X6752E91D593ABCAE.avi,929,82,1243,71,314,2
0X675972D5C0182669.avi,894,56,1506,38,612,2
0X675B53AE93B14D06.avi,1856,135,2507,119,651,2
0X675C2C40899BE4C1.avi,1102,99,1994,83,892,2
0X675DD194648538EC.avi,961,58,1404,42,443,2
0X675E10DDEFCB2A96.avi,1190,17,2082,2,892,2
0X6767F4359E20EE24.avi,1523,249,1749,229,226,2
0X6769A9060D724375.avi,899,52,1397,40,498,2
0X676EF9C13050917F.avi,908,58,1416,45,508,2
0X677366B12D63509A.avi,1826,41,2753,26,927,2
0X67753ECB554BC154.avi,2185,103,3364,83,1179,2
0X67868606606A2BBC.avi,1080,102,1715,85,635,2
0X678B0D95D2EF1F37.avi,2037,73,2515,59,478,2
0X679D34B4E61373F4.avi,1569,67,2653,51,1084,2
0X67A1EB7C88B5A510.avi,2100,65,2226,55,126,2
0X67A4CC520BEE5551.avi,892,58,1421,42,529,2
0X67A7AEB12C2DA3E2.avi,1044,112,1703,94,659,2
0X67AAE45F773658DC.avi,1164,16,1707,3,543,2
0X67ABFBDF2329C556.avi,952,35,1389,23,437,2
0X67ADC1FAB1C29E0E.avi,903,15,1429,5,526,2
0X67B63CC28517C0E.avi,884,120,1508,102,624,2
0X67B69FA150D346F3.avi,2493,99,2908,84,415,2
0X67C04E297ECB4FD5.avi,1484,103,2454,90,970,2
0X67C09B651EC014B6.avi,897,108,1360,95,463,2
0X67C1FB8BB638EEE0.avi,1193,196,1920,178,727,2
0X67C3B0621AC0639B.avi,1432,74,2444,57,1012,2
0X67C5071C6A5E16B9.avi,1638,102,2744,86,1106,2
0X67C5B6E3D1D25595.avi,886,62,1513,45,627,2
0X67C9BA2B3CDD74C.avi,1092,20,1771,3,679,2
0X67CC398E12E56F6F.avi,1650,92,2659,79,1009,2
0X67CC83EFED2413B8.avi,1379,57,2279,41,900,2
0X67CEAB9DD15BF8DA.avi,964,105,1539,88,575,2
0X67D00C92919C56D0.avi,1554,127,2510,112,956,2
0X67D3775E2E66F543.avi,1296,56,2137,41,841,2
0X67DA2B2AE959F381.avi,1180,52,1618,41,438,2
0X67E320B11E8421AB.avi,1782,64,2738,43,956,2
0X67E62FE7B3BA52B3.avi,1097,17,2010,0,913,2
0X67E6673AA2567482.avi,1347,55,1930,43,583,2
0X67E84A6AEB6EEF44.avi,2689,93,3289,81,600,2
0X67E8F2D130F1A55.avi,1578,111,2137,20,559,2
0X67ECED2F51637F45.avi,832,111,1251,96,419,2
0X67EEAB34427A2162.avi,1024,67,1568,48,544,2
0X67F06708C04321F7.avi,1299,88,2139,68,840,2
0X67F0850A73E98169.avi,878,96,1514,80,636,2
0X67F16F4E4A17E54E.avi,995,65,1704,47,709,2
0X67F418EFEAF112A.avi,1278,94,2217,80,939,2
0X67F8AC58B0BAA98.avi,1767,162,2293,198,526,2
0X67FA43200406EB5.avi,1754,110,3347,96,1593,2
0X67FC799EC72F1852.avi,989,98,1624,84,635,2
0X6802C4DD3536B4A.avi,2668,73,3113,54,445,2
0X68064ABC9AB952B0.avi,934,116,1502,105,568,2
0X6806B6025888CBBA.avi,593,48,915,36,322,2
0X6809AF862A2FD6B7.avi,1334,69,1819,52,485,2
0X680C3DA23D0A91D8.avi,1522,16,2510,4,988,2
0X680FD0769EB255A7.avi,632,48,915,32,283,2
0X681422525BDCBDAD.avi,1090,99,1781,79,691,2
0X68162D95EAB2AB4E.avi,1442,99,2360,82,918,2
0X681A95D85C2D17EC.avi,1231,34,1465,17,234,2
0X681C4622AD93D1E5.avi,1881,124,2510,109,629,2
0X681D192A1055B8C6.avi,895,54,1328,38,433,2
0X6823E5601B50BC19.avi,1506,50,2517,37,1011,2
0X6828C199A8035B7B.avi,1186,18,1757,0,571,2
0X682B20D1C224EFAA.avi,1116,126,1831,109,715,2
0X683199EBCD0E7143.avi,823,136,1228,120,405,2
0X6833A5F6D0FB940B.avi,1007,127,1547,108,540,2
0X6834D917DCB267D3.avi,862,16,1308,1,446,2
0X6836F617166B7CC6.avi,1037,18,1666,2,629,2
0X683BC0A201466229.avi,1158,15,1593,1,435,2
0X683BF75E16371700.avi,1279,82,1703,58,424,2
0X6846DD85241D2AD9.avi,826,74,1233,62,407,2
0X684A3BC616D3740C.avi,1768,65,1981,49,213,2
0X684A5A0EACA29BD.avi,1004,107,1542,90,538,2
0X684B82C1CFEDE76C.avi,1497,107,2343,92,846,2
0X68521E9A7A5E6C26.avi,2223,194,3664,175,1441,2
0X68524510445EEC8A.avi,1030,177,1578,160,548,2
0X6852980082149389.avi,960,116,1773,84,813,2
0X6854B1C76DCE575.avi,1980,64,3679,52,1699,2
0X6855BBCBB720BD0D.avi,1248,103,1978,85,730,2
0X6857D30D7DE3D2E9.avi,960,131,1469,112,509,2
0X6857E329D98B9E04.avi,1334,69,2181,55,847,2
0X68590910C6F222F6.avi,1482,58,2282,43,800,2
0X685A4B045C95B72A.avi,1091,28,1602,21,511,2
0X685D2596D38E77FF.avi,1498,70,2832,55,1334,2
0X685D625A49A9C1F6.avi,1531,146,2027,132,496,2
0X685D65855E946377.avi,1138,65,1919,49,781,2
0X685F062E752D3638.avi,910,16,1298,1,388,2
0X68625A7A16D72E46.avi,1207,70,1724,49,517,2
0X6866809B28E76AF6.avi,1100,69,1528,54,428,2
0X6866C629747A847B.avi,1031,187,1724,167,693,2
0X6867156FCD59C7DD.avi,555,20,929,5,374,2
0X686AA246EEAF841F.avi,994,12,1681,3,687,2
0X686BDE41B6806D07.avi,870,57,1426,42,556,2
0X686D8CAEF6113D71.avi,1207,67,1863,55,656,2
0X686DE99DF17681C8.avi,982,79,1569,63,587,2
0X686E9F8A8AA1DE4B.avi,792,78,1408,62,616,2
0X686F756A1F380DAC.avi,1368,57,2375,44,1007,2
0X68702D6B20ACB987.avi,1262,125,1863,112,601,2
0X687155395446BA2B.avi,1144,89,1687,71,543,2
0X6871AA112FB25F00.avi,1409,71,2161,53,752,2
0X6878753F91B0C449.avi,892,71,1462,54,570,2
0X6879E81713CC3748.avi,960,147,1466,129,506,2
0X687A5BC36E15FA4F.avi,701,132,1210,113,509,2
0X687F32820865345D.avi,1240,68,2109,54,869,2
0X6887B19B44DD3AE3.avi,1373,66,2159,51,786,2
0X6888101946612E3.avi,1038,72,1601,54,563,2
0X688C57361B02B07A.avi,1630,99,1931,89,301,2
0X688E31C0473B80BD.avi,1178,161,1765,146,587,2
0X688F3ADAB94010A0.avi,733,101,1108,85,375,2
0X68908A2FFC0B7496.avi,1185,94,1916,77,731,2
0X68930B35122898F9.avi,1153,96,1818,72,665,2
0X6896FB3693FB3A72.avi,839,72,1318,54,479,2
0X689FC77F82B906D3.avi,1301,54,1834,37,533,2
0X689FFAC34F9C025A.avi,728,59,1094,38,366,2
0X68A1CAF48D768778.avi,865,67,1337,53,472,2
0X68A375AA5675630D.avi,750,52,1084,36,334,2
0X68A39C8B92F679D6.avi,1534,49,1770,34,236,2
0X68A7270BE67D7400.avi,1011,71,1576,52,565,2
0X68AA4D586D32621A.avi,799,54,1291,40,492,2
0X68ACB079A9BDE1EF.avi,1326,125,2010,109,684,2
0X68B18CF20C51DCB2.avi,1115,100,1722,86,607,2
0X68B3B1926A16337D.avi,804,51,1279,38,475,2
0X68B8020411063DB8.avi,2178,65,3656,48,1478,2
0X68BD8FCCB1FAEE60.avi,1258,100,1837,80,579,2
0X68C1CD733690A87A.avi,844,80,1352,57,508,2
0X68C23E699437AB64.avi,1710,88,2588,64,878,2
0X68C605D0E6D11A08.avi,1201,59,1857,41,656,2
0X68C77109B94D74B9.avi,1544,127,2359,110,815,2
0X68C940A6A6F5838D.avi,1609,51,2399,39,790,2
0X68D189149E39665.avi,1808,71,2201,49,393,2
0X68D627A09628F237.avi,1325,72,2079,54,754,2
0X68D6DF1106C643F8.avi,2539,52,3126,35,587,2
0X68D721D9EEC218.avi,1533,93,2467,66,934,2
0X68D9AB58E435F878.avi,1853,198,3358,172,1505,2
0X68E3DA63806EEFBD.avi,1913,90,3045,78,1132,2
0X68E8A6D619571049.avi,1770,93,2217,79,447,2
0X68EBF6C87CD14F34.avi,767,88,1156,75,389,2
0X68ECE2BAF6D0D2FF.avi,1198,83,2037,66,839,2
0X68EFD6182F99DA56.avi,810,105,1290,87,480,2
0X68F1A70EFE9D108C.avi,1381,101,2319,76,938,2
0X68F1C08A47F51B60.avi,1282,81,1741,64,459,2
0X68F5FD987AB1DE31.avi,1066,21,1263,0,197,2
0X68F95430838173EB.avi,923,65,1435,48,512,2
0X68FAB5062A53ED22.avi,1050,73,1648,55,598,2
0X68FABC85AAFEF0C8.avi,1208,90,1861,75,653,2
0X68FEAD20679D9B7A.avi,1234,69,2037,53,803,2
0X68FF6C389EA38EA1.avi,1499,55,2396,37,897,2
0X690905881CA73619.avi,799,71,1282,50,483,2
0X690985555ADCB775.avi,1036,56,1588,38,552,2
0X690BF65CCE72593E.avi,1368,86,2133,61,765,2
0X690C466520DCF9E3.avi,653,67,1077,53,424,2
0X690D382720F5BF93.avi,1108,131,1820,118,712,2
0X690EEA7ED4067209.avi,1121,64,1868,48,747,2
0X6911215576ED756B.avi,1364,17,1703,0,339,2
0X6918A5797070503.avi,788,122,1373,109,585,2
0X691EEC9060E26058.avi,1114,174,1826,155,712,2
0X691F6E99AB190410.avi,1832,100,2902,84,1070,2
0X6921A7FAA46C25A7.avi,1021,80,1764,63,743,2
0X6924181AE32F84A6.avi,1877,65,3350,50,1473,2
0X6924FEFBEF2EA847.avi,2386,58,2743,40,357,2
0X69297859FF626047.avi,1506,90,2372,78,866,2
0X6929D94A7E4C62B7.avi,1097,108,1522,91,425,2
0X692F41B4E9E0CCAB.avi,1457,119,2238,100,781,2
0X6930EF64D363CAD9.avi,1802,78,1997,64,195,2
0X6934668EAB32560.avi,1054,145,1756,131,702,2
0X694033179511A13E.avi,1073,16,1554,4,481,2
0X69413D44827B96C1.avi,1019,17,1673,0,654,2
0X69447E46FEDD2A3F.avi,1405,19,2260,15,855,2
0X694801E47434307F.avi,551,51,896,38,345,2
0X694A48FBAD032A23.avi,1261,98,2153,83,892,2
0X694C6FDAA8B7D96E.avi,1578,183,2402,166,824,2
0X694CBB67193485BD.avi,2106,67,2847,45,741,2
0X694D5E1CBC38D44E.avi,1158,101,1936,82,778,2
0X694EE681A4D5697C.avi,839,59,1337,46,498,2
0X69549AA1CA32AE28.avi,967,107,1671,94,704,2
0X6955FFE50B579D53.avi,1007,62,1423,48,416,2
0X6956919815606827.avi,563,60,876,46,313,2
0X69572A530D2CC5E4.avi,1582,18,2274,3,692,2
0X695821AC12CAAFD2.avi,1656,112,2560,97,904,2
0X695AD46166A86635.avi,1558,82,2930,67,1372,2
0X695AF94E37EA61C5.avi,1005,66,1412,53,407,2
0X695E8125B90E542F.avi,1009,87,1370,70,361,2
0X69635DF0D0C9AE26.avi,894,63,1443,46,549,2
0X6963A8CAD6154CFB.avi,1405,43,1825,31,420,2
0X6965979E40FD1758.avi,1490,94,2047,78,557,2
0X696599CDFA651DB8.avi,1469,63,2412,47,943,2
0X6965A9076612C2A4.avi,1043,70,1742,51,699,2
0X6966D02D954A8BAD.avi,1079,124,1596,111,517,2
0X696A6FF8D9099FD8.avi,1593,124,2165,108,572,2
0X697A7501D6027B4B.avi,1110,119,1723,109,613,2
0X6984F621BB01FA4F.avi,1468,106,1956,88,488,2
0X6985788FAE5F8039.avi,997,81,1568,69,571,2
0X6986F2D866C7AF73.avi,1104,60,1795,46,691,2
0X6988345BE72D9814.avi,1098,72,1764,56,666,2
0X698851733B8DB622.avi,930,43,1249,28,319,2
0X698CD6F727626E9.avi,1609,52,2338,38,729,2
0X698EF3292D6654DF.avi,1026,102,1567,84,541,2
0X6992115DA901A8A0.avi,1471,79,1798,62,327,2
0X699258A27B9C763D.avi,750,116,1125,105,375,2
0X699E3846EC61235F.avi,1328,57,2195,43,867,2
0X699F48578122088.avi,844,76,1335,62,491,2
0X69A32C8856DC6879.avi,936,122,1419,107,483,2
0X69A37D716D3C1EE2.avi,794,53,1172,37,378,2
0X69A6D0FAEBA50027.avi,952,131,1390,112,438,2
0X69A75DB4A1B8CA28.avi,1113,43,1380,32,267,2
0X69AAEA04AAA0FB9D.avi,1086,122,1640,106,554,2
0X69AC0873700811D2.avi,1040,94,1647,78,607,2
0X69AE1D1111FCFA43.avi,1743,220,2199,203,456,2
0X69B0AC9B48CD793E.avi,988,73,1584,55,596,2
0X69B260632B8BF48A.avi,1252,65,1971,48,719,2
0X69B8866270E7BC77.avi,1129,51,1670,38,541,2
0X69B8DBAA13F1442B.avi,1449,54,1932,38,483,2
0X69C0A8E401963AD7.avi,972,156,1635,141,663,2
0X69C213A7E1B58743.avi,1676,112,2927,94,1251,2
0X69C3D72C750DC976.avi,908,58,1722,41,814,2
0X69C480D704708196.avi,1032,13,1258,6,226,2
0X69C62909E64A686D.avi,1330,18,2408,0,1078,2
0X69C718B691DF9F1.avi,976,15,1345,0,369,2
0X69C8AC872A3C32AC.avi,932,15,1387,0,455,2
0X69CAB2A980A78FCB.avi,1583,100,2258,84,675,2
0X69D4523966BC4AA8.avi,2328,18,2767,3,439,2
0X69D93F969C2F74F8.avi,2296,139,2663,118,367,2
0X69D9E8315AEF4578.avi,1794,51,2371,32,577,2
0X69DB3D6458D62410.avi,1120,72,1988,59,868,2
0X69DBE98550479217.avi,1539,18,2518,0,979,2
0X69E3C8EB6D834974.avi,1247,66,2120,50,873,2
0X69E429AEBAAEC0BD.avi,997,137,1290,122,293,2
0X69E48066CC72C3A1.avi,1195,64,2069,46,874,2
0X69EA4A8D900C9F7.avi,941,77,1519,59,578,2
0X69EC4C1F3A5C6786.avi,882,91,1321,77,439,2
0X69F29FDEF96252D8.avi,1265,67,1990,52,725,2
0X69F2D313767C34A9.avi,1227,64,1973,49,746,2
0X69F424E89D494967.avi,1180,175,2009,154,829,2
0X69F7556A5A45A5EE.avi,734,46,1244,39,510,2
0X69F8CA8E52A2E4E7.avi,1143,52,1890,32,747,2
0X69F9014343EC83B3.avi,1184,59,1610,37,426,2
0X69FC87BF17A55F65.avi,996,106,1765,93,769,2
0X69FD55350C07087B.avi,905,98,1355,79,450,2
0X69FF17A94F18585A.avi,1543,134,2225,124,682,2
0X69FF2B134E1DF1B1.avi,2470,47,3896,59,1426,2
0X69FFCA63BE0569EF.avi,1264,173,1959,153,695,2
0X6A028337AD76ADD0.avi,1009,118,1709,103,700,2
0X6A048AD1DAAA1AB0.avi,1069,82,1740,64,671,2
0X6A057FCAB5C853DE.avi,718,42,1381,30,663,2
0X6A0657D211ADDAFA.avi,1397,65,2173,47,776,2
0X6A0C365DCBCF2BC0.avi,1142,59,1815,41,673,2
0X6A0E0C2096A56020.avi,1074,83,1718,69,644,2
0X6A11E31F14ADFDEE.avi,1581,104,2306,89,725,2
0X6A13F71998AA06CA.avi,870,52,1408,30,538,2
0X6A1761B3A21AF4F2.avi,1363,72,2298,57,935,2
0X6A17807E5BD87FA9.avi,1199,99,1843,78,644,2
0X6A1AA81E9712AAFF.avi,877,84,1322,72,445,2
0X6A1B56577EBFA488.avi,1160,155,1858,140,698,2
0X6A272C995486CF4B.avi,1011,134,1704,111,693,2
0X6A2B51F5E42AAFF1.avi,867,18,1352,2,485,2
0X6A306DFCAE00CABC.avi,1022,87,1692,77,670,2
0X6A312BF878BA093F.avi,1480,70,2429,56,949,2
0X6A345FD250E04AE0.avi,1497,45,1880,30,383,2
0X6A359AD1490E6F4.avi,819,83,1210,69,391,2
0X6A38F525525AABEF.avi,1063,66,1680,50,617,2
0X6A3EE162DF19062F.avi,1402,53,2200,36,798,2
0X6A403037B3DF0127.avi,1029,92,1748,74,719,2
0X6A40752EF8FB5AB2.avi,932,97,1525,78,593,2
0X6A45FBB2F8991E0E.avi,1622,96,2253,77,631,2
0X6A46321A41C98FC7.avi,1331,9,1641,0,310,2
0X6A517CFB3CC37E24.avi,771,71,1265,61,494,2
0X6A5374D97C7E9202.avi,821,115,1295,102,474,2
0X6A56B3B7CF5AC64E.avi,1825,52,2265,37,440,2
0X6A57513F8621F814.avi,1233,49,2131,34,898,2
0X6A59ABB6D7C8F0BA.avi,1285,135,1776,112,491,2
0X6A5AA7CA64C74AC1.avi,2171,121,3396,101,1225,2
0X6A6422046F7969F2.avi,1266,170,1804,150,538,2
0X6A66AAE9B2D3C42C.avi,1097,62,1757,47,660,2
0X6A672DABBE9F8660.avi,1038,90,1685,73,647,2
0X6A815B26E4D6AFC3.avi,981,19,1596,2,615,2
0X6A86E26CF3DBBB34.avi,1614,144,2139,126,525,2
0X6A878BE2BE37679E.avi,807,114,1295,96,488,2
0X6A8AA36725720569.avi,1296,11,1794,2,498,2
0X6A9103398B308FE3.avi,1471,73,2169,55,698,2
0X6A91B83DDA5ED01.avi,819,47,1339,35,520,2
0X6A95031DBF74CF5E.avi,1170,46,1958,33,788,2
0X6A99F933F0F63900.avi,1332,54,2328,38,996,2
0X6AA21353DB219B2E.avi,1550,100,2531,83,981,2
0X6AA45821A706A75B.avi,860,19,1384,3,524,2
0X6AA4D34DB3D5F6CA.avi,1995,87,2991,78,996,2
0X6AA5302902FB3B83.avi,1385,53,1718,35,333,2
0X6AAE22F1E3985AD6.avi,1073,137,1264,120,191,2
0X6AAF124C7AD3E7E4.avi,1693,77,2368,57,675,2
0X6AB2016D376D7783.avi,1408,77,2348,57,940,2
0X6AB214EB6B92DC02.avi,1433,64,2207,48,774,2
0X6AB2CF56234A13CC.avi,1550,25,2447,3,897,2
0X6ABAD097CBF31D41.avi,853,77,1280,55,427,2
0X6ABB8932C0471F4A.avi,1451,110,2345,95,894,2
0X6AC075B8CAE1D6EF.avi,1154,76,1939,55,785,2
0X6AC11E656F4E93A3.avi,1326,109,1905,95,579,2
0X6AC5A4C46C17EDC0.avi,897,64,1515,44,618,2
0X6AC5DBD72B2B9C21.avi,940,84,1541,68,601,2
0X6ACAC4D295EF82BF.avi,1981,79,2404,51,423,2
0X6ACCE729AC05AB06.avi,1504,117,2209,98,705,2
0X6AD2C1663EF05305.avi,1077,64,1606,44,529,2
0X6AD577606BAF71F0.avi,1251,16,1539,0,288,2
0X6AD714938AE64D1B.avi,1182,89,1662,68,480,2
0X6ADA9C1585183871.avi,1303,101,2139,81,836,2
0X6ADC5D0D968E9E34.avi,993,18,1549,4,556,2
0X6AE2A159097AC945.avi,1428,86,1816,59,388,2
0X6AE3A2071303CF5.avi,1205,69,1811,50,606,2
0X6AE44761D3CEF95D.avi,995,64,1527,46,532,2
0X6AECECDB65A32BF.avi,1967,104,2348,89,381,2
0X6AEDF24703853E45.avi,1088,65,1662,46,574,2
0X6AEE34060EAF4A09.avi,1026,60,1699,41,673,2
0X6AF3B88FF98DE62F.avi,1344,62,2037,46,693,2
0X6AF702536B894D22.avi,1870,56,2434,40,564,2
0X6AF72AAF6B829695.avi,1435,138,2486,125,1051,2
0X6AF8B5ACB5A3A683.avi,845,65,1462,49,617,2
0X6AFAD37CC4FF9AD9.avi,1603,19,2490,3,887,2
0X6AFD6474F2A92942.avi,1161,90,1802,83,641,2
0X6B0A6A101C2DA474.avi,1697,66,2318,47,621,2
0X6B0DFC83DD945692.avi,1109,81,1695,62,586,2
0X6B11525181625135.avi,901,14,1437,3,536,2
0X6B11CABFF1156096.avi,1309,132,1889,114,580,2
0X6B1DB923FB0B3D34.avi,844,62,1523,45,679,2
0X6B1E22AC8DA7DC1B.avi,1639,53,2708,39,1069,2
0X6B1F4CDE430CF543.avi,2721,122,3357,108,636,2
0X6B23E32A7A8721AE.avi,925,94,1419,77,494,2
0X6B27953A008A7289.avi,619,50,849,36,230,2
0X6B2D065F4C186816.avi,813,57,1384,41,571,2
0X6B2DF895741FC467.avi,1908,79,2694,62,786,2
0X6B2EFC4E87D3174B.avi,1589,92,2499,76,910,2
0X6B2FE7C32EE5CCFF.avi,1780,89,2704,72,924,2
0X6B339B82A5BC31E3.avi,1351,80,2079,66,728,2
0X6B38A2D99D5A9A86.avi,821,66,1324,53,503,2
0X6B3A89FD473A9830.avi,1778,74,2423,53,645,2
0X6B3B9DBE3492A37A.avi,640,98,971,82,331,2
0X6B40061914A0E9A2.avi,859,209,1231,190,372,2
0X6B462232B332BB81.avi,1073,120,1875,100,802,2
0X6B4A75FD6BC165AC.avi,1751,76,2545,53,794,2
0X6B4C80EEEEE6191D.avi,1041,17,1493,5,452,2
0X6B4CCBC68946C0C9.avi,1203,99,1697,79,494,2
0X6B4FFBA68707FA0E.avi,1125,122,1898,110,773,2
0X6B5A0E853A0A1C2F.avi,1528,132,2263,163,735,2
0X6B5BCB03E1D68359.avi,1433,70,2343,51,910,2
0X6B61269F34260EB7.avi,946,53,1570,39,624,2
0X6B65849509F23240.avi,1854,183,2646,163,792,2
0X6B6CE145549C8D00.avi,2083,48,2975,35,892,2
0X6B6F3EC5EF795B2.avi,828,82,1297,60,469,2
0X6B7033724FFD6F8F.avi,1215,91,1801,71,586,2
0X6B795206FC9812.avi,1332,70,2029,52,697,2
0X6B79A0A18B813FF2.avi,960,74,1675,53,715,2
0X6B847242732C2FD4.avi,2149,118,3243,91,1094,2
0X6B84D4354376CA3F.avi,871,41,1353,30,482,2
0X6B852E31BFC8D585.avi,2725,59,3132,43,407,2
0X6B8CAD148A81CBB1.avi,1111,79,1748,67,637,2
0X6B944AB275F93DEF.avi,1628,111,2060,93,432,2
0X6B9AC2C41A07C9AD.avi,1066,97,1614,85,548,2
0X6B9AD5750DEB23A6.avi,1242,68,2277,57,1035,2
0X6B9BD7183EE0233C.avi,896,59,1640,43,744,2
0X6BA0C1F6396FBEA1.avi,1107,80,1773,60,666,2
0X6BA126FDC669D53C.avi,1804,20,2154,1,350,2
0X6BA1F9C41B2F3F5D.avi,999,87,1706,73,707,2
0X6BA7CB2E44532208.avi,1106,19,1730,1,624,2
0X6BAE140DBD757831.avi,2050,38,2542,26,492,2
0X6BAE7A563B2DD386.avi,712,66,1087,51,375,2
0X6BAEE8E7A0B91927.avi,1315,118,1580,103,265,2
0X6BB43007F6D02580.avi,791,64,1200,49,409,2
0X6BB45EC1521D9905.avi,633,11,1029,3,396,2
0X6BB6FA41CE7DAC0A.avi,1044,68,1528,51,484,2
0X6BB792FB95F3E857.avi,661,66,1046,50,385,2
0X6BB8FC06EB041453.avi,886,48,1611,36,725,2
0X6BBADD595AFAC303.avi,1037,70,1759,50,722,2
0X6BBC4723F3165464.avi,1188,138,1880,120,692,2
0X6BBD548654D21A11.avi,1029,69,1809,54,780,2
0X6BC02B386AAEC4CF.avi,1010,90,1544,79,534,2
0X6BC0B15E4B0FA423.avi,1165,62,1900,45,735,2
0X6BCB3492D214A026.avi,813,54,1121,38,308,2
0X6BCD517148A647B3.avi,1301,52,2282,34,981,2
0X6BCFA12367018AA4.avi,1828,158,2345,138,517,2
0X6BD2B2D475E661ED.avi,1007,57,1562,39,555,2
0X6BD400324E98B517.avi,969,128,1561,118,592,2
0X6BD647AB22EFCD94.avi,926,58,1594,40,668,2
0X6BDA434694AF0673.avi,1221,121,1992,107,771,2
0X6BE01E7D45855CA0.avi,1560,56,2049,36,489,2
0X6BE1E54E59745D35.avi,1424,148,2239,130,815,2
0X6BE62DA9E887AC67.avi,1557,76,2216,58,659,2
0X6BE91CF2978A1FEC.avi,949,100,1386,78,437,2
0X6BEA2DC58CE6450E.avi,3616,98,4218,85,602,2
0X6BEA70A342F82F3A.avi,1647,137,2456,123,809,2
0X6BEF1A4315F47874.avi,1625,63,2446,45,821,2
0X6BF29A819EEFB22E.avi,817,56,1404,38,587,2
0X6BF32F3C69A2D30F.avi,1145,51,1938,38,793,2
0X6BF4AAB4262F8FB.avi,1061,47,1273,35,212,2
0X6BF648EA45DB6EC2.avi,868,81,1338,63,470,2
0X6BFB095DFDB65B76.avi,1715,76,2021,55,306,2
0X6C0DE6F4A3F8EFA2.avi,1008,60,1542,44,534,2
0X6C124671AA84BFE1.avi,913,90,1321,112,408,2
0X6C16E130ABB2C0E0.avi,720,46,1165,31,445,2
0X6C1D818071AF7631.avi,1051,54,1460,38,409,2
0X6C2063707735D95A.avi,840,103,1268,83,428,2
0X6C27151F964430AB.avi,1509,121,1921,104,412,2
0X6C27302CA6B46DDD.avi,1333,96,2247,79,914,2
0X6C324F34DB86F19F.avi,861,120,1526,104,665,2
0X6C355568312FC87.avi,1507,95,2352,81,845,2
0X6C3C503CF8149861.avi,1558,65,2413,44,855,2
0X6C3D4D23B03718DD.avi,926,99,1430,85,504,2
0X6C3F001BAD38760.avi,1935,77,3173,57,1238,2
0X6C44C62622B476DC.avi,1622,105,2105,82,483,2
0X6C47FA29EAF6395.avi,977,60,1437,44,460,2
0X6C4C18C40E312836.avi,829,53,1395,40,566,2
0X6C4EE7DD884416AD.avi,1300,85,1982,73,682,2
0X6C5335E45E2F052C.avi,510,100,816,88,306,2
0X6C547E1353778F5C.avi,1124,70,1767,49,643,2
0X6C56FD0ECEF3C539.avi,1762,78,2675,57,913,2
0X6C5861D9F2B5EFF5.avi,1361,72,2195,55,834,2
0X6C5E836554770576.avi,1865,53,2485,28,620,2
0X6C626BE4E38EF658.avi,1289,70,1973,52,684,2
0X6C64E0A64888EDBD.avi,1082,76,1994,61,912,2
0X6C64F98CFB71222C.avi,1038,85,1632,67,594,2
0X6C6533842D5D2E66.avi,1415,91,1619,69,204,2
0X6C68456E30B1AE43.avi,1547,90,2613,73,1066,2
0X6C6C283053A8DC92.avi,1533,133,2296,110,763,2
0X6C6C7F4259045DFA.avi,725,68,1136,46,411,2
0X6C6ED89AB6CF2534.avi,1993,53,2638,39,645,2
0X6C6FE0CFFBEAD9C0.avi,1312,102,1935,83,623,2
0X6C7593CD60599D1B.avi,807,72,1311,57,504,2
0X6C78731607FD7813.avi,1270,46,1810,31,540,2
0X6C7CDB2B104302C.avi,1271,64,2020,46,749,2
0X6C7E27C5175E011D.avi,1390,16,2398,2,1008,2
0X6C7E4F3AAF2573E4.avi,1209,66,1501,48,292,2
0X6C81D8D4564D664D.avi,1713,60,1932,43,219,2
0X6C8252A775A3B208.avi,858,93,1364,79,506,2
0X6C845B75CC6E143C.avi,1846,78,2312,114,466,2
0X6C8542DC18BC5C98.avi,1403,73,1693,56,290,2
0X6C85931BDC207466.avi,1021,14,1660,2,639,2
0X6C86F862C0C2228F.avi,1500,13,1796,0,296,2
0X6C8C6BC50274E94B.avi,1007,51,1824,37,817,2
0X6C8CB4F82AF7B5A8.avi,829,59,1172,45,343,2
0X6C8F08AB5C918755.avi,1797,17,3027,1,1230,2
0X6C8F8AAA4F2DE9D2.avi,2305,65,2833,48,528,2
0X6C8FB4DE38C55D2D.avi,732,51,1101,35,369,2
0X6C9061C7323ED87F.avi,778,68,1230,48,452,2
0X6C907D7A293A0CA9.avi,1513,75,1674,61,161,2
0X6C932939993E9192.avi,1060,92,1726,70,666,2
0X6C94E0DE1DEA337F.avi,1821,163,2567,146,746,2
0X6C96589B41EBA3C5.avi,1341,144,1722,124,381,2
0X6C96E0DD4D10C326.avi,968,56,1727,38,759,2
0X6C99385E5A518B19.avi,967,91,1648,75,681,2
0X6CA28B9E9EEFF603.avi,2379,57,2813,38,434,2
0X6CA2B6C0070FF76.avi,1027,112,1565,91,538,2
0X6CA4C778D83B252F.avi,1209,61,1690,48,481,2
0X6CA712DE9D936CB3.avi,1864,88,2638,72,774,2
0X6CA7BA30601E7B44.avi,1437,158,2327,142,890,2
0X6CABFFD99D718350.avi,841,99,1256,85,415,2
0X6CAC8D1727509CDC.avi,1249,175,1715,158,466,2
0X6CAFD90BF9854990.avi,824,103,1472,91,648,2
0X6CB652160FFC36B7.avi,1477,152,2028,137,551,2
0X6CB6C78C1078D1A2.avi,1965,59,3194,39,1229,2
0X6CB8A5B0526602.avi,1035,63,1586,46,551,2
0X6CBEFE70A7A9BBF9.avi,2091,13,2654,4,563,2
0X6CC0AFACCC801E35.avi,2999,104,3288,87,289,2
0X6CC0DF8BF6E553D8.avi,1597,51,2568,36,971,2
0X6CC547A27A1CBE03.avi,910,53,1650,39,740,2
0X6CC8195E8ADDBFE1.avi,1031,110,1616,95,585,2
0X6CCA2353460A1836.avi,1133,69,1695,46,562,2
0X6CCFED529BAD08F8.avi,982,58,1543,44,561,2
0X6CD095A9ED1F1D82.avi,987,64,1499,54,512,2
0X6CD225131815C9B3.avi,1291,106,1896,87,605,2
0X6CD440699E013143.avi,2271,86,3317,70,1046,2
0X6CDF31281C0E6994.avi,1184,130,1550,118,366,2
0X6CE3898CCC0AAC59.avi,1542,100,2455,82,913,2
0X6CE8ED382B1D0373.avi,1117,58,2024,44,907,2
0X6CEBD0FFB29FC4FF.avi,1059,108,1783,87,724,2
0X6CECFF524B3C750F.avi,2431,19,3418,2,987,2
0X6CEF1BA255C5E6F3.avi,1415,65,2186,49,771,2
0X6CF243481B013517.avi,2194,102,2614,87,420,2
0X6CF68B1A2BD187CC.avi,1284,131,2381,117,1097,2
0X6CF8F05F9BED6F35.avi,1256,80,1887,58,631,2
0X6CFA2353220A32C3.avi,1038,68,1607,52,569,2
0X6D0315D05748849F.avi,1101,177,1686,160,585,2
0X6D06CFF7DED256F.avi,1825,67,2122,48,297,2
0X6D07CDCEA188473E.avi,1573,50,2350,36,777,2
0X6D0CFFC3949FBFD4.avi,895,17,1317,3,422,2
0X6D0D293319783A87.avi,1012,152,1695,140,683,2
0X6D1D0BE838BFC520.avi,1081,42,1809,30,728,2
0X6D1D29802905D6E0.avi,1696,71,2362,55,666,2
0X6D218D2DC031979F.avi,1874,153,3126,120,1252,2
0X6D239F747F460F.avi,3077,65,3589,45,512,2
0X6D3A000B61658ABB.avi,1471,68,2574,52,1103,2
0X6D3B3F63E5A98B19.avi,2769,44,3060,28,291,2
0X6D3D61BF45F96B11.avi,866,80,1226,62,360,2
0X6D3DA909443B39FF.avi,1148,17,1817,2,669,2
0X6D48137E0CF883E3.avi,2312,57,2685,42,373,2
0X6D48C70F773FD316.avi,1734,22,2367,2,633,2
0X6D49B9C90A557BF2.avi,2170,80,2973,58,803,2
0X6D4A0B79F875979F.avi,769,87,1244,68,475,2
0X6D4A77DC8CD88E9A.avi,1424,100,1721,83,297,2
0X6D4AB086ADFF664B.avi,1321,114,1845,92,524,2
0X6D4AE6195D85472B.avi,1936,54,2424,40,488,2
0X6D4E2F9ACA8A1563.avi,1047,59,1669,46,622,2
0X6D53A880A0B92B8D.avi,889,131,1597,114,708,2
0X6D53B5EAD55FAE88.avi,1060,47,1593,34,533,2
0X6D53E8439BFC46D9.avi,869,83,1328,68,459,2
0X6D55B39BC5165D15.avi,1304,125,2218,103,914,2
0X6D55F9F3E6A2707A.avi,926,77,1442,58,516,2
0X6D5701FED374216.avi,640,47,995,33,355,2
0X6D58693714718A15.avi,1184,94,1552,78,368,2
0X6D600D764AD2D7A9.avi,1612,68,2078,48,466,2
0X6D606F9D4AEC7257.avi,1174,73,1783,58,609,2
0X6D6388FC639CDA09.avi,1362,96,2211,82,849,2
0X6D63B455802BB05F.avi,1236,112,1783,92,547,2
0X6D643C5F5E40EF68.avi,957,49,1235,38,278,2
0X6D65F149D5EB3913.avi,928,98,1434,81,506,2
0X6D691277EEE275F2.avi,1021,103,1533,89,512,2
0X6D6B651AC1031C7.avi,1872,49,2141,36,269,2
0X6D6BF76192EEFF36.avi,1124,60,1620,40,496,2
0X6D6FFE8C3D708E08.avi,1063,63,1827,47,764,2
0X6D71DFFA4EE9C227.avi,1620,22,2506,4,886,2
0X6D72498C03D60D6B.avi,1230,130,1854,114,624,2
0X6D726D55FBF7CACD.avi,1952,118,3516,100,1564,2
0X6D72FA2CA90F4C15.avi,1131,76,1823,59,692,2
0X6D74371D1009C455.avi,1301,48,1637,33,336,2
0X6D7766F51CCDE3D7.avi,1329,72,2141,53,812,2
0X6D7889E5615FCFD4.avi,851,111,1400,98,549,2
0X6D78CCCD9680F137.avi,1378,85,2443,67,1065,2
0X6D7DDE6E9744DAC6.avi,809,105,1349,85,540,2
0X6D81C99AA35EEE47.avi,1161,151,1825,135,664,2
0X6D821F822F67B02A.avi,1270,118,2150,102,880,2
0X6D872CF7C744613E.avi,1180,76,1404,54,224,2
0X6D8C2E4FF14F1B01.avi,750,69,1049,59,299,2
0X6D8D7994A2AC5FCE.avi,807,133,1365,120,558,2
0X6D90906933A86358.avi,1348,99,2355,86,1007,2
0X6D90FEC0CDD49DC4.avi,1563,59,2231,43,668,2
0X6D917AB5FBFE3EDE.avi,1068,65,1826,54,758,2
0X6D92F22E42697C65.avi,3284,118,3328,137,44,2
0X6D95CD13FD8931F2.avi,1606,58,2634,43,1028,2
0X6D9723FC15CFEE85.avi,1390,167,1629,153,239,2
0X6D9E057CAE4BC5E0.avi,947,57,1466,44,519,2
0X6D9E5AB91D96CCE1.avi,1877,18,3229,3,1352,2
0X6DA50442706CA23D.avi,1511,70,1878,53,367,2
0X6DA6BCE4A78DB2FE.avi,1489,118,1682,100,193,2
0X6DA6FDFFA83994BB.avi,956,163,1487,143,531,2
0X6DA7A894DA307F59.avi,1230,122,2038,97,808,2
0X6DB14C93EAECA9A7.avi,813,64,1414,46,601,2
0X6DB22253FD5BBF94.avi,655,50,1005,34,350,2
0X6DB3B5B497DB6EA0.avi,1501,129,2583,113,1082,2
0X6DB4F287069B038D.avi,1846,70,2303,50,457,2
0X6DB563A9A177BD82.avi,935,98,1311,76,376,2
0X6DB58A74F7F0CBDB.avi,1235,130,1955,110,720,2
0X6DB5BC6BF960267F.avi,947,203,1415,191,468,2
0X6DB94B6B809039C7.avi,1629,118,2615,105,986,2
0X6DBC9C8C7CCBE6E2.avi,2234,120,2765,100,531,2
0X6DC13ED618770C6B.avi,1010,19,1564,2,554,2
0X6DC399F2BCE4AB7D.avi,994,57,1536,39,542,2
0X6DC4325C689CEEDD.avi,1271,22,2099,42,828,2
0X6DC4D4E665CE25B2.avi,585,99,793,86,208,2
0X6DC72E2A34A6DFE8.avi,1400,141,2495,122,1095,2
0X6DCAB3CD5A485D45.avi,1353,54,1965,37,612,2
0X6DD554CE5A1AE1B0.avi,1495,121,2141,101,646,2
0X6DD62111845E1B9.avi,1049,57,1613,39,564,2
0X6DDC0986DF75DB0C.avi,899,110,1291,90,392,2
0X6DDD5B0B4132C787.avi,1893,68,2788,50,895,2
0X6DE38BD6E3584D03.avi,1015,57,1519,44,504,2
0X6DE5DB58AD2E5577.avi,1258,125,1951,106,693,2
0X6DE7AC1795267BA3.avi,1288,60,1817,42,529,2
0X6DEB4032EBB054D9.avi,2060,96,2883,75,823,2
0X6DED7FDA8466BE6E.avi,891,110,1349,94,458,2
0X6DEDE4AA3CB872F1.avi,1415,20,2141,3,726,2
0X6DF0EE20A24FEF6A.avi,907,19,1164,2,257,2
0X6DF39A52E4048FF2.avi,1153,96,1757,85,604,2
0X6DF8E050FC840A8.avi,1183,106,1646,89,463,2
0X6DFE8F195ACC3BA4.avi,1747,118,2159,100,412,2
0X6E00BE74552DB3BA.avi,888,193,1349,173,461,2
0X6E00FB047E13A652.avi,975,159,1638,139,663,2
0X6E02E0F24F63EFD7.avi,632,64,1230,121,598,2
0X6E0708618C053CB8.avi,675,60,1111,43,436,2
0X6E0E4A558108BADA.avi,1030,96,1686,83,656,2
0X6E100C2D4D73F059.avi,2355,50,3698,38,1343,2
0X6E1145D1BA43B81F.avi,1178,59,1852,43,674,2
0X6E12C7DFC47BCD1E.avi,928,54,1544,42,616,2
0X6E1AB156B897F2B0.avi,954,117,1434,101,480,2
0X6E1C89A39A9DA038.avi,731,116,1118,101,387,2
0X6E1F0B0B5831B801.avi,1599,60,2310,43,711,2
0X6E1F571E0D834439.avi,1302,59,2021,41,719,2
0X6E1FF3606FD2148A.avi,1221,128,2180,110,959,2
0X6E212B8A73CA04DD.avi,966,52,1444,41,478,2
0X6E22CC57F5A62028.avi,952,151,1456,142,504,2
0X6E26C6F3CA75C699.avi,1627,11,2399,0,772,2
0X6E27B3EF3A104896.avi,1781,63,2391,45,610,2
0X6E2E069FDC35F8FA.avi,1205,79,2063,60,858,2
0X6E2E13E4D12ADBC5.avi,979,63,1585,45,606,2
0X6E309D9AB2B43C7E.avi,1692,51,2102,34,410,2
0X6E372FE5021EB443.avi,1019,101,1723,89,704,2
0X6E379A4025B0D43C.avi,1122,57,1852,45,730,2
0X6E3FBD73AE2685F.avi,1047,105,1555,94,508,2
0X6E4159BB40A86E64.avi,744,126,1191,113,447,2
0X6E443F7042370B42.avi,1173,46,1864,33,691,2
0X6E46A32DFF7E9E62.avi,2881,57,5361,42,2480,2
0X6E48AED3DA25731A.avi,897,104,1429,88,532,2
0X6E4B03FAE5E345CA.avi,1464,111,2347,86,883,2
0X6E4CCA9792ADED75.avi,1171,79,1849,67,678,2
0X6E4EB029042DD9D9.avi,1858,187,2757,163,899,2
0X6E54EDA664E18F4A.avi,851,53,1409,36,558,2
0X6E57B3FDE0D9C92.avi,1402,91,1762,73,360,2
0X6E5824E76BEB3ECA.avi,1380,16,2149,78,769,2
0X6E58C38FE9BC5E5E.avi,977,88,1393,76,416,2
0X6E59D3D82A2E3357.avi,1111,61,1657,44,546,2
0X6E5C224987C8E830.avi,1229,67,2024,51,795,2
0X6E5CF1D1178DF20B.avi,898,84,1555,73,657,2
0X6E5FD447C07DFA5.avi,950,58,1528,42,578,2
0X6E6024E7AF5E6B15.avi,1040,125,1300,115,260,2
0X6E60A779DF3494E3.avi,1236,86,1713,67,477,2
0X6E6108E3D0E8983C.avi,1089,130,1818,111,729,2
0X6E63D1AE66B1DFF4.avi,1131,86,2026,69,895,2
0X6E6B700BBFFFD2D6.avi,1304,68,2312,51,1008,2
0X6E6C739C44829062.avi,1196,53,1489,39,293,2
0X6E6C9C85DEA40694.avi,1025,62,1803,46,778,2
0X6E6FB1DA53C8351.avi,960,19,1501,4,541,2
0X6E7132ABF64DB8BE.avi,1020,114,1470,95,450,2
0X6E765BA3B1865957.avi,1311,74,2206,55,895,2
0X6E7E20A098A0C7A2.avi,1160,63,1955,47,795,2
0X6E8033C53E37D4D0.avi,1123,120,1886,103,763,2
0X6E811944559EDC3F.avi,1014,93,1348,72,334,2
0X6E88964C832AB9E4.avi,2043,122,2490,106,447,2
0X6E9C31795E54A821.avi,1735,84,2669,66,934,2
0X6E9F4870B113C2C6.avi,1124,16,1646,0,522,2
0X6E9F5C6EB262E26A.avi,1035,50,1183,34,148,2
0X6EA93533C06E1E1B.avi,1506,46,2774,33,1268,2
0X6EA93E2EBB466F3A.avi,1253,60,2016,45,763,2
0X6EA9E49ABF8EFEE1.avi,1762,59,2179,42,417,2
0X6EAED583DBF1F916.avi,796,61,1058,45,262,2
0X6EB436F0D1B7CE84.avi,1612,27,2025,5,413,2
0X6EB95ADCC03B7B3C.avi,1308,121,2173,100,865,2
0X6EBA417515E62FD5.avi,981,98,1738,84,757,2
0X6EBCC08A401F9B5B.avi,1127,64,1838,44,711,2
0X6EC16E49F1C9337C.avi,749,61,1305,46,556,2
0X6EC20DDF9804A94E.avi,1623,60,2099,41,476,2
0X6EC3018E83F6DC05.avi,913,73,1523,55,610,2
0X6EC9433198E4B6EE.avi,991,112,1559,100,568,2
0X6ECDA48CE778B00A.avi,634,91,1027,80,393,2
0X6ECDFA5069831090.avi,1599,13,1861,3,262,2
0X6ED5C7B1BB4E2BB6.avi,1511,18,2211,3,700,2
0X6EDD9E4450E09630.avi,873,90,1313,77,440,2
0X6EDF5FFA911E093E.avi,1581,78,2664,59,1083,2
0X6EE0A841475D41E8.avi,1774,78,2235,58,461,2
0X6EE748ED071E4598.avi,753,63,1324,49,571,2
0X6EE923F8B9F82820.avi,1277,252,1979,225,702,2
0X6EEC06B1FBB5BB16.avi,1405,138,1723,115,318,2
0X6EEC24E41B261C6F.avi,1350,61,2104,44,754,2
0X6EEDB606DA0C8EDE.avi,1465,113,2307,96,842,2
0X6EEFDA0A9F0144FF.avi,1186,50,1772,37,586,2
0X6EF41C2BBBAA83EF.avi,1382,54,2250,40,868,2
0X6EF44A176770ADBA.avi,1045,46,1785,34,740,2
0X6EF6260B0E6665D0.avi,1157,142,1725,126,568,2
0X6EF63902D4BD8E89.avi,1111,112,1769,96,658,2
0X6EFD8278BC9B7522.avi,1407,148,2420,129,1013,2
0X6F00E1B88FF7F2B6.avi,1125,50,1790,34,665,2
0X6F0A5B2A3E3B11AB.avi,929,80,1466,63,537,2
0X6F0D9D384C0A3EBD.avi,1240,54,1938,37,698,2
0X6F11EDE37AC0CF42.avi,1721,53,3169,39,1448,2
0X6F126C1C6883BA56.avi,1368,172,2431,155,1063,2
0X6F13E57513BEFA0.avi,1154,98,1878,83,724,2
0X6F16B7AB9191A5E5.avi,1593,60,2585,43,992,2
0X6F1A76C8595E054A.avi,969,86,1551,66,582,2
0X6F1C009FD8963620.avi,1010,65,1608,52,598,2
0X6F1EA03DBB298142.avi,2240,62,3797,48,1557,2
0X6F2B6B1280773A8.avi,1575,103,2485,84,910,2
0X6F2C4C1B7A791CB9.avi,1475,64,2197,46,722,2
0X6F3232FD37FD13C5.avi,800,14,1410,0,610,2
0X6F376F31663F3E61.avi,1749,46,2687,31,938,2
0X6F38AF03CE1A24E2.avi,1347,63,1956,46,609,2
0X6F3A6E1B710C13D1.avi,676,75,1132,63,456,2
0X6F3E6EC0B32CBB66.avi,747,58,1213,42,466,2
0X6F44A51223E9F1E.avi,681,59,970,41,289,2
0X6F489746D4866AAC.avi,871,60,1177,44,306,2
0X6F4E16CE27A18A6E.avi,1288,64,2250,46,962,2
0X6F4F950A5396343A.avi,876,41,1266,29,390,2
0X6F515874049619B1.avi,1666,111,2122,90,456,2
0X6F53D60A3AECC9.avi,1009,59,1428,45,419,2
0X6F57F1A540CA8629.avi,1455,63,2267,45,812,2
0X6F5932D336F6CB12.avi,999,62,1309,44,310,2
0X6F59844503FFC8FB.avi,1001,120,1702,98,701,2
0X6F59F94EF318EF6F.avi,1802,129,3214,106,1412,2
0X6F5EB0942891DF30.avi,818,110,1251,97,433,2
0X6F62E9BEC35BDCF2.avi,2054,74,3047,53,993,2
0X6F684CDA94ECA62B.avi,826,50,1248,36,422,2
0X6F6DB4A07AA7BED2.avi,687,54,1186,40,499,2
0X6F6DBAC7292C3E36.avi,1473,23,2282,4,809,2
0X6F6EA16F5E3467AA.avi,803,118,1367,102,564,2
0X6F713E0BFAAF743B.avi,1390,102,2072,83,682,2
0X6F739801341A22F6.avi,2204,104,2870,89,666,2
0X6F7817E2F5DC217F.avi,1272,166,1914,154,642,2
0X6F7BF22A07F61BC8.avi,1342,79,2122,69,780,2
0X6F7F4362C857E0FC.avi,1701,45,2773,34,1072,2
0X6F81F5F5E980BF50.avi,1376,62,2016,49,640,2
0X6F8676CBA5E2571A.avi,1297,53,1903,38,606,2
0X6F89061323A89C46.avi,1029,46,1985,33,956,2
0X6F89F46E2350BAD3.avi,1032,81,1558,70,526,2
0X6F8CC942DF924170.avi,1675,78,2591,58,916,2
0X6F8D259324E0E9D0.avi,1005,112,1553,99,548,2
0X6F9AC7D6A33B3FBD.avi,735,70,1198,53,463,2
0X6F9C221EE2CE3A8B.avi,1734,96,2492,79,758,2
0X6F9E0DEF7A32E75E.avi,711,42,1125,28,414,2
0X6F9FD41E87A2BF22.avi,981,174,1724,147,743,2
0X6FA1794B8CBE3C04.avi,1477,90,2306,75,829,2
0X6FA8D7C2278B5073.avi,2069,31,2844,3,775,2
0X6FAA89F3C9D58522.avi,1261,55,1852,39,591,2
0X6FAB02B40464E30.avi,597,70,1030,51,433,2
0X6FAC8B9E8907EBF3.avi,1091,70,1687,44,596,2
0X6FAD9DF07824297B.avi,883,39,1515,22,632,2
0X6FADD66D9851B383.avi,876,69,1388,49,512,2
0X6FB192AE737A59F2.avi,1492,71,2230,55,738,2
0X6FB47E8BB8464F42.avi,952,51,1423,40,471,2
0X6FB59E8686C472A1.avi,988,94,1404,83,416,2
0X6FBA1BCD968A92CD.avi,2213,82,3718,58,1505,2
0X6FBEF41EB6975D30.avi,1378,71,2125,49,747,2
0X6FC112B490B34E0F.avi,1137,76,1901,58,764,2
0X6FC504B60333F621.avi,1702,107,2921,89,1219,2
0X6FC50A1C8B616D06.avi,1079,71,1694,53,615,2
0X6FC541ABB4081E98.avi,2589,83,2980,73,391,2
0X6FC8A2C44917FE58.avi,1078,47,1586,35,508,2
0X6FCB1BA18A58D7F2.avi,1435,51,2142,36,707,2
0X6FCDD9107094644A.avi,1213,62,1646,45,433,2
0X6FCE7C69AE34FBF7.avi,1008,89,1771,73,763,2
0X6FD03091458DAD1C.avi,2112,57,3683,41,1571,2
0X6FDBAFEA74C9BC7E.avi,578,95,1225,80,647,2
0X6FE03765A01F42BB.avi,1035,90,1463,78,428,2
0X6FE2B29A1FEB5D59.avi,1579,60,2398,43,819,2
0X6FE853660ADC4185.avi,1278,59,2024,45,746,2
0X6FEAD8540CA87C27.avi,925,92,1392,74,467,2
0X6FECBE1633D70BD1.avi,906,14,1421,4,515,2
0X6FF3977D7086E468.avi,2544,114,2981,100,437,2
0X6FF416B50E42532F.avi,864,83,1550,67,686,2
0X6FF709E2C5589D01.avi,1016,105,1775,86,759,2
0X6FF9A4411F2F8A34.avi,808,16,1334,3,526,2
0X7005CBA88A578C96.avi,1595,18,2279,0,684,2
0X700762E763698FC5.avi,938,68,1477,48,539,2
0X7009D23E3B00F78B.avi,1283,90,2298,72,1015,2
0X700A648C41DE6CFB.avi,1295,141,1817,121,522,2
0X700C7EFB75691A.avi,803,14,1154,1,351,2
0X7012247CA8314DC5.avi,1362,124,1977,108,615,2
0X7013EE30D524B6B0.avi,838,132,1184,113,346,2
0X701410DAEAC658EF.avi,1329,61,2190,43,861,2
0X7014D866DE2E617A.avi,970,80,1648,64,678,2
0X70190C8882ECDB13.avi,996,21,1478,4,482,2
0X7020667D86884D88.avi,981,141,1549,123,568,2
0X7023BDE81F8A00C0.avi,1179,14,1787,1,608,2
0X7026A611CB19B457.avi,898,96,1481,84,583,2
0X702756FBB896F42.avi,1769,171,2791,162,1022,2
0X70275A298A8CF5ED.avi,1554,23,1826,3,272,2
0X7027715D06DA15FD.avi,1221,16,1732,0,511,2
0X702A639A91967D29.avi,1080,67,1796,56,716,2
0X702D4E353E3B6A04.avi,1293,75,1804,61,511,2
0X702EF9BCE901DC90.avi,1135,73,1940,53,805,2
0X703273C4B5E6308B.avi,1324,16,1732,2,408,2
0X7032E1A414DEC083.avi,2802,86,3090,71,288,2
0X7034CDD3E709AC39.avi,840,43,1517,31,677,2
0X70351F9FD9444C30.avi,1162,62,1715,44,553,2
0X7036B875624A51E5.avi,813,96,1113,78,300,2
0X703774EFA4BCF502.avi,1287,61,2077,45,790,2
0X7044F4025752BCB6.avi,1191,52,1920,38,729,2
0X704845139A356532.avi,891,105,1462,87,571,2
0X7048F0997184EE82.avi,753,59,1216,45,463,2
0X705277E7D6EF6A7A.avi,1063,116,1655,104,592,2
0X7055E89AD38B36BC.avi,622,66,996,49,374,2
0X705789F6BD6B3A46.avi,1243,36,1612,23,369,2
0X705A3B3F265BFE44.avi,732,112,1167,95,435,2
0X705E3B9AFAB0574E.avi,1022,111,1682,95,660,2
0X705E75D6928EF51E.avi,1406,70,1648,56,242,2
0X7061256767FDFE90.avi,1321,64,2038,50,717,2
0X706610E923C8C8EF.avi,896,57,1427,40,531,2
0X706626FF3D23F7A.avi,1919,98,2721,81,802,2
0X706A53B9FE10409B.avi,996,138,1642,123,646,2
0X706B389AF6175FE4.avi,1070,109,1629,88,559,2
0X706C949699E80227.avi,1065,147,1529,132,464,2
0X70702683D6C909DB.avi,1084,70,1872,48,788,2
0X707B067AEDFAD712.avi,1777,88,2685,70,908,2
0X707C17FA96DF27D1.avi,1145,100,1873,85,728,2
0X7083497ECE270656.avi,1096,49,1480,35,384,2
0X70873D84AF6D4274.avi,2326,104,3516,87,1190,2
0X7087C253BDEAFDF9.avi,1104,56,1515,42,411,2
0X708AF5A9AE4F5DB1.avi,1807,55,2341,37,534,2
0X708BD14C8A32B53D.avi,1182,88,1839,75,657,2
0X708D0E99CDFD8420.avi,1096,64,1759,49,663,2
0X7093FB30EB363260.avi,1212,60,1904,46,692,2
0X709522F8FD4A92DF.avi,1998,93,2537,79,539,2
0X7097365FC2F8B218.avi,1481,47,2255,35,774,2
0X709A3DD7C31252F3.avi,887,150,1578,135,691,2
0X70A2BC92934984FF.avi,1094,65,1693,52,599,2
0X70A5167D3A618D63.avi,973,66,1434,50,461,2
0X70A99B2DE372C268.avi,1088,65,1835,46,747,2
0X70AA5048370C9DC2.avi,1743,67,3136,52,1393,2
0X70AB615C12541CA8.avi,1258,112,1645,97,387,2
0X70ACF2035FC035DE.avi,899,92,1326,74,427,2
0X70ADF1B72CC150A9.avi,1563,96,2662,76,1099,2
0X70AE1E2408B80316.avi,1602,66,2888,45,1286,2
0X70B2BF6C41F06457.avi,1317,61,1792,48,475,2
0X70B49CEB13611B36.avi,1320,63,2047,43,727,2
0X70B8D6F5238FAFCF.avi,830,136,1334,114,504,2
0X70BD7DAF007680A6.avi,1208,117,1899,105,691,2
0X70BE977A39DCF1C6.avi,1788,101,2812,85,1024,2
0X70C4138A90A72155.avi,1145,117,1866,100,721,2
0X70C42F855DC5568E.avi,1574,56,2233,41,659,2
0X70C62920786CE4C2.avi,1606,75,2627,54,1021,2
0X70C6ED8487CEA4F6.avi,887,64,1385,47,498,2
0X70C72825311E1EE.avi,1168,153,1637,134,469,2
0X70C7E7E952C28C1.avi,1790,61,2144,45,354,2
0X70C7EBC3408A81DD.avi,1109,58,1668,42,559,2
0X70C80E8613294FE6.avi,1199,249,1865,217,666,2
0X70CDA916837C0563.avi,1640,85,2990,66,1350,2
0X70E038A53FD778FE.avi,1052,66,1596,50,544,2
0X70E1AE6BC18EE77C.avi,1004,16,1544,4,540,2
0X70E2AFD806E85866.avi,617,66,1098,50,481,2
0X70EF20826840207B.avi,1018,93,1670,76,652,2
0X70F08157D6C11C06.avi,1238,68,1811,52,573,2
0X70F0F3896BAA0A92.avi,997,21,1469,6,472,2
0X70F4F530DB582570.avi,1075,82,1719,65,644,2
0X70F82461E9DA9509.avi,1780,73,2324,53,544,2
0X70FC196E362DA53.avi,1483,12,2428,0,945,2
0X70FEA4410C358456.avi,2163,115,2484,93,321,2
0X7101796E23DB2C6C.avi,1543,61,2489,48,946,2
0X7102D17A09373238.avi,955,55,1651,37,696,2
0X71087954DB99E5FB.avi,1056,80,1765,64,709,2
0X710AB66715EBDE2E.avi,678,83,1060,69,382,2
0X710BC7A746C16F30.avi,1538,96,1781,84,243,2
0X710CEE694461AA2E.avi,866,55,1462,39,596,2
0X710EC36F325037EE.avi,689,90,1020,78,331,2
0X7111782DEA339319.avi,931,73,1478,61,547,2
0X7118ED94A443E8E7.avi,846,19,1133,2,287,2
0X711CC31DFD8C6CE6.avi,1066,53,1700,39,634,2
0X7120B54F5E975B0.avi,1096,16,1466,3,370,2
0X7122CEBF07A2DE69.avi,1534,91,1914,77,380,2
0X712458E135BD7CD0.avi,968,55,1429,42,461,2
0X71258BC9BF14F659.avi,1223,63,1884,47,661,2
0X7125909CA78A239F.avi,943,157,1626,139,683,2
0X71270AD323D7C627.avi,1018,64,1653,44,635,2
0X712BBDD024BB89D4.avi,1255,50,1777,37,522,2
0X7131C08459C410A1.avi,1001,173,1716,155,715,2
0X713283EFDECFC71F.avi,2210,146,2765,128,555,2
0X713C7B1DB0E7CB75.avi,1211,168,1824,151,613,2
0X714EE9D5B7A7CB68.avi,838,87,1176,60,338,2
0X715397AF1E4562CB.avi,1020,47,1611,31,591,2
0X7159C74F59E908A1.avi,982,126,1420,110,438,2
0X71609DB7DBE8E5C9.avi,958,92,1751,80,793,2
0X7161E52DA45FA80A.avi,1026,88,1478,73,452,2
0X7166874B45E63C2B.avi,1530,247,2673,216,1143,2
0X716A0C710832A933.avi,761,87,1219,66,458,2
0X716A4A1F44C246C2.avi,1358,102,2168,91,810,2
0X716B30133939FDA5.avi,1176,70,1821,52,645,2
0X716BD6EC64183751.avi,1128,56,1783,44,655,2
0X716ED8AC3405BBCF.avi,886,136,1229,126,343,2
0X71722CC01AF2175D.avi,1123,118,1679,102,556,2
0X717323632DAF18D2.avi,1105,67,1649,54,544,2
0X7174E265B5635A11.avi,568,101,1009,86,441,2
0X71755FC85FCCA3DE.avi,1490,79,2529,58,1039,2
0X71787F5C9B2F37BD.avi,1300,66,1799,51,499,2
0X717A7E3193260492.avi,990,17,1635,0,645,2
0X717DCB2A4258FA9B.avi,921,59,1439,40,518,2
0X717E05B4B54B895A.avi,1956,148,2333,127,377,2
0X718E2A768B2DAAD4.avi,1112,80,1700,59,588,2
0X718F2A065EA36E9E.avi,1346,18,2037,2,691,2
0X7192B220A4F9B614.avi,1218,17,1955,0,737,2
0X719610DCE293C29B.avi,1282,109,1935,95,653,2
0X719ADE4E464DE956.avi,568,54,990,39,422,2
0X719F5441F4D7F772.avi,1168,177,2036,161,868,2
0X71A140B2F6A6062F.avi,610,72,1009,60,399,2
0X71A38FBA15CAA56E.avi,716,92,1131,74,415,2
0X71A68ED541CAFABD.avi,982,47,1564,30,582,2
0X71A79CF4AE112004.avi,1299,183,2302,164,1003,2
0X71B1D648746922B0.avi,1601,82,2196,58,595,2
0X71B423886D8BB117.avi,1550,64,2349,48,799,2
0X71B7B5A51EB88F54.avi,990,13,1389,4,399,2
0X71B8479C56197371.avi,1357,39,2130,24,773,2
0X71BB6DF9BBBA718F.avi,955,69,1443,52,488,2
0X71BC28A1041B6981.avi,957,57,1517,41,560,2
0X71BECC036C3DD693.avi,2166,69,2572,53,406,2
0X71C37D3E936D08DA.avi,770,122,1306,106,536,2
0X71C8CFCE2B3483F6.avi,964,139,1688,123,724,2
0X71C9BD7600883FA3.avi,1172,60,1726,47,554,2
0X71CAB00A955A0BB7.avi,1425,123,2284,103,859,2
0X71CEA697EC901543.avi,1065,85,1672,69,607,2
0X71D3E92F0E283A45.avi,1447,57,1913,41,466,2
0X71DA17261425414F.avi,1356,95,2463,77,1107,2
0X71DB4E0E745B22D4.avi,984,103,1480,88,496,2
0X71EBD87DBF90BC93.avi,1971,158,3063,145,1092,2
0X71ECEE29C97C0292.avi,1278,50,1812,37,534,2
0X71EE3626BC57AB55.avi,1817,41,2597,26,780,2
0X71F4D803A9CE35AA.avi,1688,73,2053,60,365,2
0X71F6ECDFB811C998.avi,1535,108,2193,89,658,2
0X71F7F25CC893F72.avi,891,9,1284,2,393,2
0X71F9AA38B454A66A.avi,955,132,1527,116,572,2
0X71FB4521E8DC4E3D.avi,1257,109,1742,95,485,2
0X71FB4930667AD953.avi,1040,60,1767,44,727,2
0X71FE0206D64EDD39.avi,1384,72,1850,48,466,2
0X720404AB389CDF96.avi,1165,136,1775,123,610,2
0X720443862A5F44D4.avi,1594,112,2573,95,979,2
0X7204B716FE2009EA.avi,984,44,1492,32,508,2
0X720E0C79D9B2B018.avi,1113,158,1680,141,567,2
0X720F9F5DA429C676.avi,875,17,1433,0,558,2
0X7211958526AE3A51.avi,822,182,1313,166,491,2
0X7218A5217E8BA6E5.avi,1232,61,1984,45,752,2
0X721A90EE2322377A.avi,1082,61,1621,42,539,2
0X72227A5D210CFA13.avi,1803,93,2549,79,746,2
0X72247857F10306AE.avi,676,101,1047,82,371,2
0X7230B41AA70ED90D.avi,901,121,1326,103,425,2
0X7234FFD3D26F08F1.avi,756,110,1287,99,531,2
0X723DEBB24B6737BD.avi,1463,61,2408,46,945,2
0X7244FC1F0267202F.avi,1556,59,1975,45,419,2
0X7246713ACDF6B2E.avi,866,87,1363,70,497,2
0X7246B70B391D7CED.avi,1046,17,1477,1,431,2
0X7254D04113C8EA7F.avi,1240,109,1669,94,429,2
0X7258541793A94047.avi,1186,18,1514,8,328,2
0X725B0209DBD7F41B.avi,1812,165,2216,148,404,2
0X725C7955468D7BAA.avi,1457,119,1796,93,339,2
0X725F2E47573B3648.avi,1272,130,1777,108,505,2
0X72611744EE97633F.avi,1210,131,1837,115,627,2
0X726340B293ADED52.avi,826,62,1331,47,505,2
0X72641E8B44DDA6E3.avi,829,123,1289,113,460,2
0X72669FE268B8CA29.avi,796,122,1368,103,572,2
0X72685B35200F4C48.avi,1211,67,1871,52,660,2
0X726967D49A9BD73A.avi,1946,66,2259,50,313,2
0X727106F39B6E611E.avi,1136,46,1770,30,634,2
0X7273C017B303827B.avi,1196,126,1905,108,709,2
0X7273D2DCA14BFE52.avi,1673,211,2252,197,579,2
0X727574CAF516696A.avi,1250,111,2123,94,873,2
0X728343B49BC0BC70.avi,971,135,1749,121,778,2
0X72858D35CFD4490A.avi,1562,68,2404,50,842,2
0X728647F593EBCFED.avi,1758,64,2965,44,1207,2
0X72868EA70E22F4F6.avi,858,20,1405,2,547,2
0X72890FDB8C6E5396.avi,830,104,1314,87,484,2
0X728966175618192B.avi,1267,27,1991,4,724,2
0X728D7EF689FADA01.avi,1471,172,2670,154,1199,2
0X7299D46E48AD3C37.avi,1314,91,1974,70,660,2
0X729CBDBABBA099C1.avi,873,55,1457,38,584,2
0X729CD3050F8450DF.avi,1094,94,1808,82,714,2
0X72A32C36FF4B3157.avi,913,105,1325,91,412,2
0X72A626C96C71FCC.avi,1053,74,1603,53,550,2
0X72A8D28B7FB9F369.avi,976,61,1885,43,909,2
0X72A9BD119B9C7C5E.avi,877,95,1347,76,470,2
0X72AC2AF862DED456.avi,1210,92,1942,76,732,2
0X72AFD8330D1A2378.avi,1785,47,1925,36,140,2
0X72B134B9DB954CE0.avi,1786,66,3591,42,1805,2
0X72B2D4A1633D4D14.avi,1515,14,2522,0,1007,2
0X72B3B527971FE713.avi,1403,71,2206,52,803,2
0X72B520E2CC016AC4.avi,1646,152,2750,134,1104,2
0X72BA22CA9CD1AEDD.avi,781,21,1354,3,573,2
0X72BE557C5F55572B.avi,859,68,1269,50,410,2
0X72BF8A29F8CF0359.avi,1104,68,1934,50,830,2
0X72C39CB9185ABCB3.avi,2147,156,3345,136,1198,2
0X72C54782C645967A.avi,1045,63,1412,46,367,2
0X72CA19464A24E2B5.avi,757,69,1278,51,521,2
0X72CDA4DD9AD5C01E.avi,1330,137,2059,119,729,2
0X72D0449A54F721F.avi,1556,159,2222,137,666,2
0X72D31B9B3CD67721.avi,821,111,1102,96,281,2
0X72D980B0EF1D8FA4.avi,1288,14,1779,1,491,2
0X72DB58A40280753B.avi,876,68,1479,51,603,2
0X72E13FF47AEEAE04.avi,1365,18,2414,1,1049,2
0X72E41E49681C6CEB.avi,1095,72,1339,55,244,2
0X72E86E75402DEFAD.avi,715,166,1244,151,529,2
0X72F46FF82263E9BB.avi,1277,115,2210,99,933,2
0X72F90AFD1A6DC3F5.avi,1532,127,2197,107,665,2
0X72FBB4E0E2561747.avi,803,75,1264,57,461,2
0X72FBDAE8D9EF8D0E.avi,1791,79,1908,65,117,2
0X7302018616588BE1.avi,825,107,1320,92,495,2
0X7302BA5E11336B0D.avi,1149,69,1879,52,730,2
0X730370D5459157D2.avi,912,131,1505,114,593,2
0X7306CC1667084C19.avi,907,76,1538,64,631,2
0X7307134A5F851D7B.avi,940,47,1391,30,451,2
0X730D323F56D3D95B.avi,1138,21,1778,4,640,2
0X7310ACB3B6BDAEB0.avi,1496,148,2381,126,885,2
0X7313C9F94735726B.avi,1045,96,1753,80,708,2
0X73157CDC07CC521A.avi,1105,70,1773,51,668,2
0X731BBCC68C30384D.avi,1404,84,2119,71,715,2
0X731CE25F892AF5.avi,964,18,1740,0,776,2
0X7320E95D3BDA1C67.avi,1257,61,2227,46,970,2
0X73216341691AED3F.avi,1104,81,1701,65,597,2
0X7321C0F7FDA48773.avi,1149,78,1909,58,760,2
0X7323E0F1366BE491.avi,945,69,1453,49,508,2
0X7327A7A5AD3EAF3A.avi,2085,57,2650,40,565,2
0X7327AFFC293E3F3E.avi,710,127,1132,107,422,2
0X73283509266FA479.avi,1187,58,1448,46,261,2
0X7329DF92A352EC62.avi,2150,67,2624,52,474,2
0X7334E8F890A16192.avi,1176,68,1983,53,807,2
0X7337462DDC2B8F16.avi,1569,88,2470,68,901,2
0X733DE78E141F8487.avi,1381,79,2024,63,643,2
0X733FE55DDB6B588E.avi,833,68,1333,57,500,2
0X73402C06C929E8EF.avi,2627,183,3442,161,815,2
0X734706E202C7BEBE.avi,920,53,1580,41,660,2
0X73496542C2F1F928.avi,1034,64,1607,44,573,2
0X7349742DCA7B38DF.avi,1117,112,1786,93,669,2
0X734CB51813AC8430.avi,577,58,925,38,348,2
0X73501E4D51E5DF62.avi,1014,42,1559,28,545,2
0X735A2D72D186ABDF.avi,919,50,1343,34,424,2
0X735C86AD64E736BF.avi,986,13,1554,4,568,2
0X735F0DB71E45133F.avi,944,71,1510,56,566,2
0X735F588BB61D6CAA.avi,918,69,1411,51,493,2
0X73612CEEAF383F2D.avi,1374,111,2310,94,936,2
0X7361844FD9363EEA.avi,1446,86,2322,63,876,2
0X7363FE8BE097BA58.avi,1574,68,2756,50,1182,2
0X7364F152A024A66.avi,1060,63,1581,47,521,2
0X736D9AEB697FDDF0.avi,1112,82,1822,64,710,2
0X736E10551271694D.avi,942,92,1585,76,643,2
0X736ED14581138752.avi,1042,23,1823,3,781,2
0X73707FBC492E69C7.avi,1657,114,2559,98,902,2
0X7374FD2832640365.avi,1006,77,1683,56,677,2
0X7378F346BE3CD053.avi,598,74,1008,58,410,2
0X73793EDBF1409C1E.avi,1379,80,2071,64,692,2
0X7381676B84209CF0.avi,1393,17,1758,0,365,2
0X7384FCD4DDDF9740.avi,1220,178,1890,164,670,2
0X73887804901441E1.avi,1503,157,2303,133,800,2
0X73897D7AE3BFB060.avi,1006,130,1659,115,653,2
0X7389E32FF1D284E.avi,2788,68,3171,51,383,2
0X738BA7947C53A64C.avi,2283,64,3567,44,1284,2
0X7395A2178B8DD011.avi,1201,173,1891,158,690,2
0X73995C715F09779B.avi,683,61,913,43,230,2
0X739DC030F18706BB.avi,877,18,1354,5,477,2
0X73A06B412F7611EA.avi,1001,19,1534,3,533,2
0X73A4D918B6CA3C90.avi,1451,60,2274,45,823,2
0X73AD3070008C7EF9.avi,1291,57,1777,41,486,2
0X73AF0618B125251B.avi,1505,125,2677,105,1172,2
0X73B655A8FCF9F25B.avi,1231,71,2155,55,924,2
0X73B805054B52B4D0.avi,1105,74,1688,59,583,2
0X73B810568F40AFE4.avi,1560,57,2707,44,1147,2
0X73BAB1DA81605904.avi,1338,131,2165,103,827,2
0X73BDFA9C889E6149.avi,1047,132,1919,112,872,2
0X73BFDA4FB4F6235E.avi,1667,61,2827,43,1160,2
0X73C0839C4D54DBDB.avi,1680,66,2957,47,1277,2
0X73C0AD458889A9FD.avi,1300,71,2188,60,888,2
0X73C3FC7FB8A7BC9E.avi,1760,123,2540,107,780,2
0X73CBCADA2191104C.avi,1599,17,2222,0,623,2
0X73CC4E768F5C61D5.avi,1247,26,2034,2,787,2
0X73CC9D0B1F28A704.avi,1469,119,2674,100,1205,2
0X73D0401BA6131E49.avi,1808,79,2797,56,989,2
0X73D25D118343CC88.avi,1102,11,1990,0,888,2
0X73D38D822D999A40.avi,806,71,1354,46,548,2
0X73D50DE693F798E3.avi,1333,65,2097,46,764,2
0X73DD393CD2CBDE7D.avi,944,127,1520,107,576,2
0X73E028B05C13AD4C.avi,855,130,1301,114,446,2
0X73E1750D79C18CE6.avi,1389,67,2002,47,613,2
0X73E20506F6BF4FD6.avi,947,113,1589,94,642,2
0X73E3BB1E0A5DAADB.avi,2522,27,4239,6,1717,2
0X73E49B1080094361.avi,1598,116,2197,99,599,2
0X73E7E893FB817BED.avi,1395,62,2190,40,795,2
0X73E8465DDBF29918.avi,1023,158,1732,142,709,2
0X73E9825196EB26F9.avi,1498,16,1718,3,220,2
0X73EA8274FC52080F.avi,1002,75,1693,55,691,2
0X73EB274CEED30582.avi,1237,59,1648,43,411,2
0X73F5C8B7C26ADF0D.avi,936,61,1448,46,512,2
0X73F6DA33A9F3A272.avi,789,67,1277,46,488,2
0X73F79A58680979D6.avi,1055,63,1579,48,524,2
0X73F7C900EE5F7BDA.avi,1109,97,1823,77,714,2
0X7402E875B7F92C39.avi,702,48,1021,34,319,2
0X74084E3472EDBC5B.avi,816,28,1234,21,418,2
0X740B08561D0382B.avi,1329,58,1610,42,281,2
0X740C8D1BB435F52D.avi,838,91,1347,81,509,2
0X740C9FC96463133D.avi,1209,72,2095,50,886,2
0X740E3E79F3D8FD83.avi,1481,29,1832,35,351,2
0X740F540B87B8AF3.avi,1300,99,2203,83,903,2
0X7411B4F7A67BA8B5.avi,1675,53,2661,40,986,2
0X7415C8B1BD8C89F0.avi,1166,38,1734,22,568,2
0X74179B492A2A5797.avi,887,165,1488,151,601,2
0X741BD841B1FBA276.avi,1376,125,1843,108,467,2
0X741BECA9987E71FE.avi,1062,18,1769,2,707,2
0X74219E2082D4E07C.avi,1080,46,1217,32,137,2
0X74223A9F6F471ABB.avi,1662,70,1929,50,267,2
0X7428DD73E48A8B91.avi,766,237,1367,212,601,2
0X74370D9F34D1B158.avi,993,20,1606,3,613,2
0X743DC850101325BA.avi,960,123,1511,108,551,2
0X743ED9E602F4C401.avi,1246,11,2304,0,1058,2
0X7442C6F159E69F2C.avi,1372,72,2063,52,691,2
0X744318292E6F77CD.avi,987,177,1704,164,717,2
0X744867670A05CAB6.avi,791,54,1266,40,475,2
0X744B061341172EE8.avi,859,47,1485,34,626,2
0X744B44C9E0FAB522.avi,1631,68,2885,51,1254,2
0X744CE89425556B93.avi,899,53,1348,37,449,2
0X744E923850EFD4BA.avi,2549,50,2833,34,284,2
0X74582CAF1FE19301.avi,1114,92,1539,80,425,2
0X74596DA2E143D6B6.avi,996,55,1563,43,567,2
0X745E6D6BDDF80DCD.avi,1654,21,2859,0,1205,2
0X746492156F4D1DBA.avi,1103,59,1705,39,602,2
0X746834EDB4528A59.avi,767,87,1205,72,438,2
0X746AE949330474EF.avi,2226,150,2791,130,565,2
0X746F499A43B6E4FF.avi,1670,67,2177,51,507,2
0X74730225B5BBF275.avi,1510,70,2318,50,808,2
0X7476874DC8F10D2A.avi,1413,105,2120,81,707,2
0X7479583EA6499D94.avi,1157,69,1864,49,707,2
0X747A2BD26A77088C.avi,1086,72,1712,54,626,2
0X7484EE46AD3659CC.avi,1579,55,2411,36,832,2
0X748CE60009AB49AB.avi,1074,67,1695,49,621,2
0X748F2E7A97DCC6E5.avi,940,80,1540,66,600,2
0X74900986127D0528.avi,1677,21,2290,0,613,2
0X7495513F82B76105.avi,1355,82,2327,69,972,2
0X749761A9AF29C863.avi,990,113,1484,95,494,2
0X7498BD710B94CF12.avi,1227,103,1828,84,601,2
0X74A2D8CA7E7F14E.avi,1469,84,1811,70,342,2
0X74A50C8DEAF4CBA8.avi,1809,103,2362,88,553,2
0X74A8521201588DDE.avi,642,94,918,79,276,2
0X74A87351D519ABBB.avi,2896,43,3033,32,137,2
0X74AE577182FB112A.avi,1115,79,1762,60,647,2
0X74AF472F5C3E02A4.avi,1309,89,2092,77,783,2
0X74AFC03F1383C4A.avi,1209,64,1638,48,429,2
0X74B46A261E8088EA.avi,3004,78,3406,66,402,2
0X74B4D8E3459FFF7C.avi,995,90,1507,71,512,2
0X74B54899CC2CFB7B.avi,996,156,1742,139,746,2
0X74B6576AF56AECD4.avi,772,44,1312,37,540,2
0X74B8D224405BA094.avi,1368,44,2277,28,909,2
0X74C3D288B3E288B9.avi,922,77,1409,65,487,2
0X74C54B277B5B012A.avi,1823,83,2934,71,1111,2
0X74CC94D6336F349.avi,694,123,1149,108,455,2
0X74CE156E0D1988F0.avi,1077,21,1632,1,555,2
0X74CFDB0155A5F839.avi,1374,54,2158,38,784,2
0X74D2AB50ABC3BC70.avi,1202,146,2001,128,799,2
0X74D4DD80DA8C2996.avi,802,67,1043,55,241,2
0X74D8C8C813E756D9.avi,815,80,1255,58,440,2
0X74DCA6B99E9BC121.avi,1009,64,1645,47,636,2
0X74E8C723FC9CE35A.avi,907,178,1382,156,475,2
0X74EBC28051D5C897.avi,1502,131,1722,116,220,2
0X74EC1E2F247AFC9B.avi,1288,42,1692,28,404,2
0X74ECBD41FE00FDA9.avi,1298,57,2030,44,732,2
0X74EF11EA884BA69B.avi,1008,94,1422,56,414,2
0X74F1AB4BAE55B45C.avi,1557,16,2228,0,671,2
0X74FFBF42469E1942.avi,941,83,1487,61,546,2
0X75031E71CC6DBD81.avi,1357,64,1694,42,337,2
0X7504D970F17544F7.avi,999,153,1479,134,480,2
0X7506BF768DE74BD.avi,1954,101,2251,87,297,2
0X751739EFA206F1FE.avi,1528,71,2199,53,671,2
0X75184C621776F4CB.avi,1215,48,1849,35,634,2
0X751A4FB2CEA69C9C.avi,1936,121,2462,104,526,2
0X7521A2DBEE71A1F2.avi,1097,120,1695,101,598,2
0X752317EDE8CCB915.avi,1154,58,1777,40,623,2
0X7524D9CE7C6BD3B.avi,922,50,1199,30,277,2
0X7524FCA7831EB79A.avi,1067,76,1509,56,442,2
0X7525596E8C33D4E0.avi,1082,170,1663,154,581,2
0X7525B9148C2CD0BD.avi,1298,21,2130,5,832,2
0X7528AEAEC3FBA097.avi,1585,95,2640,79,1055,2
0X7529294AFB270DA0.avi,1402,117,2220,106,818,2
0X7529FE87A088578B.avi,1046,16,1459,4,413,2
0X75302B43AECFF778.avi,1077,112,2137,93,1060,2
0X75309BE6A3C65FC0.avi,1264,139,2014,121,750,2
0X7532D043B2FE1A89.avi,1503,22,2423,2,920,2
0X7532E58FAD68C533.avi,1783,19,3183,0,1400,2
0X7533B5CFDF97B569.avi,1982,63,3572,45,1590,2
0X753683596D61C023.avi,997,58,2093,41,1096,2
0X75378D82A1704679.avi,1636,121,1900,103,264,2
0X753AA26EA352BBB.avi,1677,27,2753,32,1076,2
0X753D4BE480775FE7.avi,759,29,1228,22,469,2
0X75407F342647CDB9.avi,1343,118,1901,96,558,2
0X7540B06840A33DBF.avi,1218,114,1706,93,488,2
0X7542FA5CAC850B43.avi,953,75,1549,60,596,2
0X75472032BA3A263A.avi,1742,84,2525,61,783,2
0X754AD474CF769955.avi,1050,67,1756,46,706,2
0X754B72455C00BFDF.avi,1007,85,1542,73,535,2
0X754BCC1F775CBF82.avi,1167,77,1849,60,682,2
0X75501B93842BA401.avi,771,78,1253,63,482,2
0X7552A3BA5FC6E4FE.avi,950,50,1276,40,326,2
0X75537A0F4CC9575A.avi,1003,18,1519,0,516,2
0X75572AB3B3B48345.avi,628,65,873,47,245,2
0X75596F4699354CDA.avi,1922,62,2690,43,768,2
0X755A90F50F4068A2.avi,1059,77,1694,56,635,2
0X755B138AF2588FEB.avi,882,77,1532,56,650,2
0X7563D12CC3D333.avi,1699,71,2681,55,982,2
0X7564081D4345D54E.avi,1377,69,1743,52,366,2
0X756A5DE88BADCAD5.avi,1274,57,1805,48,531,2
0X756DAD54E9785E32.avi,1452,73,1959,57,507,2
0X756FC51037837AB9.avi,773,72,1318,60,545,2
0X7571CEDC4D58BA99.avi,941,70,1506,49,565,2
0X7573D0F166A745C2.avi,1319,55,1751,33,432,2
0X757B31FD347B7585.avi,992,20,1531,0,539,2
0X757E1FD68EA38804.avi,1178,62,1819,43,641,2
0X7582300B0B9B7FE.avi,1484,76,2146,56,662,2
0X7584A85D9038EE5.avi,909,64,1524,47,615,2
0X758646B35B753982.avi,1587,104,2706,86,1119,2
0X758AD34A442E9B92.avi,1401,103,2084,87,683,2
0X758AD547400F166A.avi,1247,62,2025,33,778,2
0X758BAF4513916559.avi,651,97,991,88,340,2
0X759190C681D52700.avi,1107,109,1718,94,611,2
0X7595258EBE9BF61E.avi,940,101,1459,84,519,2
0X75980C92D587017B.avi,1037,16,1443,2,406,2
0X7599F574E8E51B1C.avi,690,63,1119,45,429,2
0X759B7B28B1086707.avi,1683,88,2754,67,1071,2
0X75ACFE19B069E805.avi,687,115,1093,96,406,2
0X75AF130134AADF00.avi,1018,55,1255,36,237,2
0X75B080DB873F09A8.avi,1094,120,1507,107,413,2
0X75B1C628D4FBB8B0.avi,857,72,1478,53,621,2
0X75B466DF0FE8BDF8.avi,1349,85,1677,63,328,2
0X75BA1623CCCF0652.avi,2101,18,2809,3,708,2
0X75BB68F0ACD22690.avi,981,79,1588,64,607,2
0X75BF25E961056A3C.avi,1527,69,2544,42,1017,2
0X75C3DEC78DC6B030.avi,1450,55,1888,36,438,2
0X75C6B7A420E577F0.avi,995,75,1737,57,742,2
0X75CC279D832110B3.avi,632,109,932,95,300,2
0X75CF68235B445C71.avi,1185,62,1906,47,721,2
0X75DABBB27803889E.avi,1178,161,1604,141,426,2
0X75DF068323A1B75A.avi,1109,68,1573,59,464,2
0X75E662FDEB925647.avi,962,51,1607,37,645,2
0X75E84FBEEEE69FD8.avi,1222,91,1980,76,758,2
0X75ECC6694B60D05A.avi,949,41,1586,27,637,2
0X75ED030E56E85A27.avi,1362,59,2142,42,780,2
0X75F02C30D9BD67BD.avi,2000,197,2456,173,456,2
0X75F76AEBCE051CD1.avi,1041,95,1467,80,426,2
0X75FA18E3007970A6.avi,1281,58,2454,41,1173,2
0X75FA93DC76BFB6A6.avi,1083,13,1618,0,535,2
0X75FCE4E4D09346E8.avi,1583,145,1829,126,246,2
0X75FD0277B3649F4C.avi,1142,19,1940,2,798,2
0X7600AA9CA94BC926.avi,976,98,1518,81,542,2
0X7602BD0B48EB9C41.avi,1337,153,2250,136,913,2
0X760D32805B54A4DB.avi,1606,62,2946,45,1340,2
0X760F20180FF2AF05.avi,1037,73,1764,57,727,2
0X7611CD2E2F5D8D5A.avi,807,72,1371,60,564,2
0X7611E73E48694DD2.avi,915,92,1219,84,304,2
0X7614D7711A328048.avi,1468,69,2240,53,772,2
0X76166F0E9F88A8EE.avi,1112,51,1770,35,658,2
0X761FEC566D4FA6B4.avi,1189,71,1868,57,679,2
0X7622FE00BC55FA93.avi,643,76,889,63,246,2
0X76236768A07DC4A0.avi,737,17,1116,0,379,2
0X7624B8F339B7F9E2.avi,755,50,1216,39,461,2
0X7626288997509ED8.avi,1739,137,2193,110,454,2
0X76265CF61DC60700.avi,1156,12,1754,2,598,2
0X7628E85E157D1655.avi,897,51,1379,36,482,2
0X762A1DFE29A222B9.avi,1458,63,2339,48,881,2
0X762B2F82E180F891.avi,647,131,1082,120,435,2
0X762B3C5FFB4F6256.avi,829,67,1340,50,511,2
0X762F3649CC03CEB2.avi,1746,67,2553,49,807,2
0X763034E9D22CB7E1.avi,1031,44,1492,27,461,2
0X7630DA7B2D3E6F27.avi,1891,158,2282,139,391,2
0X7631EA1C1A8CC24E.avi,1121,47,1423,33,302,2
0X7634C16A2566CB36.avi,1388,164,2182,148,794,2
0X7639DF523155EE5B.avi,1100,19,1417,2,317,2
0X763E3FFF4DBBB792.avi,1942,154,3178,137,1236,2
0X763F719D691570A5.avi,824,69,1358,54,534,2
0X7640521DAB3774CD.avi,1003,49,1738,35,735,2
0X76411FAE2DF2EEB5.avi,918,68,1577,52,659,2
0X7641C94226741EBA.avi,1230,108,1920,92,690,2
0X76437B0245B6762.avi,1871,17,2243,4,372,2
0X764C542E3E41E4D2.avi,1762,21,2375,14,613,2
0X764F224CC78A22A3.avi,693,55,1109,42,416,2
0X765022B40B3129C0.avi,1198,136,1850,115,652,2
0X7650A9E7CE45FD9E.avi,941,21,1557,0,616,2
0X76525CBFC30D569F.avi,1512,116,2178,97,666,2
0X7655EF3942795C54.avi,1163,120,1804,112,641,2
0X76571CA78B208B80.avi,937,53,1536,35,599,2
0X765D336F80D8DC9C.avi,1196,22,1742,2,546,2
0X766164794562852B.avi,1159,97,1885,84,726,2
0X7663D4D92BDD0DF0.avi,1042,79,1598,66,556,2
0X7666487BE51E1D94.avi,1295,79,1544,63,249,2
0X766B7B0ABDB07CD5.avi,737,45,1273,18,536,2
0X766FB03557B32F7.avi,611,54,1350,39,739,2
0X76736440F2A28290.avi,1063,107,1599,96,536,2
0X76747A1A799357B5.avi,1149,113,1950,99,801,2
0X76759C3F748F7642.avi,733,15,1171,3,438,2
0X7675A1B2694BA8E.avi,1080,90,1756,75,676,2
0X767947C7DECC2E0D.avi,1195,101,2083,82,888,2
0X767FB65F24445D49.avi,1097,90,1466,79,369,2
0X76833F5D02883757.avi,955,89,1345,74,390,2
0X768E85852A1CF053.avi,853,44,1322,31,469,2
0X7697FABB106CA020.avi,925,102,1573,86,648,2
0X769C3D56C7272A2.avi,1054,49,1777,34,723,2
0X769E071800CFC0FB.avi,866,102,1564,81,698,2
0X769E51557A324219.avi,1512,67,2158,51,646,2
0X769EDBD7BD855F6E.avi,912,148,1418,133,506,2
0X76A2F23E5CC3AE8.avi,1545,20,2499,38,954,2
0X76A43B263DED8D2A.avi,897,48,1326,29,429,2
0X76A7219E8CDEDD94.avi,957,46,1638,29,681,2
0X76AA056D7D126764.avi,837,72,1359,55,522,2
0X76AC76456CE65507.avi,1117,67,1691,48,574,2
0X76ACECF4ADDE5FEC.avi,949,72,1510,61,561,2
0X76AFD129D4D3F9B6.avi,1017,106,1844,90,827,2
0X76B3419501D921D5.avi,1770,130,3018,111,1248,2
0X76B58AFEBD29ED3A.avi,1012,106,1549,89,537,2
0X76BA1F5294F6CED2.avi,1071,66,1387,44,316,2
0X76BACDAE432385EB.avi,1044,58,1608,43,564,2
0X76BDAF25BA25FB78.avi,1002,75,1636,59,634,2
0X76C419ACD0EB7F21.avi,1604,125,2575,109,971,2
0X76C545439F4D8755.avi,1891,55,2693,40,802,2
0X76C68DF9EAD541B2.avi,1093,140,1710,125,617,2
0X76C84AD83FFD8620.avi,1577,71,2724,51,1147,2
0X76CA8EF02677FD92.avi,1149,63,2045,44,896,2
0X76CB8866FF386D70.avi,1095,186,1978,169,883,2
0X76CD74B7A16F961C.avi,932,61,1476,44,544,2
0X76CF3E993E9964A9.avi,2297,30,2545,60,248,2
0X76CF9DD42F1E65F5.avi,1073,103,1727,87,654,2
0X76D00C87BFFEF9ED.avi,1287,48,2338,34,1051,2
0X76D0455E4D842528.avi,812,57,1261,42,449,2
0X76D1CD83C813866F.avi,866,74,1368,56,502,2
0X76D4127252AEE59B.avi,1824,61,3212,40,1388,2
0X76D5689A73615919.avi,640,72,1066,60,426,2
0X76DC6D4505B83070.avi,1133,108,1885,92,752,2
0X76E11B10B82CED38.avi,1219,70,1899,49,680,2
0X76E3BEB91B015F9C.avi,948,48,1554,32,606,2
0X76E4353961DF844D.avi,1912,180,2511,160,599,2
0X76EB03C76DA83506.avi,1049,104,1742,82,693,2
0X76ECD9C77CBF74DF.avi,1372,105,2274,87,902,2
0X76F1860F9A3BA0D.avi,2099,69,3143,51,1044,2
0X76F22089D5778788.avi,1323,46,2062,30,739,2
0X76F4E037E279AF66.avi,930,122,1627,104,697,2
0X76F8E59118B237E4.avi,1584,110,2191,94,607,2
0X76FCC20BE40D7420.avi,1498,72,2291,52,793,2
0X76FD04F70E71C6B4.avi,940,79,1532,61,592,2
0X76FE618100C74B17.avi,1589,242,2293,224,704,2
0X76FFCEF160816C6D.avi,872,21,1604,2,732,2
0X770217E8A046549.avi,876,86,1389,68,513,2
0X7708922833D36759.avi,1015,88,1622,71,607,2
0X770BECBD81CA14F9.avi,1655,76,1861,60,206,2
0X770D507C00A355B.avi,1006,109,1408,99,402,2
0X770DA83A3089A1CE.avi,1180,72,1930,47,750,2
0X770E5896DC4FD92B.avi,1199,151,1824,138,625,2
0X7710551E470BE80A.avi,980,69,1612,52,632,2
0X771077249874A8C5.avi,2039,102,3137,83,1098,2
0X771268F9558AC1F1.avi,1037,131,1801,119,764,2
0X771366A13CB946B7.avi,1106,129,1828,113,722,2
0X7713736C58AE4285.avi,1175,136,1895,112,720,2
0X771C3F118CBF577A.avi,1450,104,2507,84,1057,2
0X77205DA830ED3817.avi,900,67,1532,50,632,2
0X7724D6B08D73B212.avi,1887,72,2937,52,1050,2
0X772970685B34F0F1.avi,1094,79,1706,65,612,2
0X772A0668FFB473C1.avi,1077,69,2242,49,1165,2
0X772AB2EA261CD16A.avi,1269,207,1935,188,666,2
0X772BAD84F86F709D.avi,1031,67,1623,51,592,2
0X772EC799B52E7C56.avi,1336,36,2027,0,691,2
0X77373A73E2BC8C9E.avi,884,141,1311,128,427,2
0X773AC247581BBBA1.avi,846,77,1517,59,671,2
0X773AFFB19D6D921B.avi,866,104,1429,91,563,2
0X773D4F3643F9BF5F.avi,1635,93,2434,73,799,2
0X77435187285FD096.avi,1214,99,1932,87,718,2
0X77458937194C1E72.avi,1264,72,2185,57,921,2
0X77512D8618DD734C.avi,1398,77,2165,60,767,2
0X775319C257A48042.avi,2134,117,2869,95,735,2
0X775716B41199062E.avi,790,84,1178,62,388,2
0X7758757FDD3AA0D4.avi,1853,21,2760,2,907,2
0X7759E238B242AFBC.avi,1348,103,2245,84,897,2
0X775A2380C732189.avi,928,141,1557,121,629,2
0X775A9E14ECEB2A11.avi,1304,72,2010,54,706,2
0X775B4EA7420EEECA.avi,953,51,1459,33,506,2
0X775EBA7C578E03AD.avi,1806,91,2216,75,410,2
0X775F0DCC5003FFB.avi,947,49,1548,33,601,2
0X776060BC74A34C5F.avi,1114,60,1233,44,119,2
0X77609B23026AAFAA.avi,1000,73,1696,50,696,2
0X776400751536FD2E.avi,1631,72,2926,57,1295,2
0X77666FD212028DA8.avi,1042,53,1742,38,700,2
0X77673F84D3540E92.avi,795,81,1386,66,591,2
0X777110E46D3D382.avi,910,65,1609,47,699,2
0X77714EEC1C79CC7F.avi,1008,19,1689,0,681,2
0X7771F923B288DDB7.avi,1591,75,2450,53,859,2
0X7775D4576C04313E.avi,1366,57,2092,42,726,2
0X77762963F999DEE3.avi,1103,122,1396,97,293,2
0X777692B30E35465A.avi,1018,112,1462,87,444,2
0X777EA631128ED080.avi,935,116,1512,103,577,2
0X778935C329CC1789.avi,1312,116,1764,103,452,2
0X778CB82CED72873C.avi,1299,71,2249,51,950,2
0X778CFD575FF2145E.avi,788,73,1284,56,496,2
0X778D8A645214CBB0.avi,1122,105,1765,69,643,2
0X7790F4DB18852455.avi,1494,116,2328,100,834,2
0X7795868D5A8D56AC.avi,2602,144,3260,128,658,2
0X779A65D152E67F94.avi,967,143,1449,123,482,2
0X779B9DB887C3B8C6.avi,1425,60,2247,43,822,2
0X779C1D2EE532F2FA.avi,1058,67,1630,49,572,2
0X779CF7E0C461311.avi,768,15,1103,1,335,2
0X77A2E6579D61CCC5.avi,1715,45,2522,31,807,2
0X77A68EB0325B1DFC.avi,1068,46,1544,33,476,2
0X77A6AF7AADDA5798.avi,1279,75,1896,55,617,2
0X77A6EEED554F8360.avi,1182,64,1958,45,776,2
0X77AFF38EB600E72A.avi,1244,97,1942,82,698,2
0X77B0F03C4F1E0315.avi,1018,68,1576,51,558,2
0X77B19349F044C8FF.avi,1772,81,2474,65,702,2
0X77B1CC9BB9CAF732.avi,969,50,1299,34,330,2
0X77B797A13F96E759.avi,2034,54,2286,38,252,2
0X77B8C03F736ABA4C.avi,1007,62,1467,43,460,2
0X77C3278832702B6.avi,957,79,1530,64,573,2
0X77C42751F7BDB257.avi,1006,133,1697,119,691,2
0X77C5776C24812C92.avi,1548,48,1680,31,132,2
0X77C6792EE63777FD.avi,814,98,1267,82,453,2
0X77CC33D53A20A219.avi,1064,57,1639,40,575,2
0X77CF3CC14C7190A9.avi,886,51,1244,37,358,2
0X77D07E4FBCC59B0D.avi,769,69,1278,50,509,2
0X77D12C545D5C9ACD.avi,1594,65,1864,49,270,2
0X77D53936A055CA6.avi,1773,87,3276,65,1503,2
0X77D9BAB1ED5B5837.avi,1641,101,2452,81,811,2
0X77DA468737612781.avi,827,15,1406,0,579,2
0X77DFC0A0B3DA48DD.avi,1215,87,1809,60,594,2
0X77E1E067C24C6E82.avi,1323,73,2009,60,686,2
0X77E79D44922605D6.avi,1161,62,1846,46,685,2
0X77EE3CD923A3952A.avi,1980,66,2899,56,919,2
0X77EE9E3399043D40.avi,1077,71,1769,53,692,2
0X77EF9056FBABD0D6.avi,1531,130,1968,113,437,2
0X77F114E014535570.avi,1460,66,2538,49,1078,2
0X77F14DF18E757A6A.avi,1318,111,2521,95,1203,2
0X77F50BC6874F0950.avi,1344,92,1956,78,612,2
0X77F76DB5C3A42E76.avi,2277,126,2546,113,269,2
0X77F8C9F85AF592BF.avi,1295,117,2196,100,901,2
0X77FC68F7D0062C8A.avi,1263,131,1819,117,556,2
0X77FDD36CF78C6B3E.avi,768,18,1224,0,456,2
0X77FE84AC7ED08242.avi,858,82,1331,72,473,2
0X7801FF9E1465E078.avi,1731,114,2357,94,626,2
0X7804E51BBB763327.avi,1185,105,2187,89,1002,2
0X7807A42169BABF20.avi,1102,109,1739,93,637,2
0X7809B942D62CFBB5.avi,1134,72,1792,54,658,2
0X780AD0B949EEDBA0.avi,742,71,1063,53,321,2
0X780CE7F5E87A038.avi,860,15,1387,1,527,2
0X780D5E4FEC1EC3B2.avi,1034,147,1769,126,735,2
0X781152F1005A1522.avi,1127,107,1770,131,643,2
0X78118555A5C07E29.avi,1151,52,1850,36,699,2
0X7817540F1219A27C.avi,1183,17,1828,2,645,2
0X781C2C22B0A7C2E3.avi,1200,16,1615,3,415,2
0X781D97826A1BF672.avi,1656,90,2672,76,1016,2
0X781FFD3CCFF0CA8E.avi,1076,126,1565,108,489,2
0X78284C66D3F96F3.avi,787,16,1203,0,416,2
0X782AA3BADF83BB72.avi,3085,85,3296,68,211,2
0X7833AEF73CFD8BD5.avi,1058,124,1844,107,786,2
0X783756A8026DBC56.avi,1821,72,2584,58,763,2
0X78434E61DCE25DC8.avi,888,127,1196,117,308,2
0X7843FB4B296F52B6.avi,1283,117,1789,102,506,2
0X7846A393403DCE9A.avi,704,144,1052,128,348,2
0X7849B8B5FE76FE05.avi,713,63,1197,48,484,2
0X7849D7A045150574.avi,862,124,1523,103,661,2
0X784E5B7183AC020E.avi,1160,21,1825,4,665,2
0X7850CA363820BC1C.avi,972,105,1713,86,741,2
0X7855B4CFD2774B4A.avi,1534,102,2080,88,546,2
0X7858426972D973B3.avi,1875,120,2785,103,910,2
0X78586838FB284ED2.avi,1881,162,2378,185,497,2
0X78591777FB7F524B.avi,1131,92,1836,81,705,2
0X7859D0AF85077667.avi,767,72,1289,55,522,2
0X785B0B7BAD1E6DF0.avi,1012,77,1566,59,554,2
0X785B6EB4524C1CD3.avi,1358,46,2321,32,963,2
0X785B8C83B95EA6C4.avi,1335,23,1997,2,662,2
0X78603C5A9F6ADF4E.avi,2215,62,2754,44,539,2
0X786686A9B8DE6547.avi,593,84,964,70,371,2
0X786F77982DF76767.avi,718,97,1092,89,374,2
0X786F954EC983199B.avi,900,70,1429,52,529,2
0X7871A13A25E72847.avi,1588,101,2398,84,810,2
0X7872F013CA424271.avi,880,113,1339,84,459,2
0X787792F77911F6F.avi,2239,70,2427,50,188,2
0X787E4FC76615DF81.avi,809,79,1216,70,407,2
0X7889C9C82EAA329B.avi,986,48,1523,40,537,2
0X788B2560A356EFFD.avi,1908,132,2872,118,964,2
0X788C21FC83ECEA3.avi,1647,148,2473,130,826,2
0X788E36C66B235B5.avi,804,69,1197,53,393,2
0X7891B8459BC3756F.avi,998,92,1671,77,673,2
0X78926CFAF2EA0A0.avi,1174,20,1997,3,823,2
0X78980D66F6E94B79.avi,1048,118,1730,100,682,2
0X78981EA114F87C17.avi,1542,126,2555,105,1013,2
0X789C6979A03B622B.avi,1274,81,2004,66,730,2
0X789F3DB99F9D56CE.avi,1017,74,1627,57,610,2
0X78A2ADFE42F241BD.avi,741,79,1222,58,481,2
0X78A317925103BFA3.avi,973,91,1466,79,493,2
0X78A41CFB09841F00.avi,1308,24,2017,5,709,2
0X78A6383CDA0DFA47.avi,786,100,1177,81,391,2
0X78A712A3ED524435.avi,1615,48,3245,34,1630,2
0X78A88D003F122C35.avi,1130,52,1650,35,520,2
0X78AB39630A7770BC.avi,1164,20,1773,2,609,2
0X78AC53487A0B4174.avi,1305,195,1980,178,675,2
0X78B1A9C5DBBE470C.avi,721,66,1280,51,559,2
0X78BAA3A2FD0AE7F1.avi,1259,50,1875,34,616,2
0X78C330A341555880.avi,763,56,1273,41,510,2
0X78C6315BF03ABDA0.avi,949,52,1064,37,115,2
0X78C8E91921348D87.avi,1037,79,1685,65,648,2
0X78CDE711CB9223A5.avi,1338,135,2123,118,785,2
0X78D655F26D43004C.avi,878,74,1494,58,616,2
0X78D7E9160D4678EA.avi,727,74,1176,58,449,2
0X78DC5645033F242A.avi,1411,176,1906,158,495,2
0X78ED1868FE9D92E.avi,2944,173,3709,139,765,2
0X78EF8C888EA44499.avi,1823,103,2760,82,937,2
0X78F080F8C0B17CAC.avi,1383,127,1942,105,559,2
0X78F0A016752E04BC.avi,579,69,948,56,369,2
0X78FAF371B4DBE44E.avi,1741,119,2636,100,895,2
0X78FC560A2C3016C8.avi,777,172,1248,158,471,2
0X790031A481B03F12.avi,853,93,1339,86,486,2
0X7904206A590AD5FF.avi,820,133,1348,118,528,2
0X7904526507C77812.avi,1576,146,2570,130,994,2
0X790508AEB126988F.avi,1171,48,1509,28,338,2
0X7906AC315D6DF35C.avi,719,84,1129,67,410,2
0X790A3B476F1281A1.avi,2056,45,2490,34,434,2
0X790C79124FE1C985.avi,990,157,1570,140,580,2
0X790C871B162806D2.avi,1041,18,1579,0,538,2
0X790DD9CAD22463CA.avi,958,40,1272,29,314,2
0X790F741C3212659B.avi,906,61,1414,44,508,2
0X79116483627C83FB.avi,2531,55,3140,38,609,2
0X79137B32737A8141.avi,881,78,1440,60,559,2
0X7915D945D952B139.avi,1276,101,2096,87,820,2
0X7917B2BCFC48DE01.avi,1142,89,1989,68,847,2
0X7921E34728F85917.avi,1408,56,2362,37,954,2
0X7923B6B4614AF456.avi,1301,18,1779,4,478,2
0X7923DC7612E3B47.avi,652,52,1166,37,514,2
0X7925C344B4A5872F.avi,1463,22,2572,56,1109,2
0X7928A2EE4CEF22F6.avi,1471,76,1852,58,381,2
0X792BB639F04589BF.avi,1864,25,2829,2,965,2
0X792F6CC3B5F51F92.avi,729,44,1210,31,481,2
0X792FD48B11CB327F.avi,854,128,1357,113,503,2
0X7933EC90C09036BB.avi,1321,91,1931,77,610,2
0X7934C29136B9E43E.avi,1696,35,1704,53,8,2
0X793578146859F2C9.avi,1038,94,1724,74,686,2
0X793831EF15DE432A.avi,1180,83,1822,70,642,2
0X7943AD7E68A9860E.avi,995,73,1514,50,519,2
0X794FD97F585E5500.avi,852,69,1337,56,485,2
0X794FDC47120BED40.avi,948,49,1365,36,417,2
0X795D88887DD0C961.avi,1768,78,2972,61,1204,2
0X79604A39051DBA4E.avi,1185,114,1969,92,784,2
0X7961335E2F13823A.avi,1253,94,2202,80,949,2
0X79669F8008E1EB9B.avi,3562,90,3848,79,286,2
0X7968FBFB3A8B73D4.avi,1824,69,2652,48,828,2
0X796D96C289660E32.avi,874,98,1475,86,601,2
0X796FE72A47DAC27A.avi,954,17,1696,0,742,2
0X797680E4E4D3A9EC.avi,2326,101,3485,83,1159,2
0X797CA10A7CDE384B.avi,831,80,1489,60,658,2
0X7981CC0C94FC7EFC.avi,1590,65,2146,50,556,2
0X7985E3E4BA6F1EEA.avi,884,86,1454,60,570,2
0X798EA367FD9FD1EA.avi,928,75,1581,103,653,2
0X7991910507FF074F.avi,1101,120,1907,102,806,2
0X79921FA17BDD6678.avi,1275,58,1900,43,625,2
0X79921FB7E516EE1F.avi,813,112,1308,94,495,2
0X799797D05A6A8328.avi,1150,93,1637,80,487,2
0X799A232B2818C3BB.avi,1750,119,2340,104,590,2
0X799F64CF2E4B98EB.avi,939,78,1407,55,468,2
0X79A37CEF1E1797D9.avi,1265,57,2338,44,1073,2
0X79AD01697FA403C6.avi,1078,61,1686,45,608,2
0X79B116E3D0B6B1E2.avi,870,125,1300,107,430,2
0X79B3467FF294267F.avi,1726,19,2687,0,961,2
0X79B8C7CC275750D0.avi,931,137,1489,122,558,2
0X79BFA0749EA72B51.avi,1259,84,1969,59,710,2
0X79C4711A7BF18DD9.avi,955,118,1556,100,601,2
0X79C5E146E59872EA.avi,1047,62,1839,47,792,2
0X79CBB5F0922D0FDC.avi,747,121,1237,102,490,2
0X79CCAED9E51AB16.avi,1097,119,1834,93,737,2
0X79CDCC08F41F94D8.avi,1209,51,2179,37,970,2
0X79D202AB0932C8A8.avi,1115,61,1781,46,666,2
0X79D21EF8F7119A68.avi,1451,63,1776,44,325,2
0X79D327865853B75E.avi,1599,84,2578,67,979,2
0X79D4284DDF83A529.avi,891,19,1478,2,587,2
0X79DB58E266AEB979.avi,1631,59,1995,50,364,2
0X79DC993B122D6A82.avi,1612,93,2823,82,1211,2
0X79DD4F3B7A13EEA2.avi,1498,79,1598,63,100,2
0X79DFA3F8C5BD03E1.avi,1599,65,1791,49,192,2
0X79DFCFF4867CB797.avi,1040,100,1411,78,371,2
0X79E1574A83CD787C.avi,705,118,1104,97,399,2
0X79E1F33063F55D0.avi,1801,107,2612,90,811,2
0X79E246BD39A8835E.avi,955,104,1580,86,625,2
0X79E2DE8393F31357.avi,1305,41,1535,24,230,2
0X79E5E594E59FA593.avi,957,114,1500,96,543,2
0X79E5EFBA02DBE63D.avi,964,60,1496,43,532,2
0X79E6261DF5CE752C.avi,940,115,1517,104,577,2
0X79E68FC6793DC38D.avi,1084,97,1891,82,807,2
0X79EC6D48771F2C16.avi,1155,38,1821,32,666,2
0X79EEEACC28A079B3.avi,1066,142,1755,126,689,2
0X79EF2E23A698C2B1.avi,2804,58,4058,46,1254,2
0X79F1B78EF230D0C.avi,1284,128,1999,108,715,2
0X79F95870BD482C00.avi,1681,89,2750,68,1069,2
0X79FD74BD1C6B18A1.avi,1256,95,1936,77,680,2
0X79FEA7283354A6D4.avi,1061,104,1564,90,503,2
0X7A0010EC59FC1A1C.avi,1616,59,2544,47,928,2
0X7A0139AECBC02A88.avi,961,107,1586,89,625,2
0X7A0224D0CBD322D0.avi,766,54,1071,39,305,2
0X7A060E2FFC1A750C.avi,1975,60,2904,42,929,2
0X7A0A019AFB36B515.avi,1614,76,1757,59,143,2
0X7A0D58570271FED5.avi,1204,57,1566,41,362,2
0X7A0E6F5825AEC419.avi,905,137,1465,105,560,2
0X7A0F2BE6B7655842.avi,1538,114,1864,96,326,2
0X7A10F6BCBD21FFD6.avi,1508,95,1843,77,335,2
0X7A12F53BAAE9016C.avi,1380,21,2434,4,1054,2
0X7A153F772A883CA0.avi,915,47,1516,33,601,2
0X7A18EB9388515AC6.avi,2158,56,2930,43,772,2
0X7A19E0EBE51B99AD.avi,1929,73,2228,56,299,2
0X7A1EF125CAECF905.avi,1417,85,2504,64,1087,2
0X7A21DE7A58B915DD.avi,755,24,1168,1,413,2
0X7A2F23DE3B4A8543.avi,1764,76,2263,52,499,2
0X7A32FE05734D3EC6.avi,1142,52,1853,41,711,2
0X7A36F71B6647D596.avi,829,84,1189,63,360,2
0X7A3ACD77CBDBB65.avi,1166,55,2056,42,890,2
0X7A3D3EC1A0D798F0.avi,3773,16,5111,1,1338,2
0X7A3DFD0BC51267F8.avi,1032,116,1733,101,701,2
0X7A489C593ADEDF80.avi,1024,114,1399,95,375,2
0X7A49B980EAACB689.avi,1005,163,1521,148,516,2
0X7A4ABCBDD9D9F33A.avi,1131,55,1896,36,765,2
0X7A4FD5194E7FAFF6.avi,1011,61,1745,45,734,2
0X7A50108623519FF8.avi,1066,100,1739,86,673,2
0X7A5DA8496F2DF4B0.avi,1704,56,2587,45,883,2
0X7A616EA9F1DD0684.avi,911,76,1472,60,561,2
0X7A61928840F41939.avi,444,84,735,69,291,2
0X7A61CC6DF656DB9E.avi,1757,19,2118,5,361,2
0X7A620C5C256333CF.avi,1691,189,2804,164,1113,2
0X7A66617547DFC6A9.avi,805,49,1235,39,430,2
0X7A67867B96A7DB62.avi,946,102,1524,88,578,2
0X7A6EEE9D2CC4DDD8.avi,915,62,1506,46,591,2
0X7A70F384131D3E87.avi,1694,181,2421,164,727,2
0X7A7323714436A96A.avi,1060,63,1848,45,788,2
0X7A753FB6A09BB7E7.avi,1400,55,2457,40,1057,2
0X7A75982F479C21BD.avi,1473,71,2220,54,747,2
0X7A761FAB53996A17.avi,974,118,1723,102,749,2
0X7A764AEB1EEFFBE9.avi,800,20,1244,1,444,2
0X7A77DF8AACD6E023.avi,910,132,1430,116,520,2
0X7A7D9FE81266344B.avi,966,180,1535,166,569,2
0X7A7FFFEB3BB8FACF.avi,656,73,1121,58,465,2
0X7A801758B1E2422D.avi,879,53,1493,41,614,2
0X7A85506EE6948707.avi,2182,88,3116,73,934,2
0X7A85BE2A483D2B3F.avi,800,98,1434,82,634,2
0X7A878CE8EF95A413.avi,1614,18,2291,2,677,2
0X7A8B5F7B228E4737.avi,1376,46,2035,35,659,2
0X7A8E80694D4485A8.avi,1138,118,1821,101,683,2
0X7A94BF20F663B054.avi,1216,60,1995,44,779,2
0X7A97FAB0F842279A.avi,764,79,1074,66,310,2
0X7A981DF5E84D198C.avi,2108,108,3353,95,1245,2
0X7A9F05D78B1F4919.avi,1834,60,2777,44,943,2
0X7AA24540A6E405A1.avi,2455,69,2915,52,460,2
0X7AA34F9FBA7212D6.avi,1139,56,1744,42,605,2
0X7AAB12A381313F99.avi,909,55,1549,39,640,2
0X7AB103757B8047FC.avi,1024,76,1904,60,880,2
0X7AB1F1372A66F7FB.avi,1208,137,1790,124,582,2
0X7AB1FC4869E885A.avi,2331,71,2622,51,291,2
0X7AB682A3B8DEC28A.avi,1463,96,1719,72,256,2
0X7AB6F8E417D8840B.avi,1147,72,1786,50,639,2
0X7ABDE075D44C8588.avi,1129,57,1550,37,421,2
0X7ABE255108B5D960.avi,1781,67,2305,55,524,2
0X7ABF95CFB129BA92.avi,1022,54,1386,41,364,2
0X7AC4DF00D0AADA44.avi,925,157,1546,139,621,2
0X7AC5B09AD65C17DB.avi,1957,17,3457,0,1500,2
0X7ACA82C5A670004C.avi,632,70,1006,59,374,2
0X7ACDCFB7A4056641.avi,1258,165,1531,150,273,2
0X7AD378073EC75A33.avi,1144,307,1725,287,581,2
0X7AD45F74C08CFE5C.avi,1368,58,2190,39,822,2
0X7ADCFA2C3BD93CB2.avi,1680,95,2718,69,1038,2
0X7AE76966D714CE68.avi,1277,18,1941,1,664,2
0X7AE9B88968450BB7.avi,1346,183,1855,160,509,2
0X7AEB162B3A45EAA9.avi,1178,58,1778,42,600,2
0X7AEFC179509EEEA6.avi,1743,51,3050,35,1307,2
0X7AF2DF90B850F22C.avi,541,22,766,3,225,2
0X7AF5420EB5D8A0D3.avi,990,167,1469,151,479,2
0X7AF69DD2E26966D7.avi,1106,15,1709,3,603,2
0X7AFA36E0847EEF8A.avi,860,52,1426,37,566,2
0X7AFF447DBE3CC46.avi,945,18,1540,2,595,2
0X7AFF5B2DEEE839B9.avi,525,47,785,35,260,2
0X7B07C72D814BF24A.avi,1010,99,1493,90,483,2
0X7B11085407253356.avi,2085,15,2625,3,540,2
0X7B1F112049D754D9.avi,1340,58,2352,41,1012,2
0X7B2564212B59E8BD.avi,1070,90,1815,77,745,2
0X7B2E8A51DCBBA0DE.avi,1648,135,2339,116,691,2
0X7B361D8604999C29.avi,1641,122,2668,108,1027,2
0X7B36CA7499CCB34D.avi,973,64,1569,46,596,2
0X7B4062501918819C.avi,2112,57,2335,40,223,2
0X7B5573AAB7FF0B.avi,961,67,1673,51,712,2
0X7B58E92EA5E26F04.avi,983,43,1537,29,554,2
0X7B594349510CCAE4.avi,1147,122,1663,104,516,2
0X7B5A055AF729EDF2.avi,1513,55,2357,40,844,2
0X7B5A83BBE8DB9B19.avi,1047,76,1696,57,649,2
0X7B5BD31A9B927EA9.avi,2045,71,2707,54,662,2
0X7B64C66425F826C9.avi,1031,66,1532,47,501,2
0X7B67867A2E9C59E9.avi,1084,119,1731,100,647,2
0X7B6C5217AFE9F3C1.avi,855,47,1441,36,586,2
0X7B6F98E0BA891F6D.avi,1297,68,2033,50,736,2
0X7B73DF444BEF7269.avi,1633,68,2090,50,457,2
0X7B75B05FC679E58E.avi,1199,67,1903,48,704,2
0X7B76CB1D495CDC4A.avi,1783,150,2586,134,803,2
0X7B782548CD60DD17.avi,1395,64,2033,49,638,2
0X7B7DCCB4D78CD5BD.avi,773,90,1232,79,459,2
0X7B7ECB319911B032.avi,1477,83,2075,61,598,2
0X7B82FDB13CF2CE3.avi,843,74,1384,56,541,2
0X7B8526A405DEB964.avi,1775,79,2204,58,429,2
0X7B8F542F991D908F.avi,1350,99,2043,86,693,2
0X7B91BB399D1EF0E0.avi,1811,80,3287,72,1476,2
0X7B93FAE7841C1826.avi,770,184,1324,164,554,2
0X7B96EB2565E5E0F7.avi,639,13,1068,2,429,2
0X7B982CE3A8C024F4.avi,1400,104,2184,88,784,2
0X7B9A154FC4B9A975.avi,2850,71,4401,46,1551,2
0X7B9BCBCF1AC67C22.avi,944,48,1467,28,523,2
0X7B9D5C68AB322E27.avi,870,97,1404,78,534,2
0X7BA1B13AB4EC602D.avi,2419,55,2711,40,292,2
0X7BA58229FCBA50B3.avi,1179,66,1811,53,632,2
0X7BA58F095A0EDE7E.avi,853,79,1377,58,524,2
0X7BA9FD251A48D45B.avi,1324,112,1707,96,383,2
0X7BB1CB83B94EB317.avi,1271,152,1904,133,633,2
0X7BC38D46D3D3750C.avi,1906,77,2163,61,257,2
0X7BC3BD3B6AA3AFD.avi,1060,68,1778,51,718,2
0X7BC5E5DDF9DBE9F1.avi,1575,67,1856,54,281,2
0X7BC611E29496FD3E.avi,1298,54,1903,38,605,2
0X7BC859C176E9E6DB.avi,1323,95,2237,73,914,2
0X7BC908B49BFFD76D.avi,643,69,914,56,271,2
0X7BCC548D2F2EEEE5.avi,914,73,1472,58,558,2
0X7BCDD67EB4F5945E.avi,963,82,1424,59,461,2
0X7BCEF24F83447FFE.avi,2374,21,3324,3,950,2
0X7BCEF35CEC8302A4.avi,1560,16,2438,3,878,2
0X7BD00517B6ED440D.avi,1038,96,1730,68,692,2
0X7BD009AA7B30A5D8.avi,1209,131,1811,112,602,2
0X7BD1EFE780ACD70B.avi,734,69,1193,54,459,2
0X7BD38A944FB7D285.avi,750,46,1060,34,310,2
0X7BD3D2A65C18A4CA.avi,756,161,1084,146,328,2
0X7BD51A04F3D1AF7.avi,1909,72,2307,52,398,2
0X7BD6977487C29ECF.avi,1254,136,1594,114,340,2
0X7BD7893522AEAB1E.avi,1115,110,1968,95,853,2
0X7BE4A633CA420375.avi,1667,65,2061,45,394,2
0X7BE6BA90FB9BC4C6.avi,885,48,1381,36,496,2
0X7BE93FB0FD83D91D.avi,1605,117,2409,101,804,2
0X7BECA917CA87A9DA.avi,1101,129,1588,111,487,2
0X7BED18C482386E18.avi,657,56,1137,40,480,2
0X7BF746EB936C65BE.avi,1204,35,1875,25,671,2
0X7BFEEBCCC38DB440.avi,1246,130,1548,115,302,2
0X7BFFFB7899AF3782.avi,1475,53,2040,35,565,2
0X7C053B5DB5BAEB83.avi,1357,122,2112,105,755,2
0X7C076CFBDD1CB990.avi,1201,56,2116,40,915,2
0X7C084027BD7966B9.avi,671,15,1072,0,401,2
0X7C0C60C983B89520.avi,952,156,1445,136,493,2
0X7C1078ADB86F63B2.avi,883,55,1171,40,288,2
0X7C10D53910F69D61.avi,1832,71,2890,51,1058,2
0X7C11A719A3C02AD3.avi,1310,16,2217,0,907,2
0X7C11CAFF545777DC.avi,1052,52,1405,38,353,2
0X7C1277ADCD83E8BA.avi,976,98,1501,84,525,2
0X7C1A4682049A9C62.avi,1316,69,1792,52,476,2
0X7C1B2513F22715C8.avi,1728,87,2941,75,1213,2
0X7C1B6369CCFFBDDF.avi,984,110,1559,95,575,2
0X7C1E9F9F4993DFFC.avi,1224,70,1911,56,687,2
0X7C202E81AFCC7010.avi,1077,52,1677,37,600,2
0X7C2086652C808B3D.avi,1044,147,1659,122,615,2
0X7C23C2D126878C83.avi,1220,55,1801,42,581,2
0X7C2B6DE932E8EB4D.avi,1145,124,1617,107,472,2
0X7C371BCB4ACF8CFD.avi,1089,145,1707,132,618,2
0X7C3724DE3C2BBEA6.avi,699,71,1503,53,804,2
0X7C39285C0277DBB5.avi,1435,93,2064,78,629,2
0X7C39483D6FC66806.avi,1066,55,1752,39,686,2
0X7C3A04F6182C79D6.avi,1472,80,2751,60,1279,2
0X7C3A0715974A7250.avi,903,67,1570,49,667,2
0X7C3C3EE6582C429A.avi,1139,173,2052,153,913,2
0X7C3CA2BC6A6EE986.avi,998,109,1546,83,548,2
0X7C47EF804F3367E8.avi,1493,67,2543,52,1050,2
0X7C499024B4A4DA1A.avi,1792,80,2718,62,926,2
0X7C54E0438C0F6AB5.avi,828,65,1185,42,357,2
0X7C567D0F1DAB3620.avi,1466,100,2165,86,699,2
0X7C5C65685D6ABC7A.avi,1116,66,1794,49,678,2
0X7C5CE94A1B662182.avi,1217,62,1807,46,590,2
0X7C65DA147A4EA7E1.avi,1311,72,2101,50,790,2
0X7C6A6F5AE74EB074.avi,1618,54,2396,37,778,2
0X7C6D2CA9F2B482CF.avi,943,77,1500,57,557,2
0X7C6D449DEDF42EE8.avi,1657,94,2489,74,832,2
0X7C6FB8F7CE82D404.avi,1841,14,2357,0,516,2
0X7C6FC9FFABD5BC8D.avi,1119,50,1691,40,572,2
0X7C6FEF42346665BB.avi,1584,135,2019,116,435,2
0X7C7BD92BD4602CAA.avi,1225,104,1676,88,451,2
0X7C7CB880947C5C5C.avi,1343,67,1606,46,263,2
0X7C7D65DB11064625.avi,1245,119,2153,102,908,2
0X7C7EB193BEC5D926.avi,1627,49,2914,33,1287,2
0X7C7F2E7816DBE8C1.avi,1518,149,2576,134,1058,2
0X7C883F8B60AF5C02.avi,1266,60,1962,44,696,2
0X7C88FB0DAAC98643.avi,952,50,1472,36,520,2
0X7C8C939686F0D276.avi,2351,106,2814,95,463,2
0X7C939BD6B4574A80.avi,1410,58,1845,43,435,2
0X7C9F6CBD094B0359.avi,1283,21,1986,50,703,2
0X7CA0A2B5B1F8A134.avi,1055,57,1744,42,689,2
0X7CA10684E319705F.avi,1186,108,1636,92,450,2
0X7CA133BB031E0FFD.avi,1329,60,2199,39,870,2
0X7CA15DC6A1C6DA13.avi,1147,95,1933,78,786,2
0X7CA9A912598CA322.avi,3208,128,4663,108,1455,2
0X7CA9F39E5042977C.avi,606,65,949,45,343,2
0X7CAE371CDC897CE6.avi,1074,48,1722,42,648,2
0X7CAE69437044224A.avi,1704,78,2587,56,883,2
0X7CB071721715D80F.avi,2341,78,2687,71,346,2
0X7CB28DF1B556246B.avi,2966,123,5068,107,2102,2
0X7CB7207DB5849348.avi,960,59,1455,44,495,2
0X7CB7C518E22849C0.avi,790,54,1430,39,640,2
0X7CBAA73896DCFDB9.avi,1723,70,2082,53,359,2
0X7CBDDB20A1855D5B.avi,1039,147,1425,130,386,2
0X7CC04BF5B6684CEE.avi,899,18,1433,2,534,2
0X7CCAC8AD825CB21A.avi,952,46,1499,30,547,2
0X7CCD7AEC19D4AFE8.avi,1415,61,2331,43,916,2
0X7CD73F9F79E1F4DE.avi,1802,70,3048,50,1246,2
0X7CDAB7D00122C00F.avi,1344,55,1590,36,246,2
0X7CDC48EE66ABB915.avi,1156,78,1908,62,752,2
0X7CDF036B61A17CC3.avi,1184,73,1879,53,695,2
0X7CE0D85A16659110.avi,936,54,1473,39,537,2
0X7CE3B7D2F8976E7D.avi,1073,62,1757,44,684,2
0X7CE6275BC5A013A0.avi,2249,71,2946,54,697,2
0X7CE6AFF52A6B8670.avi,1385,82,2252,70,867,2
0X7CE7F41BF99545F6.avi,1210,81,1691,72,481,2
0X7CE9AAE0242EF73D.avi,1492,104,2457,87,965,2
0X7CEA8E5FA8F3FB3F.avi,1745,166,2201,152,456,2
0X7CEB5315352C1FC9.avi,2370,119,2939,96,569,2
0X7CEF57328013C8B6.avi,900,10,1360,4,460,2
0X7CF265240EBC0648.avi,969,142,1606,125,637,2
0X7CF70061E3B47DE6.avi,1066,97,1749,84,683,2
0X7CFF2E1311F09165.avi,961,14,1536,1,575,2
0X7D011309F536A7E0.avi,1034,90,1639,76,605,2
0X7D01D8A3BF2A3A46.avi,1377,57,2181,41,804,2
0X7D0223AF4A3B9955.avi,2050,77,3464,57,1414,2
0X7D06F10AF881B055.avi,1082,105,1589,90,507,2
0X7D0AC305541BEEAA.avi,1150,111,1883,97,733,2
0X7D0FC6E69A6AD15A.avi,1541,84,2253,68,712,2
0X7D1234DED3EAC45.avi,782,89,1348,75,566,2
0X7D129213628239FA.avi,1708,161,2600,144,892,2
0X7D131134E996F284.avi,1780,58,3212,43,1432,2
0X7D1BEA2D8E1CF02E.avi,798,66,1266,48,468,2
0X7D1E11429C92D9FB.avi,1060,74,1645,55,585,2
0X7D1F59C70EC5E749.avi,877,87,1312,64,435,2
0X7D2089086EF49B62.avi,2877,45,3310,32,433,2
0X7D2478A652A3B024.avi,1748,68,2606,46,858,2
0X7D24D09D4B66FB12.avi,1712,81,2984,63,1272,2
0X7D25EEAD9C236D01.avi,998,74,1616,55,618,2
0X7D263C90CF9FCAB7.avi,1062,62,1576,41,514,2
0X7D2C9FE972A828D3.avi,907,125,1421,111,514,2
0X7D32BEF617ED61E9.avi,1022,55,1531,39,509,2
0X7D34DA638DFF03C6.avi,1044,93,1625,76,581,2
0X7D37F4AEEDA7A721.avi,920,64,1568,49,648,2
0X7D39012AC4B412BE.avi,1024,112,1582,95,558,2
0X7D39A36B39114D.avi,865,15,1388,3,523,2
0X7D3A348B868CFCB2.avi,2753,74,4526,60,1773,2
0X7D3AA96EF70A00D5.avi,1110,17,1940,0,830,2
0X7D3CE6662D2113FA.avi,821,63,1271,53,450,2
0X7D41714643A4524D.avi,971,101,1530,81,559,2
0X7D466FE3AC012BBB.avi,1269,77,1913,56,644,2
0X7D469692EDE2EF91.avi,1268,45,2361,35,1093,2
0X7D47E45DC22458A.avi,1095,16,1615,2,520,2
0X7D4C42BDA9299A46.avi,1272,95,1937,77,665,2
0X7D4E031123DA9E4F.avi,652,79,1035,66,383,2
0X7D4E2B016F111A25.avi,989,110,1202,94,213,2
0X7D52513975CDE18F.avi,1147,42,1786,32,639,2
0X7D52A5663195DC72.avi,1109,98,1860,81,751,2
0X7D537B2C2CDCB140.avi,929,184,1437,171,508,2
0X7D567F2A870FD8F0.avi,1386,117,1605,102,219,2
0X7D57150EFE76C557.avi,809,71,1260,60,451,2
0X7D5A835A93B83445.avi,1714,20,2805,1,1091,2
0X7D5C2B6F2A436FA1.avi,1594,70,2031,53,437,2
0X7D61161FC3365FF8.avi,2596,86,2759,72,163,2
0X7D63A7259A3897D0.avi,1892,105,2253,79,361,2
0X7D687BF5AC8C33FF.avi,580,31,990,26,410,2
0X7D6FE68C1C17A7C6.avi,1055,99,1537,77,482,2
0X7D714831754A6554.avi,1027,48,1599,38,572,2
0X7D73E6E86837FFD9.avi,1362,89,1981,69,619,2
0X7D74FC40A9B3DEFE.avi,1120,94,1820,75,700,2
0X7D759A4FA9F2837.avi,1529,41,2667,21,1138,2
0X7D75B913B4E1EA73.avi,2275,62,4489,44,2214,2
0X7D78994E4A3FCC6D.avi,2316,20,2681,5,365,2
0X7D78F3613852C759.avi,1280,63,1890,46,610,2
0X7D7C468C359E3E07.avi,957,134,1319,117,362,2
0X7D8600F1074A1731.avi,1620,78,2602,57,982,2
0X7D8896D7ABA514A8.avi,2056,130,2679,105,623,2
0X7D88E00C316BF203.avi,1165,64,1742,50,577,2
0X7D8ABCFB75E1ADBB.avi,1760,57,2152,38,392,2
0X7D8D06DE42E09937.avi,1250,109,1994,94,744,2
0X7D919A10DD368B11.avi,1763,55,2485,37,722,2
0X7D94F81C5387DFB9.avi,1009,82,1788,73,779,2
0X7D99736023C684B0.avi,1086,166,1657,155,571,2
0X7D9F7769029B6B6C.avi,1078,42,1461,32,383,2
0X7DA2B79E3C7E5531.avi,1662,94,3038,77,1376,2
0X7DA74EAC9DFC2D5B.avi,1238,70,1937,54,699,2
0X7DA7FE6D7C38E348.avi,913,68,1554,50,641,2
0X7DAE3C83E62D7300.avi,1182,65,1907,49,725,2
0X7DBCD32E64B1AB22.avi,1151,146,1847,129,696,2
0X7DBD9306566CBD10.avi,1055,54,1744,37,689,2
0X7DBEF3FB9A0BCA64.avi,1009,149,1774,132,765,2
0X7DBEFBE8095593DB.avi,1298,69,1872,54,574,2
0X7DC0B4B357668325.avi,1170,104,2039,88,869,2
0X7DC3724BF02AC1D0.avi,1540,104,2303,84,763,2
0X7DC3F04A5A3EA2FB.avi,1168,84,1972,71,804,2
0X7DC7546F7690E198.avi,806,56,1205,41,399,2
0X7DD0CDE4F55D32BF.avi,2787,16,4299,0,1512,2
0X7DD29CE777E65CEC.avi,1682,62,1911,49,229,2
0X7DD583CBA190CCCA.avi,1100,72,1793,51,693,2
0X7DDD45D433603256.avi,925,67,1477,52,552,2
0X7DDDD231EBB796C1.avi,846,17,1386,3,540,2
0X7DDF0EC1E66C7415.avi,855,15,1427,3,572,2
0X7DE5F4D17C87F518.avi,1172,69,1912,52,740,2
0X7DE76E1393920C4C.avi,2465,78,3134,63,669,2
0X7DE8489883F940C7.avi,2009,77,2514,60,505,2
0X7DE8BF9416439516.avi,662,66,1216,49,554,2
0X7DE8E63672D26C40.avi,1104,125,1694,108,590,2
0X7DED63697C8793C1.avi,1205,75,1758,60,553,2
0X7DEDA8CF84A3A406.avi,954,18,1578,3,624,2
0X7DEF57A51BC30923.avi,1601,116,2079,97,478,2
0X7DF4117F27AA3D96.avi,1520,118,2378,106,858,2
0X7DF4CD457E50176D.avi,989,87,1653,71,664,2
0X7DF4F29C9FA848A4.avi,1857,71,2704,54,847,2
0X7DF5817CCA22438E.avi,705,129,1141,110,436,2
0X7DF5D27D4C9EAD89.avi,1209,48,2138,33,929,2
0X7DF70019168CB29B.avi,1055,56,1548,40,493,2
0X7DFAE6F2089B2594.avi,1067,86,1611,72,544,2
0X7DFF7BAA1B2E4700.avi,2829,84,3299,69,470,2
0X7E0135356970C1A1.avi,1163,95,1834,79,671,2
0X7E03DC0DBBD76FFE.avi,1468,44,2140,26,672,2
0X7E0565C38530F24C.avi,1293,73,2083,59,790,2
0X7E06DB07314DEC7.avi,3629,58,5529,39,1900,2
0X7E08C6E04DE8DB0F.avi,1284,17,1546,0,262,2
0X7E09E67C095EA7C0.avi,586,92,982,71,396,2
0X7E0ACE153EE2260F.avi,864,34,1515,24,651,2
0X7E1023DC25D3B318.avi,2435,101,3245,85,810,2
0X7E12D3121940CDF6.avi,1215,62,1795,42,580,2
0X7E15A2E78B07ADE2.avi,1404,55,1853,42,449,2
0X7E1703D6C05CEE3F.avi,940,35,1424,24,484,2
0X7E17E85D21D4D683.avi,1241,120,2081,101,840,2
0X7E1B29A2BE138FC.avi,1472,16,1953,0,481,2
0X7E1ED32C166D83A8.avi,1628,49,1946,34,318,2
0X7E22E4FE22BE624B.avi,913,30,1463,19,550,2
0X7E236CD4C4C6A4A7.avi,1408,86,2176,67,768,2
0X7E23FFF51EDA2FA7.avi,1904,166,2648,150,744,2
0X7E2437FA9BB9A9BE.avi,1403,17,2427,3,1024,2
0X7E245EA8FCB5B13.avi,966,143,1392,128,426,2
0X7E2898BDFAEEFE47.avi,1610,60,2395,42,785,2
0X7E2A6FAF7D5669F0.avi,990,70,1454,60,464,2
0X7E2CCCD26033DD2A.avi,1335,147,1889,126,554,2
0X7E2D179960B03654.avi,947,65,1641,50,694,2
0X7E2E682CAF764E00.avi,2060,119,2871,104,811,2
0X7E2E832595076130.avi,1098,75,1789,58,691,2
0X7E2E8534D07DDBE.avi,1035,55,1722,42,687,2
0X7E2F6A8A773EBE57.avi,1776,96,2568,77,792,2
0X7E2FF5B9369E2E51.avi,828,65,1280,50,452,2
0X7E32DC733A9F4C7.avi,1317,53,2115,40,798,2
0X7E338DE86354DFBB.avi,1117,15,1811,1,694,2
0X7E379B92108E37EF.avi,1015,59,1571,43,556,2
0X7E37D63514270905.avi,2122,81,2966,55,844,2
0X7E420105768FD9FE.avi,832,73,1342,54,510,2
0X7E429DC3AED5BE34.avi,1770,114,1932,107,162,2
0X7E43798B43C11709.avi,1177,68,1657,55,480,2
0X7E45FF332B9BE28E.avi,1408,59,1770,44,362,2
0X7E4639354A0AF043.avi,2092,74,2390,58,298,2
0X7E46A5FDB773F2FC.avi,2098,55,2268,37,170,2
0X7E4D98875A3BF1AB.avi,1025,106,1749,93,724,2
0X7E4F89B98A52555F.avi,1124,60,1880,46,756,2
0X7E51B1F0EBC1BD6C.avi,941,73,1386,52,445,2
0X7E53AE264125B7F9.avi,1383,83,1964,68,581,2
0X7E5F7C851AE9AF55.avi,1612,72,2468,52,856,2
0X7E654BC9652802D5.avi,1123,65,1575,56,452,2
0X7E655DBE953C1A73.avi,888,106,1477,95,589,2
0X7E673A7B6123F76C.avi,1000,114,1533,99,533,2
0X7E6AA3C86277C4E.avi,1241,157,1635,135,394,2
0X7E6CEE047BF80FF6.avi,1045,14,1879,2,834,2
0X7E6E3C03C2A05522.avi,2098,62,3111,45,1013,2
0X7E6E452DB3269A4F.avi,1184,114,1787,95,603,2
0X7E72FD13490DB722.avi,1085,50,1723,33,638,2
0X7E731D5758FB247F.avi,1352,109,1702,80,350,2
0X7E773DD1C25D761.avi,1273,76,2166,57,893,2
0X7E7BC8F597A191C6.avi,1736,63,2438,46,702,2
0X7E7C1BDAFEBB61FA.avi,1406,64,2115,48,709,2
0X7E7D546F8D68F445.avi,1293,73,2389,59,1096,2
0X7E83551D8C9C79BD.avi,1193,142,2007,124,814,2
0X7E8632AE4089326E.avi,2345,68,2590,44,245,2
0X7E870E21566FC34B.avi,978,69,1263,52,285,2
0X7E8800EA8C40DF0C.avi,1481,38,2436,24,955,2
0X7E8CCD93D8EA9D7.avi,1195,53,1574,38,379,2
0X7E9560406E173927.avi,1567,83,2643,67,1076,2
0X7E97922390602019.avi,1353,62,2232,43,879,2
0X7E991F3C31F6C17.avi,1439,67,2117,48,678,2
0X7E9BC4EAB9EEA7F9.avi,1819,48,2067,33,248,2
0X7EA59EE03F02C35B.avi,1620,114,2498,99,878,2
0X7EA8D9C268C16137.avi,1173,56,2004,42,831,2
0X7EB2FC6CD65F86D2.avi,832,178,1367,161,535,2
0X7EB4493502BE6170.avi,1724,87,2024,68,300,2
0X7EB490F7C2A158D8.avi,1779,162,2694,149,915,2
0X7EB6CE7A0EE060B0.avi,1314,58,2118,41,804,2
0X7EBA049982BB9A40.avi,1665,115,2786,96,1121,2
0X7EBB0C21B95DA27D.avi,1291,153,1827,128,536,2
0X7EBF7E6F42E75FC3.avi,889,98,1344,72,455,2
0X7EC12AC2BF084B28.avi,1746,108,2169,93,423,2
0X7EC4B89BCFA4841D.avi,922,54,1349,44,427,2
0X7EC67D9015EF4B0D.avi,1563,135,1751,116,188,2
0X7EC841CC6F0DC078.avi,703,136,1057,122,354,2
0X7EC96F4D9167A448.avi,1853,128,2137,113,284,2
0X7ECD0FC05155C51A.avi,1982,101,3594,84,1612,2
0X7ECD208BCBDB30FF.avi,971,202,1517,179,546,2
0X7ECF02812DE8EFCE.avi,1375,37,2115,25,740,2
0X7ED073E0F80E43D3.avi,1276,76,2097,56,821,2
0X7ED1E92FFFD1AF5C.avi,835,17,1229,3,394,2
0X7ED2FA1C9CE297BF.avi,666,46,1022,29,356,2
0X7ED3009A9CD8ADB5.avi,955,131,1601,116,646,2
0X7ED560E44F1FA0C4.avi,1022,215,1562,195,540,2
0X7ED6C6FC729A391B.avi,2084,77,3482,57,1398,2
0X7ED87AB27BE161FF.avi,989,50,1483,38,494,2
0X7EDFA78D3FB002B0.avi,955,84,1478,67,523,2
0X7EE27209D0508B79.avi,1410,65,2050,49,640,2
0X7EE47A0A4ABB0115.avi,2755,361,3248,314,493,2
0X7EE64D322158B13F.avi,993,138,1676,123,683,2
0X7EE933A1912A146.avi,895,128,1326,111,431,2
0X7EEA66DBE251854B.avi,1879,121,2304,100,425,2
0X7EEEA16525CC87E5.avi,1671,98,3100,84,1429,2
0X7EEFE2B06DC5E7D1.avi,1492,92,2278,78,786,2
0X7EF7C12373EF33BD.avi,1355,21,2018,3,663,2
0X7EFDA5A4CDF6C678.avi,1425,61,2176,45,751,2
0X7EFE15741DE591F6.avi,865,65,1509,51,644,2
0X7EFE1E76A839FA63.avi,829,110,1396,93,567,2
0X7F048295BF84C41B.avi,1178,141,1741,112,563,2
0X7F058A3503090EC8.avi,1028,17,1665,6,637,2
0X7F1E35093F4B437E.avi,1160,99,1915,81,755,2
0X7F1E7ABCC62403A0.avi,936,168,1570,150,634,2
0X7F20614AB09F7092.avi,1083,95,1491,76,408,2
0X7F2326218F61FEDE.avi,1006,158,1831,139,825,2
0X7F271243B0FAAA2D.avi,2523,36,2720,30,197,2
0X7F27475CB49B8FE.avi,1126,121,1888,102,762,2
0X7F2BC02FB5C2AFBC.avi,1030,83,1537,68,507,2
0X7F2CD5493EA12EBE.avi,1047,15,1703,2,656,2
0X7F33CFDB31ADCD6A.avi,1623,40,1928,95,305,2
0X7F3ABE82B6992583.avi,724,107,1248,97,524,2
0X7F3F1029C810EC0C.avi,2210,60,3354,44,1144,2
0X7F44B26015459155.avi,1602,49,2384,35,782,2
0X7F49972656B12401.avi,1019,119,1611,99,592,2
0X7F4A99BDBFC2182F.avi,1609,143,2447,124,838,2
0X7F4C057216F1A154.avi,1292,134,2152,118,860,2
0X7F50F813F8D25B5B.avi,1127,93,1444,83,317,2
0X7F59661D773B332C.avi,3123,146,3534,128,411,2
0X7F5987A4C2EE04A.avi,1487,124,1945,109,458,2
0X7F5CB71A507DF8D1.avi,939,54,1423,37,484,2
0X7F5FDD0D4BE306D8.avi,1518,76,1728,62,210,2
0X7F626207A5FD5189.avi,1267,70,2127,51,860,2
0X7F65556BA84EBBCB.avi,1318,45,1378,33,60,2
0X7F666F93B086F12C.avi,959,103,1496,89,537,2
0X7F6828554FDAF24.avi,883,97,1429,79,546,2
0X7F6B899860079B54.avi,3823,102,4363,87,540,2
0X7F6D009D54D33E63.avi,1222,53,1922,38,700,2
0X7F6DB8B3D4E8B55.avi,1032,67,1604,49,572,2
0X7F6E0885BC9B860B.avi,896,68,1432,49,536,2
0X7F7068CC85CAA239.avi,766,48,1163,37,397,2
0X7F729CDC1F8A8FB2.avi,1366,83,2510,65,1144,2
0X7F76F93FC067F40D.avi,1189,128,1497,113,308,2
0X7F83AF45B348B1D9.avi,1646,45,2684,33,1038,2
0X7F888CA2AE13003C.avi,953,154,1525,136,572,2
0X7F8C1AE16F2BE812.avi,1795,123,2573,108,778,2
0X7F8E427A8C0CAA8.avi,870,90,1277,73,407,2
0X7F9D0256F9D9B44F.avi,1801,81,2882,56,1081,2
0X7F9E684F7BD8FF64.avi,625,13,1069,1,444,2
0X7F9ED6D9B7543E46.avi,977,106,1470,86,493,2
0X7FA12212C7887EC7.avi,1134,45,2073,31,939,2
0X7FA1AACC44E2B13D.avi,1144,58,1817,42,673,2
0X7FA1DE5F5006E04B.avi,1050,116,1635,98,585,2
0X7FA40A4991567843.avi,823,85,1241,71,418,2
0X7FA84CF03DD99FD3.avi,904,112,1704,96,800,2
0X7FACBF00899A8ACF.avi,579,58,901,43,322,2
0X7FADA6C7AC45A389.avi,910,17,1397,0,487,2
0X7FB15C9CF30544A4.avi,671,16,984,1,313,2
0X7FB52DF47D58D5EF.avi,943,58,1421,40,478,2
0X7FB86702C128C3E7.avi,1481,125,2082,108,601,2
0X7FBA0A353972E8CE.avi,1874,54,2696,37,822,2
0X7FBBFD75F86988E1.avi,983,82,1522,62,539,2
0X7FBE933AD38C3009.avi,1561,110,2644,98,1083,2
0X7FCC13D41D507C64.avi,3355,56,3956,42,601,2
0X7FCE5D1FB46D6BDE.avi,772,92,1285,71,513,2
0X7FCF556C166C571.avi,1308,17,1857,7,549,2
0X7FD042711B0E1D27.avi,996,88,1539,72,543,2
0X7FD058A6306C7EF8.avi,1444,52,2519,37,1075,2
0X7FD0FEBD1D0CB00C.avi,2046,115,2503,94,457,2
0X7FDE5F6E1091C024.avi,1552,14,1726,0,174,2
0X7FDEEB42B822AABC.avi,817,69,1443,53,626,2
0X7FE0B07EC190E77D.avi,1586,66,2034,54,448,2
0X7FE0C465A0251BAE.avi,1087,53,1824,35,737,2
0X7FE18A8EC2E2E11A.avi,1130,93,1761,78,631,2
0X7FE1C56B8173D76B.avi,1065,107,1733,91,668,2
0X7FE309A386708568.avi,1571,139,2124,114,553,2
0X7FE48E5475ADE2E3.avi,1966,94,2368,119,402,2
0X7FE620885816A032.avi,2534,94,3001,79,467,2
0X7FE6224B4AC49B7E.avi,2158,72,2859,54,701,2
0X7FE8D1F8E0376B88.avi,1235,74,1813,52,578,2
0X7FE97EB98940401D.avi,1058,95,1646,74,588,2
0X7FE9B2FFC96B60E6.avi,2548,67,2924,50,376,2
0X7FEC2CF1EBF472C6.avi,988,190,1613,171,625,2
0X7FF2092E3F8724DC.avi,1278,64,2003,47,725,2
0X7FF6111130FB1E5E.avi,1935,62,2607,44,672,2
0X7FF6AF6E2EAF781.avi,1271,68,1516,54,245,2
0X7FFB6106C779A974.avi,1377,77,2279,61,902,2
0X7FFE47211BD0EA01.avi,1162,112,1562,95,400,2
0X7FFE99C52C424E9A.avi,1219,126,2035,105,816,2
0X800ACAD85B587B0.avi,839,28,1360,3,521,2
0X803C3B563A14E1F.avi,1831,254,3235,225,1404,2
0X8054AB409CF3EB.avi,964,155,1771,133,807,2
0X808E84C059F2E12.avi,1534,57,2300,39,766,2
0X809DF9732C992B1.avi,1254,63,2231,47,977,2
0X80BB507E25E9051.avi,1341,56,2214,40,873,2
0X810938B35377D16.avi,1108,83,1810,64,702,2
0X812DBE8706E91E5.avi,1410,195,2532,173,1122,2
0X814D190DF9A8A2D.avi,1094,101,1651,79,557,2
0X818765E8E170C5.avi,964,107,1374,93,410,2
0X81C37C9513EF69.avi,3304,63,5045,46,1741,2
0X81E84BB3D703367.avi,2601,82,3117,56,516,2
0X8216721E18CBC00.avi,1452,15,1774,2,322,2
0X821F08A571C0618.avi,967,65,1754,44,787,2
0X823D7223765294E.avi,1223,130,1997,113,774,2
0X825E3913D0D68F2.avi,1300,14,2113,5,813,2
0X827ECF66833BBA2.avi,1231,121,2284,106,1053,2
0X8288BB1A5DA12FF.avi,953,79,1346,56,393,2
0X8306A6BD55A19F5.avi,1445,77,2315,59,870,2
0X8325F4E34DD910D.avi,875,73,1868,57,993,2
0X834EF864ED0A453.avi,1989,140,2810,121,821,2
0X837EE8D6BDBD824.avi,1067,153,1666,141,599,2
0X838581B4AEFA558.avi,1686,100,2923,83,1237,2
0X8398A447D95E31.avi,1608,90,2256,74,648,2
0X83C6343E938255C.avi,883,107,1464,93,581,2
0X83FBE3781C4F828.avi,1063,47,1758,31,695,2
0X8429581F984C6A4.avi,940,53,1380,41,440,2
0X843AD4240FB0AD6.avi,1406,131,2136,115,730,2
0X848378E4CE0BD88.avi,1058,29,1634,23,576,2
0X84DF2CB5BBD3A91.avi,894,87,1552,66,658,2
0X8558D35ED09F890.avi,1782,116,2402,96,620,2
0X85DEC5C015AA094.avi,768,93,1143,77,375,2
0X862D8340FB0AB5D.avi,954,75,1656,64,702,2
0X86643606EDB99E8.avi,1047,170,1452,155,405,2
0X868028466F66DE2.avi,1357,18,1936,4,579,2
0X86C408DFC3FF659.avi,1302,49,1943,36,641,2
0X871CEFF60C7274C.avi,1363,53,1971,35,608,2
0X875E7FCD5A76D74.avi,2023,14,2204,0,181,2
0X876E335B4AF534E.avi,985,76,1479,63,494,2
0X87A60AE9795E5C3.avi,1158,80,1917,63,759,2
0X87D7BC7C27ADD3C.avi,1353,98,2200,83,847,2
0X87EDBD72DA6B2D3.avi,1658,59,2101,41,443,2
0X881AA416D8AB418.avi,1360,85,1656,71,296,2
0X8877F8DEB7D6CC0.avi,1498,111,3276,92,1778,2
0X88C42FCA83FB0A7.avi,963,125,1720,109,757,2
0X88CCC8BE9FDF7EA.avi,2384,68,3861,51,1477,2
0X88D256E56DDCF23.avi,3537,111,4139,94,602,2
0X88D6A14569716D2.avi,1063,82,1611,70,548,2
0X88E1A4DDF09741A.avi,1487,63,1890,45,403,2
0X88E54370A17E06F.avi,1570,136,2158,125,588,2
0X88F47DF3EAB4624.avi,1775,55,2717,37,942,2
0X890D3BA23D088E7.avi,812,62,1321,47,509,2
0X8956CF90AA24E85.avi,1250,48,2133,35,883,2
0X897DC95F2BA7FDD.avi,997,78,1652,56,655,2
0X89931CCA2CA8FEB.avi,1307,69,1557,56,250,2
0X899CFAA2241B41A.avi,1144,84,1691,69,547,2
0X89C66B02F23463.avi,725,126,1395,112,670,2
0X89F6E4E6E71311E.avi,962,102,1455,77,493,2
0X8A00B604D26DE91.avi,785,52,1288,41,503,2
0X8A02C375D49B3A0.avi,994,71,1473,57,479,2
0X8A609D00A0FAB1E.avi,1311,97,1989,86,678,2
0X8AD33565052D9C0.avi,1113,56,1711,38,598,2
0X8ADB8A9EE8822FD.avi,1246,142,2045,120,799,2
0X8AE11CBC0A5D3E0.avi,1047,52,1759,37,712,2
0X8AE76DB8D580220.avi,1369,74,2106,55,737,2
0X8B81181EDD9DDFE.avi,713,129,1187,105,474,2
0X8C4EE7B7BDD0AE9.avi,787,73,1225,45,438,2
0X8C79A779F8014F8.avi,1055,65,1716,48,661,2
0X8CC92C116365C7B.avi,1505,126,1849,112,344,2
0X8D4753B7DADB6A6.avi,942,38,1415,26,473,2
0X8D6808AE8CCE022.avi,1518,112,2643,95,1125,2
0X8D771490D0E2E2E.avi,805,102,1256,90,451,2
0X8D9EBA5A4173367.avi,1497,74,1994,56,497,2
0X8DB48002F8F408D.avi,1355,70,1954,53,599,2
0X8DD547AAAF4577C.avi,1091,106,1778,91,687,2
0X8DDBA56BBEDA587.avi,1153,17,1924,0,771,2
0X8E0549DB1C1180F.avi,794,65,1241,48,447,2
0X8E0D26B4A4C7F9C.avi,730,68,1346,43,616,2
0X8E2FCF5187C4872.avi,1130,144,1782,127,652,2
0X8E4C0881B1F460D.avi,1075,78,1681,64,606,2
0X8E7B765866B0CA7.avi,1862,125,2428,105,566,2
0X8F03E72D159789D.avi,1239,131,1950,105,711,2
0X8F5D6CCBFC12DDD.avi,1743,105,2648,86,905,2
0X8F75381F3CD39C3.avi,1047,57,1268,44,221,2
0X9044899961C94FF.avi,968,78,1296,63,328,2
0X90500B5A7C0E6C0.avi,1370,17,2243,0,873,2
0X9061772F56FB80F.avi,1255,103,1695,85,440,2
0X90825C9FEC5E29B.avi,2851,17,3643,5,792,2
0X90843A89F2D62D9.avi,981,88,1446,69,465,2
0X90BE54996D1FE56.avi,891,140,1576,119,685,2
0X914E962BA46BCAE.avi,1072,167,1596,151,524,2
0X9190B2AF79FD1EF.avi,1334,63,2046,47,712,2
0X91EEBF4F6984C3C.avi,1599,118,2242,100,643,2
0X920784B3F888823.avi,542,97,1225,88,683,2
0X921B9F8EC62DE20.avi,1502,133,2474,114,972,2
0X922773E4DBD8FDA.avi,725,88,1286,76,561,2
0X92A69D3CBDD8890.avi,1655,93,1866,77,211,2
0X92E7F82947B0C28.avi,629,13,991,1,362,2
0X932199C4C55B362.avi,1093,86,1749,72,656,2
0X936B9FCB68B8F2A.avi,1732,85,2621,67,889,2
0X93720259E693454.avi,1686,134,2699,114,1013,2
0X93769D5AAF18824.avi,1132,15,1840,0,708,2
0X938895A99199D5E.avi,2489,92,3280,64,791,2
0X93C06F6952E14DA.avi,1127,114,1719,94,592,2
0X93ECC18675FEC51.avi,962,64,1496,45,534,2
0X93ED1CF2689DBEE.avi,1642,83,2941,68,1299,2
0X93F22EE30533FAD.avi,1376,82,1537,65,161,2
0X9408F4FC14DA75D.avi,794,132,1287,122,493,2
0X9419D068656DB99.avi,1118,98,1749,84,631,2
0X94423ABE1D87A82.avi,1458,79,2624,67,1166,2
0X9581FCED8A0EB28.avi,1344,15,1761,0,417,2
0X966B4698CBD18F6.avi,3487,121,4002,98,515,2
0X96ACFF7BE3F559D.avi,1852,108,3189,91,1337,2
0X96CE61C92FAEE43.avi,927,57,1281,42,354,2
0X97101B235AE00C6.avi,829,61,1360,50,531,2
0X972FF6E2B9B9B1B.avi,985,168,1512,150,527,2
0X973E4A9DAADDF9F.avi,2019,40,2380,49,361,2
0X973FF05037F911F.avi,1028,80,1822,59,794,2
0X9756BC052F770E5.avi,1669,69,2089,49,420,2
0X9776C2BDF17D2F.avi,1484,71,2343,53,859,2
0X977FA9B62EA3FD1.avi,818,95,1147,81,329,2
0X9790A6812535DA6.avi,1730,52,2118,36,388,2
0X98217365CE7C868.avi,813,53,1162,43,349,2
0X983B0EA3147F367.avi,966,34,1785,22,819,2
0X989B4D72DC92247.avi,822,47,1190,39,368,2
0X98A5CDCC73DC4E9.avi,1250,67,1685,47,435,2
0X98AE6BD83F02077.avi,1512,78,1874,68,362,2
0X98B0C025EC61940.avi,1974,63,3021,46,1047,2
0X98E1CCF5F6CADF5.avi,1227,118,1903,100,676,2
0X9910641C4636621.avi,1002,57,1682,41,680,2
0X992CE8E901B6D5D.avi,1043,119,1678,98,635,2
0X9949F48CD62C825.avi,978,83,1585,70,607,2
0X996144BA5B06549.avi,987,16,1566,2,579,2
0X99779FE7AB6FCB0.avi,1407,66,2269,53,862,2
0X9986074CBE59786.avi,1444,59,2087,45,643,2
0X999693BACC06F2A.avi,1205,53,2006,35,801,2
0X99E2DE4B1C00277.avi,1438,90,2467,74,1029,2
0X9A03DC1334986F3.avi,3452,44,3741,32,289,2
0X9A5A7DB7451F0C8.avi,1421,100,2223,78,802,2
0X9A5EF4B2212EA30.avi,946,57,1469,44,523,2
0X9A79C9B36D1055C.avi,1103,55,1504,44,401,2
0X9A907E25D74AE97.avi,950,89,1487,70,537,2
0X9AA7B6854969266.avi,1085,63,1677,45,592,2
0X9ABE9D61E4472A8.avi,858,56,1299,41,441,2
0X9B0C20331B5EB7F.avi,1195,99,1957,81,762,2
0X9B148571A758952.avi,970,73,1610,49,640,2
0X9B2BE4C440C107D.avi,1038,54,1610,41,572,2
0X9B4420F570F7BA.avi,1619,111,2205,97,586,2
0X9B80B7519CEBB0.avi,795,73,1293,50,498,2
0X9BC2066CD0D816F.avi,2741,124,3293,102,552,2
0X9BC46CA635485B6.avi,1845,144,2165,129,320,2
0X9BCA80E40CC5AFF.avi,1862,95,3060,81,1198,2
0X9BCAF5D4D05D27F.avi,1684,52,2807,37,1123,2
0X9C07F125C8FC4C1.avi,871,57,1324,44,453,2
0X9C5CFD92158CC11.avi,2009,93,2427,72,418,2
0X9C73FFFD19447AB.avi,1122,77,1530,57,408,2
0X9C7E9770B314AE5.avi,1017,54,1533,42,516,2
0X9CCD9D64D3CA005.avi,1239,66,2201,48,962,2
0X9D0FC1FDA17491D.avi,1320,85,1913,64,593,2
0X9D40B3B9C178B26.avi,1062,47,1491,34,429,2
0X9DB79DF0A269227.avi,1028,141,1705,127,677,2
0X9DBF850852BB18F.avi,1447,71,2441,51,994,2
0X9DE98A203BEC5F2.avi,992,22,1525,4,533,2
0X9E181B942CACADF.avi,1007,18,1684,0,677,2
0X9E37320F33E7ED.avi,1150,212,1665,187,515,2
0X9E3B3B6B928DA58.avi,1975,291,3154,262,1179,2
0X9E3D09429F6B852.avi,1566,142,2242,128,676,2
0X9E6E997496C87CC.avi,1389,59,1589,44,200,2
0X9E72E2C8A9536F6.avi,942,12,1490,2,548,2
0X9F2D61012CC7FCA.avi,616,59,945,41,329,2
0X9F2E7A05C3B994C.avi,1507,140,2201,122,694,2
0X9F47D732822A695.avi,1234,69,2042,47,808,2
0X9FB2E15488737AA.avi,1317,173,2027,157,710,2
0X9FBEB56D70FA0B7.avi,1146,80,1811,65,665,2
0XA05202904A89EAD.avi,1138,21,1486,0,348,2
0XA0FF3E0630F3902.avi,1624,43,1955,33,331,2
0XA14DEADA0918C0C.avi,1630,21,2464,0,834,2
0XA1EC54A2895788E.avi,1182,95,1754,82,572,2
0XA2092DD4255657B.avi,1056,121,1919,105,863,2
0XA20E92517726A99.avi,1036,72,1771,55,735,2
0XA20EE6C5B1F48CB.avi,3967,116,4117,95,150,2
0XA238B0B664FDCFE.avi,938,69,1449,51,511,2
0XA23DF6B3D64C5A1.avi,1713,106,2694,88,981,2
0XA27FDD7A35C6779.avi,986,134,1688,116,702,2
0XA28369AAB872CF2.avi,678,50,1034,39,356,2
0XA29BAB8A42F22B5.avi,751,55,1111,77,360,2
0XA2CE53842FD45BE.avi,1006,81,1676,68,670,2
0XA31E5D703BAE77A.avi,1160,95,1560,81,400,2
0XA3372C20EFD8726.avi,1194,207,1783,188,589,2
0XA3617C5EFEDD2E5.avi,1315,121,2081,103,766,2
0XA3D91865EC953D9.avi,1190,103,2131,88,941,2
0XA3DC9C69839F5FA.avi,1190,71,1950,53,760,2
0XA40AEF2A1787260.avi,928,63,1479,44,551,2
0XA42F2AFCCCD336D.avi,2581,79,3723,64,1142,2
0XA43117B34833F33.avi,954,66,1485,48,531,2
0XA45E4E31AD288AB.avi,911,50,1516,36,605,2
0XA490B5C1BABF770.avi,1419,61,1766,43,347,2
0XA5323DD59E0A869.avi,1035,132,1529,112,494,2
0XA5BE050BEE27DE1.avi,979,83,1423,67,444,2
0XA5C31C5A0108C30.avi,828,59,1288,44,460,2
0XA6098BB06A8586A.avi,1211,113,2110,97,899,2
0XA61A892741BB67A.avi,1071,66,1577,56,506,2
0XA64090D4741F0BD.avi,996,62,1549,46,553,2
0XA684E725FD761B6.avi,1123,171,1786,144,663,2
0XA69CDEAD15F2E1A.avi,1581,111,2761,95,1180,2
0XA6A8F7E7AA0F98E.avi,1076,90,1620,75,544,2
0XA6BD3BA9AAB064D.avi,644,51,1074,36,430,2
0XA6D71323002CF21.avi,1225,61,1662,42,437,2
0XA6D84E19F2DA13D.avi,1417,52,2371,36,954,2
0XA6E09CACE38DD02.avi,1118,64,1506,48,388,2
0XA72DE0C1F32EA64.avi,1565,22,1897,8,332,2
0XA72F656E23C7F53.avi,979,17,1583,3,604,2
0XA789C0D93B1DF7A.avi,844,63,1433,49,589,2
0XA7F4EE9647DF974.avi,1315,26,2075,5,760,2
0XA8324479A861D01.avi,1708,131,2632,118,924,2
0XA837A17982E7335.avi,1051,101,1619,84,568,2
0XA84957F45657A67.avi,1446,97,2569,84,1123,2
0XA86485C87693449.avi,1247,44,1435,31,188,2
0XA8C2902A686BF34.avi,1188,67,1715,48,527,2
0XA8EB154B86EAEE7.avi,1174,73,1384,60,210,2
0XA94EE36D10C4D70.avi,1560,57,2877,42,1317,2
0XA951AB7646161AE.avi,1351,97,1958,79,607,2
0XA97434292889BC4.avi,1549,84,2328,61,779,2
0XA989DD619F4AB85.avi,943,52,1591,38,648,2
0XAA023992D00F604.avi,744,16,1158,4,414,2
0XAA304E75C4EE3E9.avi,1262,99,1981,91,719,2
0XAA3A306D4EC8B69.avi,1351,162,1982,137,631,2
0XAA3E06425E1A23E.avi,1206,86,1478,73,272,2
0XAA4741B7E7194A2.avi,855,69,1390,51,535,2
0XAA68800871BD1FD.avi,1259,88,2162,72,903,2
0XAAB25926214E746.avi,1620,112,2432,93,812,2
0XAABEF7BA895A967.avi,1333,96,2025,80,692,2
0XAAFC07869635B00.avi,1102,92,1790,76,688,2
0XAB497CBE6A93DA1.avi,929,85,1341,66,412,2
0XAB701373CBCF5FC.avi,2661,66,4252,51,1591,2
0XAB7D06D7A122D44.avi,1345,93,2155,81,810,2
0XAB8C29BE4841CB0.avi,1317,82,2063,61,746,2
0XABA4614974D17D9.avi,1002,71,1607,54,605,2
0XABB712C1939FBC5.avi,1084,17,1600,0,516,2
0XABB9008CDCF5A14.avi,1132,62,1736,46,604,2
0XABBDDF3F072EB3F.avi,1960,100,2352,87,392,2
0XAC0EAEC877E4011.avi,1139,94,1571,78,432,2
0XAC7C3A56AF70470.avi,1099,59,1699,44,600,2
0XAC98E4AFBFA863C.avi,1050,118,1578,106,528,2
0XACACEACDB6D7111.avi,1966,53,2745,35,779,2
0XAD3A148177CC751.avi,1377,68,2310,50,933,2
0XADA270671B3E2BD.avi,1429,144,2115,125,686,2
0XADC4DD1BE4E66C6.avi,2688,76,3286,48,598,2
0XAE20223CD4D01E4.avi,1118,77,1503,59,385,2
0XAE25D6E1B0C1D36.avi,928,55,1673,41,745,2
0XAE64A9D50B9C49E.avi,1325,77,2215,55,890,2
0XAE7CEC16E9165DC.avi,1119,94,1842,76,723,2
0XAE9B1B36D4582AD.avi,1076,18,1968,3,892,2
0XAEA31035D9CAA52.avi,958,50,1483,69,525,2
0XAF14E70264D4B68.avi,1020,55,2488,77,1468,2
0XAF2DAA07BEAF65F.avi,1141,201,1803,182,662,2
0XAF4A04FFB4BBBC8.avi,1404,18,2400,3,996,2
0XAF4B0E083E9D6C2.avi,1151,54,1892,40,741,2
0XAF8D4A78571AD29.avi,1044,21,1653,0,609,2
0XAFBE86F77CEE5A0.avi,702,67,1148,46,446,2
0XAFE17647DB9F842.avi,811,45,1335,31,524,2
0XB01A6602791740C.avi,1018,101,1708,79,690,2
0XB047DCB63710E45.avi,1420,21,2501,3,1081,2
0XB0F37929C190A8C.avi,1196,72,1916,57,720,2
0XB11B61E6027ABCE.avi,695,31,920,21,225,2
0XB11E2FD02BEDD68.avi,1112,54,1673,34,561,2
0XB120E010AF07AC0.avi,1230,21,1888,3,658,2
0XB2586FF43C881C2.avi,1781,60,2875,44,1094,2
0XB261623CE7B3E23.avi,1743,129,3098,113,1355,2
0XB27C7F68A21F79A.avi,1114,65,1617,43,503,2
0XB2850929FE8153.avi,1441,181,2459,161,1018,2
0XB29658CF38E12F7.avi,758,160,1042,147,284,2
0XB2B0A80A3F2DEF4.avi,1085,75,1796,62,711,2
0XB2B1E32A08876DF.avi,1803,112,3023,94,1220,2
0XB2D24AC185D2FAE.avi,623,55,963,43,340,2
0XB2D73F7CA60D083.avi,2040,117,2305,106,265,2
0XB37983600380DDC.avi,1383,74,2160,59,777,2
0XB3824A90B372B6.avi,1348,67,2156,48,808,2
0XB38FB7A0C821476.avi,848,119,1341,105,493,2
0XB3B6D8016D3A0EA.avi,1168,56,1909,40,741,2
0XB3D681E981F28A9.avi,1313,73,1559,63,246,2
0XB3E3E715D675954.avi,876,115,1238,92,362,2
0XB3F6662216A4BF1.avi,1434,134,2204,119,770,2
0XB3FFC4AE334E9F4.avi,1704,18,2027,4,323,2
0XB46944CEABE2516.avi,1026,107,1492,93,466,2
0XB4AD1970D00CAB5.avi,1087,101,1878,88,791,2
0XB4CA9F2B3253AA4.avi,725,93,1105,83,380,2
0XB52E6E911CEFDD3.avi,858,52,1480,39,622,2
0XB534B965C394598.avi,597,105,927,87,330,2
0XB5470B070E7F16D.avi,937,36,1387,22,450,2
0XB5492BEC906F76C.avi,1726,55,2241,40,515,2
0XB55FE9464938526.avi,1836,41,2277,28,441,2
0XB57FA9DF1716E76.avi,1027,18,1615,3,588,2
0XB5CAEDA2CA09409.avi,1089,51,1409,37,320,2
0XB5CECBD29920B7B.avi,1772,76,1985,61,213,2
0XB60BF6DE9227C68.avi,1441,79,2291,62,850,2
0XB618EF1BD4738C9.avi,1509,67,2114,47,605,2
0XB61F11056573030.avi,1084,33,1714,69,630,2
0XB674609B23949FD.avi,1251,108,1977,85,726,2
0XB6A91D71A5741C2.avi,795,49,1385,37,590,2
0XB6BC570A4D3532.avi,1565,102,2350,86,785,2
0XB6D8F3BAB7D9415.avi,1615,38,2259,27,644,2
0XB72CF150368BAB2.avi,866,79,1016,61,150,2
0XB731B3B5A5E2BF7.avi,1092,109,1701,95,609,2
0XB790D3227275B82.avi,2324,75,3623,55,1299,2
0XB7D37DE2E8CF999.avi,1104,71,1660,54,556,2
0XB7E1867A17EDAD4.avi,860,48,1258,37,398,2
0XB816279A0E9E07B.avi,1206,78,1585,62,379,2
0XB8513240ED5E94.avi,1334,66,2008,115,674,2
0XB854FB1991CF64E.avi,793,48,1436,32,643,2
0XB8A42CE677180DB.avi,1158,119,1509,105,351,2
0XB8DDFCA26AD93E2.avi,1456,60,1946,42,490,2
0XB97524F54DE851.avi,1164,79,1691,60,527,2
0XB97CDA07C6DD6F4.avi,2592,42,2812,26,220,2
0XB9AB54BCD7F3781.avi,909,55,1729,44,820,2
0XB9C19B214A298A0.avi,1247,81,1682,56,435,2
0XB9DA76703445AFD.avi,890,42,1436,59,546,2
0XB9DB01A28FD139B.avi,995,79,1600,63,605,2
0XB9DF67C20D1A4B7.avi,946,62,1465,48,519,2
0XB9F42D3E6D02705.avi,1033,71,1749,58,716,2
0XBA0869D75B7E754.avi,1376,391,2244,362,868,2
0XBA15B40D87218A9.avi,1053,76,1627,57,574,2
0XBA57FE6C733F574.avi,1053,113,1530,96,477,2
0XBA908EC80548AD8.avi,2089,92,2507,75,418,2
0XBAC49AF78B67E41.avi,1169,36,1930,26,761,2
0XBAE445E8B4352C5.avi,885,43,1416,29,531,2
0XBB76A78AC119BBB.avi,1255,120,1943,101,688,2
0XBB81FA57B45B41E.avi,889,58,1582,43,693,2
0XBB9F70A309D39C1.avi,805,83,1610,63,805,2
0XBC07D6F8A319F72.avi,1149,95,1761,83,612,2
0XBC18C83D7C41A12.avi,2132,112,2934,91,802,2
0XBC881D0528B2788.avi,1829,24,2713,2,884,2
0XBCA7B3FD3A0699B.avi,1156,57,1937,41,781,2
0XBCACA2185BF51AB.avi,1856,121,2519,106,663,2
0XBCDE79B59A394B8.avi,1573,86,1883,73,310,2
0XBCEAB22A81A23C1.avi,1611,123,1833,100,222,2
0XBD39E52A48060D2.avi,1728,57,2262,36,534,2
0XBD3C5F14D7E8D1D.avi,1847,200,3316,184,1469,2
0XBD557B0BD7E6F38.avi,971,100,1341,88,370,2
0XBD9E3CD3543C2F6.avi,1283,60,1997,42,714,2
0XBDA070FFD92A748.avi,988,44,1566,32,578,2
0XBDBB1C23E1D4F0D.avi,1061,53,1668,34,607,2
0XBDD429854C33D4E.avi,1248,90,1852,69,604,2
0XBE0391F995D4296.avi,2216,125,3563,110,1347,2
0XBE06F978BB3226D.avi,2952,16,4447,0,1495,2
0XBE3FBF3D0E9DC64.avi,1490,60,1923,42,433,2
0XBE8A99913E8F6DA.avi,1645,88,2525,73,880,2
0XBE8C637FF9D9124.avi,607,42,1105,26,498,2
0XBEB28C9A5DE835.avi,1241,137,1864,120,623,2
0XBEFC0BDB0F7405.avi,1479,21,2216,3,737,2
0XBEFC537F3BF5278.avi,1730,117,2495,102,765,2
0XBF2A250BF36ED1E.avi,2013,78,2919,56,906,2
0XBF90FC1324AEA2B.avi,1304,135,2021,118,717,2
0XBF9AB1A74DFA6CD.avi,1453,103,2249,85,796,2
0XBFB1DC2891103C.avi,624,88,967,73,343,2
0XBFB290E3C10D76A.avi,2019,127,2308,110,289,2
0XC006D08601D1BFB.avi,941,80,1530,67,589,2
0XC063D22870F910D.avi,857,192,1360,178,503,2
0XC0A98C54ADFEF94.avi,1173,94,1896,78,723,2
0XC0E8792CFD78017.avi,2033,114,2873,99,840,2
0XC11611943453836.avi,1136,95,1939,80,803,2
0XC1B491BD7A3D11C.avi,1153,132,1844,115,691,2
0XC1D7945DDDA478A.avi,873,139,1396,120,523,2
0XC1DB7C42C35E345.avi,1987,200,2539,179,552,2
0XC1E11233E59181F.avi,1377,112,1990,92,613,2
0XC2053253DC743F3.avi,1037,88,1736,72,699,2
0XC206AC545831126.avi,1082,183,1583,164,501,2
0XC21E699429625CD.avi,554,66,894,51,340,2
0XC244CEC2F500E34.avi,1828,63,2651,48,823,2
0XC31605A9D22702E.avi,573,24,953,0,380,2
0XC31D77CD4D50FA9.avi,1051,119,1742,97,691,2
0XC3CC9222A4E69E6.avi,1043,130,1704,112,661,2
0XC3D95F0492F6512.avi,802,62,1214,48,412,2
0XC3E8BBE54048886.avi,2812,89,5368,72,2556,2
0XC42AF46236A2CFD.avi,1575,23,2145,5,570,2
0XC44170E9F907DD2.avi,1157,159,1701,135,544,2
0XC4565B55DFF191.avi,1965,64,2924,48,959,2
0XC4BE2CADE35713C.avi,1320,89,2005,73,685,2
0XC4D66DC3E1AA6EB.avi,1054,102,1659,84,605,2
0XC4F21DA269D2EE9.avi,1191,111,1762,101,571,2
0XC538353E221F3FB.avi,1371,58,2141,45,770,2
0XC5BF82CA81C2DF.avi,945,91,1642,75,697,2
0XC5EED498D232DC9.avi,1569,16,2246,1,677,2
0XC60C5CB61599F8F.avi,1517,167,1873,149,356,2
0XC622E828FE2A648.avi,1822,120,2471,99,649,2
0XC62BC4D50804187.avi,1229,86,1868,71,639,2
0XC649E4EF24DCAB7.avi,779,61,1087,47,308,2
0XC6CE1305C2B28D0.avi,815,119,1384,106,569,2
0XC74B1F99DF2243E.avi,848,62,1335,47,487,2
0XC76E35532F7EE47.avi,1139,100,1862,86,723,2
0XC775724BE40EAFD.avi,1002,108,1645,92,643,2
0XC77F1C717BE6B6D.avi,930,17,1497,1,567,2
0XC781E8B0D3035BD.avi,1159,121,1576,106,417,2
0XC8144B9EF1990EF.avi,1088,101,1734,87,646,2
0XC824784198003F2.avi,1163,79,1693,67,530,2
0XC83A970AAC17CA8.avi,1225,165,1659,149,434,2
0XC8811E9F9047578.avi,1101,53,1806,37,705,2
0XC89A68BA0AA0A11.avi,1040,33,1896,22,856,2
0XC89BD7836585978.avi,2016,59,2657,44,641,2
0XC8D1B3C80770006.avi,2667,114,2930,99,263,2
0XC8DE2D8DB465511.avi,717,68,1215,51,498,2
0XC9784D72590639A.avi,1888,69,2912,50,1024,2
0XC9CD3F156FBCC49.avi,438,55,844,36,406,2
0XCA133A9A2B901DB.avi,1002,89,1620,75,618,2
0XCA1E6F96A8F0686.avi,791,53,1218,39,427,2
0XCA3F1E9BC33DB6E.avi,1382,64,2319,44,937,2
0XCB722F90EEDD431.avi,1758,112,2155,96,397,2
0XCBB63C835191B4B.avi,1473,97,2291,85,818,2
0XCBBD0FFDB29A321.avi,1388,73,1962,58,574,2
0XCBC6A16E66E2941.avi,1173,23,1846,53,673,2
0XCC0DD4FDDA0EA5B.avi,1011,88,1572,73,561,2
0XCC49D77D8379951.avi,1014,55,1738,40,724,2
0XCC513AC74753096.avi,1059,138,1864,117,805,2
0XCC8B5A22926B01A.avi,982,177,1522,161,540,2
0XCCB63496DB01277.avi,800,63,1444,47,644,2
0XCCBE81B251BEF37.avi,1190,60,1987,46,797,2
0XCCC60B5DC80A516.avi,981,73,1497,53,516,2
0XCCF1BD71411C2EE.avi,878,62,1359,41,481,2
0XCD3FC9BB91227E0.avi,866,19,1477,0,611,2
0XCDA061FD0F030DC.avi,1158,136,1593,119,435,2
0XCDC194CB936209F.avi,2460,47,4004,31,1544,2
0XCDD2820A5F430A1.avi,1746,67,3037,49,1291,2
0XCDD502705AC6FCC.avi,1177,69,1916,52,739,2
0XCEAEC183EA7E7E6.avi,1411,85,2166,68,755,2
0XCEC174C2D88B511.avi,3060,18,4526,3,1466,2
0XCEEA1EA058DA6C0.avi,1266,54,1992,39,726,2
0XCF0F0C58A0F4639.avi,1167,118,1786,100,619,2
0XCF22B2C72A7CE6C.avi,1020,70,1592,56,572,2
0XCF341C5F3A273CD.avi,1224,71,1467,51,243,2
0XCF4E414163EBF98.avi,1675,66,2688,42,1013,2
0XCF92B5177AEC06F.avi,825,200,1232,184,407,2
0XCFA60F0B3CF1782.avi,972,62,1558,44,586,2
0XCFC029F53F6CD42.avi,1428,91,2513,75,1085,2
0XD0070C7CDF75456.avi,2043,73,3560,56,1517,2
0XD00B14807A0FA2B.avi,897,51,1019,41,122,2
0XD032E3D5A853578.avi,999,90,1467,74,468,2
0XD05D93184B12092.avi,1114,13,1959,0,845,2
0XD06D90B22BC11CE.avi,1200,72,1627,54,427,2
0XD07ABCAC62F4FF7.avi,1466,146,2512,123,1046,2
0XD0955B01F39FD0C.avi,946,134,1473,117,527,2
0XD0B87FA30CDF547.avi,1143,90,1974,75,831,2
0XD0BD0330D1F1A00.avi,1373,68,1900,46,527,2
0XD0BE4647858725A.avi,1055,67,1931,47,876,2
0XD0DC210BA3C1C9E.avi,1191,93,1809,75,618,2
0XD0DDB39727C76C.avi,984,76,1601,59,617,2
0XD0E1375CD861EDC.avi,1638,57,2299,41,661,2
0XD11D1E980723BE1.avi,1413,93,2220,76,807,2
0XD1A496DBFB3FC4F.avi,956,95,1254,79,298,2
0XD1D122C0AFC006C.avi,2148,23,3258,4,1110,2
0XD2023E03A8C566C.avi,825,165,1464,142,639,2
0XD25783B49EB1FE6.avi,925,53,1517,37,592,2
0XD299E490ECC3438.avi,1164,98,1757,83,593,2
0XD2B1CAD149853FE.avi,1800,129,2678,101,878,2
0XD2C12F10DD2C98F.avi,1011,64,1546,50,535,2
0XD3015B502E070B2.avi,940,136,1369,117,429,2
0XD348D272B89F1A6.avi,1202,58,1937,35,735,2
0XD37F085443DAC1A.avi,1085,151,1844,137,759,2
0XD3B557874B91D0D.avi,1730,109,2532,91,802,2
0XD3CF6D354ACF645.avi,950,65,1476,48,526,2
0XD4659C3A1FA9518.avi,1284,57,1523,42,239,2
0XD486D3C28ECF7F2.avi,2269,192,3022,173,753,2
0XD51E16EDF0F45F2.avi,1087,62,1865,49,778,2
0XD537CD5A04B8C43.avi,1238,115,1660,98,422,2
0XD578E2221A216DD.avi,1605,17,1915,0,310,2
0XD5ED87EECABCE2F.avi,1412,79,2383,61,971,2
0XD5F2509FE1D0C20.avi,1722,168,2873,127,1151,2
0XD604065881A87A3.avi,899,66,1404,53,505,2
0XD6240C89679865D.avi,1198,120,1855,99,657,2
0XD65A5E3BEE1A26B.avi,936,74,1489,59,553,2
0XD69093EEA9EE1CD.avi,2166,78,2470,58,304,2
0XD6975BAB837093B.avi,1880,93,2552,79,672,2
0XD70CB948FBEE927.avi,1195,108,1755,91,560,2
0XD77D667D3BD5EAE.avi,959,61,1514,46,555,2
0XD782AF8BF68556F.avi,1214,140,1661,124,447,2
0XD79C49C010950C7.avi,833,68,1478,52,645,2
0XD7ACD0FDE9C8A69.avi,1478,70,2093,52,615,2
0XD7B885364948E9B.avi,763,73,1279,45,516,2
0XD807B969AAB4A1B.avi,970,109,1508,90,538,2
0XD82A46274BA199D.avi,1355,197,2160,178,805,2
0XD84BF2C72859828.avi,1060,89,1728,73,668,2
0XD88810A8041349B.avi,1228,55,1782,40,554,2
0XD931DD5F6E68BB.avi,1097,111,1695,93,598,2
0XDA3A603964AF0D3.avi,1159,121,1848,102,689,2
0XDA3CBEA102E1D11.avi,1864,102,2197,83,333,2
0XDA9164EAE828591.avi,2965,86,3616,108,651,2
0XDAA38BE7DD4D8F6.avi,844,19,1449,2,605,2
0XDAC9597CA49DF0A.avi,1015,61,1498,44,483,2
0XDB100B9990F3EB.avi,2367,21,3988,2,1621,2
0XDB4C8F64C55982E.avi,955,169,1548,149,593,2
0XDBB48C48A226A5.avi,1031,99,1711,84,680,2
0XDC1CE3355BA3CD9.avi,1354,67,2272,46,918,2
0XDC754C50E00D543.avi,1650,126,2772,107,1122,2
0XDC9457A479390F4.avi,1132,69,1781,53,649,2
0XDCAB490130919DE.avi,1183,46,1366,34,183,2
0XDD3291A30BBAB09.avi,1143,114,1911,99,768,2
0XDD4F7361041731C.avi,1593,86,1853,70,260,2
0XDD95EC509482D69.avi,1589,16,2590,0,1001,2
0XDDE8C09C893992.avi,1250,108,1875,92,625,2
0XDDF6CD002C13FAB.avi,1330,58,1596,41,266,2
0XDE2B520A16EB881.avi,1012,49,1671,33,659,2
0XDE352D911F0C6DD.avi,1071,110,1791,95,720,2
0XDE3F9D01F78FA74.avi,1632,105,2612,88,980,2
0XDE61FD9522E5852.avi,863,47,1381,34,518,2
0XDE9310288F4FBFC.avi,828,15,1317,0,489,2
0XDEC72212622926F.avi,1006,64,1744,52,738,2
0XDEE3C5434E5B289.avi,1809,101,2826,86,1017,2
0XDEEF6DE6F4A8F45.avi,1170,140,1945,120,775,2
0XDF1FD388B6166A2.avi,891,18,1376,2,485,2
0XDFDC37EE52B138D.avi,1510,107,1814,93,304,2
0XDFF3A318962AD77.avi,1159,115,1764,99,605,2
0XE01EA3914250B74.avi,999,73,1740,61,741,2
0XE025360AE5D6B9.avi,1381,151,2136,125,755,2
0XE09693AED1032C0.avi,1063,21,1904,57,841,2
0XE0A06BBB5417202.avi,786,142,1485,121,699,2
0XE0CD11D3F5C69DB.avi,621,72,1043,60,422,2
0XE0DFD3845CCF80F.avi,1833,73,2064,62,231,2
0XE12521DF3EDF68A.avi,1233,80,2255,65,1022,2
0XE264FF9B06BFDB1.avi,1471,82,2488,65,1017,2
0XE27AFFCA94F6E3D.avi,1015,166,1718,151,703,2
0XE2F1E54DEFDF46F.avi,1267,58,1760,40,493,2
0XE315B0A3C5BAC9E.avi,964,62,1510,46,546,2
0XE31E2DCAFB19A01.avi,1029,73,1389,59,360,2
0XE354EF700E4B992.avi,1524,123,2352,106,828,2
0XE3634D73CD76145.avi,1052,47,1818,31,766,2
0XE39993045DB612C.avi,1953,70,2702,48,749,2
0XE3ACAE78E81F9E0.avi,1195,72,1609,57,414,2
0XE3B9242BC8DEE40.avi,1256,141,1893,118,637,2
0XE3D4128C7719147.avi,1424,16,2156,0,732,2
0XE3DED926B92A91B.avi,1535,148,2303,132,768,2
0XE3F034EA28509F5.avi,1050,79,1832,61,782,2
0XE416C6A721DD00C.avi,965,152,1633,133,668,2
0XE4299054391C4B.avi,994,69,1508,47,514,2
0XE473560DC3BF6D6.avi,914,127,1308,111,394,2
0XE476D1873283160.avi,720,91,1213,78,493,2
0XE4DFE0DCBEFEF10.avi,953,16,1347,3,394,2
0XE52CB1441F60EAF.avi,1915,110,2499,97,584,2
0XE5A9B465EB444E.avi,754,90,1160,73,406,2
0XE5E5BCE6C2D200C.avi,1383,140,2015,127,632,2
0XE5F70C3C553E989.avi,1781,168,3023,145,1242,2
0XE62926359A7E033.avi,1934,15,2455,0,521,2
0XE6F5061C12D9083.avi,1291,92,2135,68,844,2
0XE727DA95C7D9B46.avi,1516,110,2429,90,913,2
0XE72812337BCB4A7.avi,815,54,1359,40,544,2
0XE763608A3EFEF2.avi,1107,57,1498,39,391,2
0XE7677B39DB66752.avi,1817,99,2900,83,1083,2
0XE778DAE0B378968.avi,2361,175,4100,158,1739,2
0XE7A4FB78DA40B1C.avi,2132,135,3517,121,1385,2
0XE826F3A93E97AB4.avi,919,14,1475,0,556,2
0XE837871E0ED1EB7.avi,1361,73,1950,54,589,2
0XE855B147551A51.avi,1077,77,1407,50,330,2
0XE871BC36704A97B.avi,917,62,1483,49,566,2
0XE88650E3BA9E287.avi,669,38,1035,18,366,2
0XE8894DCC98CCF57.avi,874,73,1461,52,587,2
0XE8B85E5538EF26A.avi,1327,161,2024,147,697,2
0XE8BB14C66E3BAC9.avi,1876,108,3139,81,1263,2
0XE8CF3F4838C0ACF.avi,1270,14,1764,2,494,2
0XE8DC347D390EE90.avi,1177,226,1909,199,732,2
0XE8E30696E3AF198.avi,767,73,1157,46,390,2
0XE92064595CE5305.avi,1313,105,2048,91,735,2
0XE9217FEF2BCB4B1.avi,1167,44,1833,32,666,2
0XE92C294577144FC.avi,683,55,1387,41,704,2
0XE9315FA2FA71674.avi,734,74,1347,58,613,2
0XE96D228DFDC48DC.avi,986,167,1634,153,648,2
0XE9F5A4FD690EDB3.avi,1775,81,2957,62,1182,2
0XEA049B76C9061E7.avi,1657,154,2863,138,1206,2
0XEA4EAF062F7A21D.avi,1276,58,1655,49,379,2
0XEA6482986918798.avi,1357,86,2264,62,907,2
0XEBBF9242B09E964.avi,875,53,1547,41,672,2
0XEBD5D5C0824B2A7.avi,1222,92,1491,81,269,2
0XEC02C6EDC625DCE.avi,787,294,1206,266,419,2
0XEC0CCE39DC396D0.avi,1377,63,2102,47,725,2
0XEC1374DBAE71116.avi,1167,22,1797,2,630,2
0XEC16D98451B6B28.avi,785,115,1429,97,644,2
0XEC245307B5E2E0.avi,1280,81,1874,61,594,2
0XEC2F65B0B9EFB90.avi,928,57,1372,45,444,2
0XEC340BEA3298AE3.avi,1103,56,1675,39,572,2
0XEC49B9CFE28F619.avi,1212,64,1368,54,156,2
0XEC5FB56F6EA00B8.avi,766,145,1290,130,524,2
0XECC497B16591984.avi,903,94,1459,73,556,2
0XECF82DC9301EE77.avi,1330,111,2192,91,862,2
0XECFAD2E2BAB2AC8.avi,1211,72,1920,59,709,2
0XED290312C1390F6.avi,2290,72,3803,55,1513,2
0XED603B8278C5196.avi,1433,68,2528,52,1095,2
0XED72DAE2E8CAF4F.avi,1520,67,1943,49,423,2
0XED8409F1DA4738A.avi,1085,157,1791,142,706,2
0XEE3CCD3E808313C.avi,780,135,1150,119,370,2
0XEE433DBDBEAF37A.avi,974,63,1380,53,406,2
0XEE630F143F0414D.avi,1437,102,2120,84,683,2
0XEE7E2A3E141E060.avi,1235,81,1486,65,251,2
0XEF7D675329600E9.avi,1872,156,2344,139,472,2
0XEF9B5520CAA14AA.avi,833,66,1371,49,538,2
0XEFA2FC13E63C9C5.avi,1060,67,1583,48,523,2
0XEFDBFDCA164AB94.avi,1384,122,1698,100,314,2
0XF01B4470872E293.avi,1490,61,2039,39,549,2
0XF046816394513C6.avi,2282,99,2641,85,359,2
0XF057D2ED95035D.avi,2193,103,2590,90,397,2
0XF0645E6834100AC.avi,2054,51,3096,39,1042,2
0XF072F7A9791B060.avi,1944,52,2191,33,247,2
0XF09019B7B99872B.avi,847,99,1716,88,869,2
0XF0B7D7CD42C001E.avi,949,61,1472,45,523,2
0XF0EFF8B5A19D1A1.avi,1227,95,2010,80,783,2
0XF145A7B0E6F417E.avi,889,57,1399,40,510,2
0XF1640FC4E35A73E.avi,556,43,818,33,262,2
0XF1D850CC908573F.avi,813,68,1345,51,532,2
0XF2A168FEF29C6E1.avi,983,18,1476,5,493,2
0XF30FA224240FF8C.avi,1941,73,3243,50,1302,2
0XF342DDFE30C0980.avi,1842,77,2860,54,1018,2
0XF46CF63A2A1FA90.avi,955,73,1375,58,420,2
0XF4CA716E61ECD9F.avi,1385,95,2424,77,1039,2
0XF526937B72090A6.avi,1002,75,1698,60,696,2
0XF53FF3E3EDF0470.avi,1095,69,1690,52,595,2
0XF54528219E80770.avi,1503,65,2283,51,780,2
0XF557EF658FD13D0.avi,1102,20,1659,0,557,2
0XF599A765E273E17.avi,978,67,1254,52,276,2
0XF5F0335B42366C5.avi,1060,106,1498,84,438,2
0XF60BBEC9C303C98.avi,1370,113,2145,98,775,2
0XF61C0F562AA75BB.avi,947,18,1588,0,641,2
0XF66173D1894718C.avi,851,112,1277,94,426,2
0XF6661AF354401A5.avi,1150,111,1963,93,813,2
0XF6B57AC096CADD4.avi,1409,19,2425,3,1016,2
0XF6D483170E23D92.avi,932,18,1547,4,615,2
0XF70A3F712E03D87.avi,719,60,1120,48,401,2
0XF72EB7E520F126E.avi,849,63,1467,45,618,2
0XF7373FB1CFBE827.avi,1177,17,1797,0,620,2
0XF760A47D31AE457.avi,2651,61,3442,47,791,2
0XF7AF4EDD2224855.avi,1571,62,2738,48,1167,2
0XF829F634971A0F7.avi,1010,66,1698,48,688,2
0XF92E2B74A04BBC4.avi,1251,88,2016,72,765,2
0XF96230565BFF1D2.avi,2825,109,3180,98,355,2
0XF99271B5D3D9AE3.avi,1028,68,1704,50,676,2
0XF9A94878A64F70B.avi,1675,100,2826,78,1151,2
0XF9B19F076482852.avi,672,73,985,51,313,2
0XF9CA1C6A7687A8D.avi,1057,170,1469,155,412,2
0XF9E698E7CE7FEB1.avi,1866,43,2638,29,772,2
0XF9E859F93775E1F.avi,1685,17,2248,2,563,2
0XFA2F04D15D5D222.avi,1094,64,1687,51,593,2
0XFA9EA2F22209920.avi,1305,94,2146,76,841,2
0XFAE70080273B8AD.avi,894,103,1390,88,496,2
0XFB550573BDD938A.avi,714,65,1172,54,458,2
0XFBA686750D879E6.avi,1339,72,2415,54,1076,2
0XFBAA07C60AF61C2.avi,2261,59,3372,41,1111,2
0XFBC3E8226CE1D25.avi,926,89,1627,76,701,2
0XFBD22BB93EE05C1.avi,1216,56,1878,39,662,2
0XFC193B557F698B6.avi,1673,65,2087,45,414,2
0XFC2F8325071BDC2.avi,1114,59,1847,45,733,2
0XFC6499D603B9E1E.avi,1244,136,1715,116,471,2
0XFCB2810C93F7F5D.avi,1550,90,1816,81,266,2
0XFCC2AF8E23AFBA8.avi,1165,57,1891,41,726,2
0XFCDC29AA6B8E83B.avi,1568,89,1707,75,139,2
0XFCF860A2A9C211.avi,1087,63,1682,47,595,2
0XFD06AD51C6DA6E5.avi,1088,62,1631,47,543,2
0XFD513BE6D49349F.avi,1416,59,2126,43,710,2
0XFD9464CF9E40B66.avi,863,121,1665,106,802,2
0XFDB874C30A9C923.avi,1699,73,1930,53,231,2
0XFDC39A88895DE1E.avi,1023,63,1526,42,503,2
0XFDFBA5702E94ABF.avi,1403,117,2091,100,688,2
0XFDFD17B7CCFE5AF.avi,965,85,1545,66,580,2
0XFE6E32991136338.avi,1306,45,1644,31,338,2
0XFE83FF3D3B13C3A.avi,791,67,1205,49,414,2
0XFEBEEFF93F6FEB9.avi,1213,38,1407,25,194,2
