FileName,Frame,PixelCount,OriginalPixelCount,PixelIncrease,PercentIncrease,CorrectionMethod,KernelSize,Iterations
0X100009310A3BD7FC.avi,46,1744,1348,396,29.376854599406528,morphological_dilation,3,2
0X100009310A3BD7FC.avi,61,854,543,311,57.2744014732965,morphological_dilation,3,2
0X1002E8FBACD08477.avi,3,1593,1225,368,30.04081632653061,morphological_dilation,3,2
0X1002E8FBACD08477.avi,18,960,680,280,41.17647058823529,morphological_dilation,3,2
0X1005D03EED19C65B.avi,24,1166,842,324,38.47980997624703,morphological_dilation,3,2
0X1005D03EED19C65B.avi,35,728,472,256,54.23728813559322,morphological_dilation,3,2
0X10075961BC11C88E.avi,91,1445,1109,336,30.297565374211,morphological_dilation,3,2
0X10075961BC11C88E.avi,108,997,705,292,41.41843971631206,morphological_dilation,3,2
0X10094BA0A028EAC3.avi,137,2514,2070,444,21.44927536231884,morphological_dilation,3,2
0X10094BA0A028EAC3.avi,156,2077,1677,400,23.85211687537269,morphological_dilation,3,2
0X100CF05D141FF143.avi,132,1719,1339,380,28.37938760268857,morphological_dilation,3,2
0X100CF05D141FF143.avi,148,1117,805,312,38.75776397515528,morphological_dilation,3,2
0X100E3B8D3280BEC5.avi,25,1657,1293,364,28.151585460170146,morphological_dilation,3,2
0X100E3B8D3280BEC5.avi,38,1273,961,312,32.46618106139438,morphological_dilation,3,2
0X100E491B3CD58DE2.avi,49,1739,1347,392,29.101707498144023,morphological_dilation,3,2
0X100E491B3CD58DE2.avi,75,1403,1055,348,32.98578199052133,morphological_dilation,3,2
0X100F044876B98F90.avi,56,1622,1234,388,31.442463533225286,morphological_dilation,3,2
0X100F044876B98F90.avi,72,972,631,341,54.04120443740095,morphological_dilation,3,2
0X101026B90DAE7E95.avi,45,2180,1736,444,25.57603686635945,morphological_dilation,3,2
0X101026B90DAE7E95.avi,62,1589,1190,399,33.52941176470588,morphological_dilation,3,2
0X1012703CDC1436FE.avi,154,2765,2303,462,20.060790273556233,morphological_dilation,3,2
0X1012703CDC1436FE.avi,172,2092,1676,416,24.821002386634845,morphological_dilation,3,2
0X1013E8A4864781B.avi,35,828,552,276,50.0,morphological_dilation,3,2
0X1013E8A4864781B.avi,46,520,258,262,101.55038759689923,morphological_dilation,3,2
0X1018521A3BC5CDBA.avi,42,1583,1227,356,29.013854930725348,morphological_dilation,3,2
0X1018521A3BC5CDBA.avi,57,1021,745,276,37.04697986577181,morphological_dilation,3,2
0X101C388397F66EDB.avi,46,2272,1832,440,24.017467248908297,morphological_dilation,3,2
0X101C388397F66EDB.avi,62,1373,1013,360,35.53800592300099,morphological_dilation,3,2
0X101CFC9C5351DCBE.avi,59,2107,1680,427,25.416666666666664,morphological_dilation,3,2
0X101CFC9C5351DCBE.avi,73,1415,1043,372,35.66634707574305,morphological_dilation,3,2
0X101E654AF3FC07A8.avi,109,1088,796,292,36.68341708542713,morphological_dilation,3,2
0X101E654AF3FC07A8.avi,132,641,409,232,56.723716381418086,morphological_dilation,3,2
0X10267ADF2E644E0.avi,150,1566,1194,372,31.155778894472363,morphological_dilation,3,2
0X10267ADF2E644E0.avi,172,902,622,280,45.01607717041801,morphological_dilation,3,2
0X102AE9C68B2C46DA.avi,48,1222,902,320,35.47671840354767,morphological_dilation,3,2
0X102AE9C68B2C46DA.avi,63,895,553,342,61.84448462929476,morphological_dilation,3,2
0X102C51641C321436.avi,0,2149,1761,388,22.032935831913687,morphological_dilation,3,2
0X102C51641C321436.avi,15,1471,1139,332,29.148375768217733,morphological_dilation,3,2
0X102CFB07F752AAE6.avi,163,1926,1514,412,27.212681638044916,morphological_dilation,3,2
0X102CFB07F752AAE6.avi,184,1369,1025,344,33.5609756097561,morphological_dilation,3,2
0X102DD1B9BE03716.avi,52,2316,1884,432,22.929936305732486,morphological_dilation,3,2
0X102DD1B9BE03716.avi,71,1552,1184,368,31.08108108108108,morphological_dilation,3,2
0X102E453603FA1440.avi,46,2433,1997,436,21.832749123685527,morphological_dilation,3,2
0X102E453603FA1440.avi,60,1332,1004,328,32.669322709163346,morphological_dilation,3,2
0X102E94908346DE1D.avi,116,1421,1073,348,32.432432432432435,morphological_dilation,3,2
0X102E94908346DE1D.avi,138,1069,761,308,40.473061760841,morphological_dilation,3,2
0X102F3D4CD5E10801.avi,0,2042,1642,400,24.3605359317905,morphological_dilation,3,2
0X102F3D4CD5E10801.avi,22,1414,1082,332,30.683918669131238,morphological_dilation,3,2
0X10365E52F01510B4.avi,28,1929,1541,388,25.17845554834523,morphological_dilation,3,2
0X10365E52F01510B4.avi,36,1242,898,344,38.30734966592428,morphological_dilation,3,2
0X1039108E17193B1C.avi,60,2426,1954,472,24.15557830092119,morphological_dilation,3,2
0X1039108E17193B1C.avi,79,1558,1170,388,33.16239316239316,morphological_dilation,3,2
0X1039B49145DF4F25.avi,40,1318,998,320,32.06412825651302,morphological_dilation,3,2
0X1039B49145DF4F25.avi,57,875,599,276,46.07679465776294,morphological_dilation,3,2
0X103A55B2546EF36E.avi,166,1967,1563,404,25.84772872680742,morphological_dilation,3,2
0X103A55B2546EF36E.avi,186,1305,957,348,36.36363636363637,morphological_dilation,3,2
0X103BE163257D663A.avi,47,1330,978,352,35.991820040899796,morphological_dilation,3,2
0X103BE163257D663A.avi,69,918,614,304,49.5114006514658,morphological_dilation,3,2
0X1040C376CF369A01.avi,52,1303,975,328,33.64102564102564,morphological_dilation,3,2
0X1040C376CF369A01.avi,64,806,534,272,50.936329588014985,morphological_dilation,3,2
0X1040D64234D3E916.avi,90,1919,1528,391,25.589005235602098,morphological_dilation,3,2
0X1040D64234D3E916.avi,108,1148,818,330,40.34229828850856,morphological_dilation,3,2
0X1043D3D352972862.avi,91,1584,1236,348,28.155339805825243,morphological_dilation,3,2
0X1043D3D352972862.avi,113,1154,846,308,36.40661938534279,morphological_dilation,3,2
0X1045F1B5A0A5EA54.avi,57,1399,1043,356,34.13231064237775,morphological_dilation,3,2
0X1045F1B5A0A5EA54.avi,73,1036,712,324,45.50561797752809,morphological_dilation,3,2
0X104D2C3D60AE3DE8.avi,145,3391,2871,520,18.112156043190524,morphological_dilation,3,2
0X104D2C3D60AE3DE8.avi,163,1903,1503,400,26.61343978709248,morphological_dilation,3,2
0X105039B849CDB1CD.avi,55,1951,1547,404,26.11506140917906,morphological_dilation,3,2
0X105039B849CDB1CD.avi,73,1197,873,324,37.11340206185567,morphological_dilation,3,2
0X10516E63208D8EA1.avi,51,1944,1538,406,26.397919375812744,morphological_dilation,3,2
0X10516E63208D8EA1.avi,66,1279,918,361,39.32461873638344,morphological_dilation,3,2
0X1055D6B76E5D7556.avi,75,1206,898,308,34.29844097995546,morphological_dilation,3,2
0X1055D6B76E5D7556.avi,90,818,546,272,49.81684981684982,morphological_dilation,3,2
0X10569E00E4DFFF7D.avi,36,1261,941,320,34.00637619553667,morphological_dilation,3,2
0X10569E00E4DFFF7D.avi,53,609,371,238,64.15094339622641,morphological_dilation,3,2
0X1059077339EF0869.avi,90,1863,1463,400,27.34107997265892,morphological_dilation,3,2
0X1059077339EF0869.avi,116,1122,789,333,42.20532319391635,morphological_dilation,3,2
0X105B9EF57DE45DCB.avi,106,2411,1975,436,22.075949367088608,morphological_dilation,3,2
0X105B9EF57DE45DCB.avi,121,1747,1359,388,28.550404709345106,morphological_dilation,3,2
0X105CDF495F9A9A43.avi,71,1826,1430,396,27.692307692307693,morphological_dilation,3,2
0X105CDF495F9A9A43.avi,89,1219,879,340,38.68031854379977,morphological_dilation,3,2
0X105D400DBDB7A1FA.avi,78,2303,1859,444,23.883808499193115,morphological_dilation,3,2
0X105D400DBDB7A1FA.avi,96,1456,1100,356,32.36363636363636,morphological_dilation,3,2
0X105E0E36E611D657.avi,69,2375,1931,444,22.993267736923872,morphological_dilation,3,2
0X105E0E36E611D657.avi,86,1708,1324,384,29.003021148036257,morphological_dilation,3,2
0X10623D3AF96AC271.avi,34,3868,3296,572,17.354368932038835,morphological_dilation,3,2
0X10623D3AF96AC271.avi,52,1905,1525,380,24.91803278688525,morphological_dilation,3,2
0X1062E316DF137FDB.avi,123,1327,986,341,34.5841784989858,morphological_dilation,3,2
0X1062E316DF137FDB.avi,140,768,488,280,57.377049180327866,morphological_dilation,3,2
0X10648BFB1458861.avi,30,2164,1732,432,24.94226327944573,morphological_dilation,3,2
0X10648BFB1458861.avi,39,1585,1201,384,31.973355537052456,morphological_dilation,3,2
0X106766224781FAE2.avi,47,1579,1211,368,30.388109000825764,morphological_dilation,3,2
0X106766224781FAE2.avi,65,1036,728,308,42.30769230769231,morphological_dilation,3,2
0X106A8FDB8A83534B.avi,60,1681,1321,360,27.252081756245268,morphological_dilation,3,2
0X106A8FDB8A83534B.avi,72,1012,732,280,38.25136612021858,morphological_dilation,3,2
0X106B384BEED608E3.avi,68,1980,1584,396,25.0,morphological_dilation,3,2
0X106B384BEED608E3.avi,83,1123,815,308,37.79141104294478,morphological_dilation,3,2
0X106E73F4961CC47B.avi,88,1581,1229,352,28.641171684296175,morphological_dilation,3,2
0X106E73F4961CC47B.avi,104,992,708,284,40.11299435028249,morphological_dilation,3,2
0X106EA7D9DEC59EA9.avi,96,1887,1499,388,25.883922615076717,morphological_dilation,3,2
0X106EA7D9DEC59EA9.avi,110,1332,996,336,33.734939759036145,morphological_dilation,3,2
0X106FE6CF624D4C8C.avi,55,2056,1656,400,24.154589371980677,morphological_dilation,3,2
0X106FE6CF624D4C8C.avi,74,1331,1011,320,31.65182987141444,morphological_dilation,3,2
0X1070ABA581A9A255.avi,41,1533,1177,356,30.246389124893795,morphological_dilation,3,2
0X1070ABA581A9A255.avi,58,1008,708,300,42.3728813559322,morphological_dilation,3,2
0X107458C8895A9AC9.avi,96,1350,1004,346,34.462151394422314,morphological_dilation,3,2
0X107458C8895A9AC9.avi,110,905,605,300,49.586776859504134,morphological_dilation,3,2
0X1082BF2A3762D881.avi,44,1913,1521,392,25.77251808021039,morphological_dilation,3,2
0X1082BF2A3762D881.avi,67,1490,1146,344,30.017452006980804,morphological_dilation,3,2
0X1088B755BC61AF23.avi,42,1396,1052,344,32.69961977186312,morphological_dilation,3,2
0X1088B755BC61AF23.avi,52,768,492,276,56.09756097560976,morphological_dilation,3,2
0X108B163EEADDDABC.avi,40,1759,1367,392,28.675932699341622,morphological_dilation,3,2
0X108B163EEADDDABC.avi,55,1150,838,312,37.23150357995227,morphological_dilation,3,2
0X108B4B26B48E417B.avi,65,1228,912,316,34.64912280701755,morphological_dilation,3,2
0X108B4B26B48E417B.avi,76,889,607,282,46.45799011532125,morphological_dilation,3,2
0X1093398DC18FB3B3.avi,53,3160,2656,504,18.97590361445783,morphological_dilation,3,2
0X1093398DC18FB3B3.avi,75,1808,1416,392,27.683615819209038,morphological_dilation,3,2
0X1096572D64654BBD.avi,76,1139,827,312,37.726723095526,morphological_dilation,3,2
0X1096572D64654BBD.avi,93,809,522,287,54.98084291187739,morphological_dilation,3,2
0X1098A9CCA66A5DD0.avi,38,1650,1278,372,29.107981220657276,morphological_dilation,3,2
0X1098A9CCA66A5DD0.avi,53,1125,809,316,39.060568603213845,morphological_dilation,3,2
0X109D27B0A540F9F6.avi,51,1470,1126,344,30.550621669627,morphological_dilation,3,2
0X109D27B0A540F9F6.avi,64,974,678,296,43.657817109144545,morphological_dilation,3,2
0X10A28877E97DF540.avi,69,2242,1814,428,23.594266813671442,morphological_dilation,3,2
0X10A28877E97DF540.avi,87,1327,991,336,33.90514631685166,morphological_dilation,3,2
0X10A5FC19152B50A5.avi,112,2327,1879,448,23.842469398616284,morphological_dilation,3,2
0X10A5FC19152B50A5.avi,125,1355,998,357,35.77154308617235,morphological_dilation,3,2
0X10A8ADB48536C3D5.avi,88,2178,1770,408,23.050847457627118,morphological_dilation,3,2
0X10A8ADB48536C3D5.avi,97,1939,1543,396,25.664290343486712,morphological_dilation,3,2
0X10A9B17E26220232.avi,61,1591,1215,376,30.946502057613166,morphological_dilation,3,2
0X10A9B17E26220232.avi,80,950,654,296,45.25993883792049,morphological_dilation,3,2
0X10ABB3401FC5EC2D.avi,51,1932,1540,392,25.454545454545453,morphological_dilation,3,2
0X10ABB3401FC5EC2D.avi,71,1119,811,308,37.97780517879161,morphological_dilation,3,2
0X10AD385C206C85C.avi,133,1196,884,312,35.294117647058826,morphological_dilation,3,2
0X10AD385C206C85C.avi,145,946,666,280,42.04204204204204,morphological_dilation,3,2
0X10B04432B90E5AC2.avi,66,1692,1292,400,30.959752321981426,morphological_dilation,3,2
0X10B04432B90E5AC2.avi,83,1120,796,324,40.7035175879397,morphological_dilation,3,2
0X10B063E16BA7BEE3.avi,96,2153,1733,420,24.23542989036353,morphological_dilation,3,2
0X10B063E16BA7BEE3.avi,107,1767,1375,392,28.50909090909091,morphological_dilation,3,2
0X10B13E581B12A53C.avi,39,1225,921,304,33.00760043431053,morphological_dilation,3,2
0X10B13E581B12A53C.avi,53,799,547,252,46.06946983546618,morphological_dilation,3,2
0X10B7505562B0A702.avi,61,1784,1412,372,26.345609065155806,morphological_dilation,3,2
0X10B7505562B0A702.avi,77,1183,875,308,35.199999999999996,morphological_dilation,3,2
0X10BC6AA53115AA06.avi,42,2282,1842,440,23.887079261672095,morphological_dilation,3,2
0X10BC6AA53115AA06.avi,61,1516,1148,368,32.05574912891986,morphological_dilation,3,2
0X10BD75A3203C3BB9.avi,50,1778,1390,388,27.913669064748202,morphological_dilation,3,2
0X10BD75A3203C3BB9.avi,66,1185,841,344,40.903686087990486,morphological_dilation,3,2
0X10BDFD27E27D56A9.avi,1,1570,1186,384,32.377740303541316,morphological_dilation,3,2
0X10BDFD27E27D56A9.avi,20,1048,700,348,49.714285714285715,morphological_dilation,3,2
0X10BFDDD409BA5A7A.avi,43,1735,1335,400,29.962546816479403,morphological_dilation,3,2
0X10BFDDD409BA5A7A.avi,57,1066,742,324,43.66576819407008,morphological_dilation,3,2
0X10C2D4AA0721C0FB.avi,149,1984,1544,440,28.497409326424872,morphological_dilation,3,2
0X10C2D4AA0721C0FB.avi,166,1200,848,352,41.509433962264154,morphological_dilation,3,2
0X10C3E084B3ABE52A.avi,4,1722,1330,392,29.47368421052631,morphological_dilation,3,2
0X10C3E084B3ABE52A.avi,20,1109,760,349,45.921052631578945,morphological_dilation,3,2
0X10C4823DD13E1869.avi,49,3039,2524,515,20.404120443740094,morphological_dilation,3,2
0X10C4823DD13E1869.avi,67,1969,1541,428,27.774172615184945,morphological_dilation,3,2
0X10C53B6D1D01A54A.avi,91,2877,2377,500,21.03491796381994,morphological_dilation,3,2
0X10C53B6D1D01A54A.avi,112,1735,1315,420,31.93916349809886,morphological_dilation,3,2
0X10CA19FBE6D26A71.avi,53,2011,1604,407,25.374064837905237,morphological_dilation,3,2
0X10CA19FBE6D26A71.avi,70,1227,887,340,38.331454340473506,morphological_dilation,3,2
0X10D11D93FB71B19C.avi,103,2524,2048,476,23.2421875,morphological_dilation,3,2
0X10D11D93FB71B19C.avi,118,1497,1109,388,34.98647430117223,morphological_dilation,3,2
0X10D1B5DDEBC0E3C8.avi,31,1740,1340,400,29.850746268656714,morphological_dilation,3,2
0X10D1B5DDEBC0E3C8.avi,41,1204,844,360,42.65402843601896,morphological_dilation,3,2
0X10D278E3FD2DE072.avi,82,1920,1532,388,25.326370757180154,morphological_dilation,3,2
0X10D278E3FD2DE072.avi,99,1100,800,300,37.5,morphological_dilation,3,2
0X10D5F8CF0EB124.avi,110,1878,1494,384,25.702811244979916,morphological_dilation,3,2
0X10D5F8CF0EB124.avi,132,1628,1272,356,27.9874213836478,morphological_dilation,3,2
0X10D734CBEB6ECB81.avi,5,1267,943,324,34.35843054082714,morphological_dilation,3,2
0X10D734CBEB6ECB81.avi,13,1001,721,280,38.83495145631068,morphological_dilation,3,2
0X10D8F5659B144070.avi,57,1178,862,316,36.65893271461717,morphological_dilation,3,2
0X10D8F5659B144070.avi,71,869,572,297,51.92307692307693,morphological_dilation,3,2
0X10DEF75CF6DC6B84.avi,116,1913,1485,428,28.82154882154882,morphological_dilation,3,2
0X10DEF75CF6DC6B84.avi,134,1276,924,352,38.095238095238095,morphological_dilation,3,2
0X10E197789006C3D5.avi,111,1886,1482,404,27.26045883940621,morphological_dilation,3,2
0X10E197789006C3D5.avi,126,1115,803,312,38.85429638854296,morphological_dilation,3,2
0X10E47D630E15DE12.avi,87,2833,2345,488,20.810234541577824,morphological_dilation,3,2
0X10E47D630E15DE12.avi,108,2279,1843,436,23.657080846446014,morphological_dilation,3,2
0X10E57E24DBA5788.avi,45,2392,1980,412,20.80808080808081,morphological_dilation,3,2
0X10E57E24DBA5788.avi,61,2040,1652,388,23.486682808716708,morphological_dilation,3,2
0X10E60C3C123CAEB8.avi,58,1484,1132,352,31.09540636042403,morphological_dilation,3,2
0X10E60C3C123CAEB8.avi,85,919,631,288,45.64183835182251,morphological_dilation,3,2
0X10EFC1D17C7FB199.avi,179,1212,872,340,38.99082568807339,morphological_dilation,3,2
0X10EFC1D17C7FB199.avi,195,837,541,296,54.71349353049908,morphological_dilation,3,2
0X10F04F8DFB86BAEE.avi,43,2014,1606,408,25.404732254047325,morphological_dilation,3,2
0X10F04F8DFB86BAEE.avi,62,1521,1181,340,28.789161727349704,morphological_dilation,3,2
0X10F6FD4A9C6A458E.avi,46,2785,2305,480,20.824295010845987,morphological_dilation,3,2
0X10F6FD4A9C6A458E.avi,66,1560,1188,372,31.313131313131315,morphological_dilation,3,2
0X10FCACE551DE0CEB.avi,50,1534,1174,360,30.664395229982965,morphological_dilation,3,2
0X10FCACE551DE0CEB.avi,68,872,596,276,46.308724832214764,morphological_dilation,3,2
0X11000DD0D10B399F.avi,57,1599,1221,378,30.95823095823096,morphological_dilation,3,2
0X11000DD0D10B399F.avi,71,1025,725,300,41.37931034482759,morphological_dilation,3,2
0X1100A0AA0BDBAE92.avi,49,1427,1091,336,30.7974335472044,morphological_dilation,3,2
0X1100A0AA0BDBAE92.avi,68,976,684,292,42.69005847953216,morphological_dilation,3,2
0X1106795368C7DE44.avi,38,2447,1963,484,24.656138563423333,morphological_dilation,3,2
0X1106795368C7DE44.avi,49,1534,1134,400,35.273368606701936,morphological_dilation,3,2
0X1108EED6EC60971E.avi,51,1789,1413,376,26.610049539985848,morphological_dilation,3,2
0X1108EED6EC60971E.avi,70,1087,783,304,38.8250319284802,morphological_dilation,3,2
0X110A2E1C465B1B53.avi,103,1754,1382,372,26.91751085383502,morphological_dilation,3,2
0X110A2E1C465B1B53.avi,119,1092,772,320,41.45077720207254,morphological_dilation,3,2
0X11109B2A42A4C76E.avi,123,2563,2107,456,21.642145230185097,morphological_dilation,3,2
0X11109B2A42A4C76E.avi,135,1835,1423,412,28.952916373858045,morphological_dilation,3,2
0X11116A740B44446A.avi,94,1994,1586,408,25.72509457755359,morphological_dilation,3,2
0X11116A740B44446A.avi,112,1340,1000,340,34.0,morphological_dilation,3,2
0X1112442D58D48C79.avi,61,2423,1999,424,21.210605302651324,morphological_dilation,3,2
0X1112442D58D48C79.avi,72,1431,1083,348,32.13296398891966,morphological_dilation,3,2
0X11199500C4901088.avi,3,1600,1252,348,27.79552715654952,morphological_dilation,3,2
0X11199500C4901088.avi,19,1174,874,300,34.32494279176201,morphological_dilation,3,2
0X111D3734D84AA8B8.avi,109,1885,1477,408,27.623561272850374,morphological_dilation,3,2
0X111D3734D84AA8B8.avi,125,1208,868,340,39.1705069124424,morphological_dilation,3,2
0X111E2E3AD9EB4317.avi,4,2758,2294,464,20.226678291194418,morphological_dilation,3,2
0X111E2E3AD9EB4317.avi,19,1612,1244,368,29.581993569131832,morphological_dilation,3,2
0X111EDA8A1E44169C.avi,97,1446,1080,366,33.88888888888889,morphological_dilation,3,2
0X111EDA8A1E44169C.avi,110,966,666,300,45.04504504504504,morphological_dilation,3,2
0X1123724D7C9FAF61.avi,42,1343,999,344,34.434434434434436,morphological_dilation,3,2
0X1123724D7C9FAF61.avi,59,900,596,304,51.006711409395976,morphological_dilation,3,2
0X1124D3D938A98B7B.avi,58,1838,1446,392,27.10926694329184,morphological_dilation,3,2
0X1124D3D938A98B7B.avi,72,1177,861,316,36.70150987224158,morphological_dilation,3,2
0X112505A983BB4D8E.avi,101,1214,894,320,35.79418344519016,morphological_dilation,3,2
0X112505A983BB4D8E.avi,114,764,504,260,51.587301587301596,morphological_dilation,3,2
0X112668E4C7655E1A.avi,76,1125,829,296,35.70566948130278,morphological_dilation,3,2
0X112668E4C7655E1A.avi,93,749,510,239,46.86274509803921,morphological_dilation,3,2
0X112862331B7E140E.avi,37,3013,2471,542,21.934439498178875,morphological_dilation,3,2
0X112862331B7E140E.avi,58,1674,1254,420,33.49282296650718,morphological_dilation,3,2
0X1128628F2CE14FF4.avi,87,1424,1080,344,31.851851851851855,morphological_dilation,3,2
0X1128628F2CE14FF4.avi,108,1143,835,308,36.88622754491018,morphological_dilation,3,2
0X1129FFF0D45D7EFF.avi,53,3306,2794,512,18.32498210450966,morphological_dilation,3,2
0X1129FFF0D45D7EFF.avi,69,2006,1582,424,26.801517067003793,morphological_dilation,3,2
0X112B93363FA20D8B.avi,31,1571,1215,356,29.300411522633745,morphological_dilation,3,2
0X112B93363FA20D8B.avi,49,1146,838,308,36.754176610978526,morphological_dilation,3,2
0X112D0A3D2ACB8800.avi,128,2774,2286,488,21.347331583552055,morphological_dilation,3,2
0X112D0A3D2ACB8800.avi,149,1672,1272,400,31.446540880503143,morphological_dilation,3,2
0X112E05F05062753E.avi,44,2228,1800,428,23.77777777777778,morphological_dilation,3,2
0X112E05F05062753E.avi,64,1508,1135,373,32.863436123348016,morphological_dilation,3,2
0X112EF236E1F676E4.avi,64,2609,2141,468,21.85894441849603,morphological_dilation,3,2
0X112EF236E1F676E4.avi,87,1669,1278,391,30.59467918622848,morphological_dilation,3,2
0X112F1A9C7DF4A5F2.avi,121,2547,2079,468,22.51082251082251,morphological_dilation,3,2
0X112F1A9C7DF4A5F2.avi,146,1560,1156,404,34.94809688581315,morphological_dilation,3,2
0X11303E45952732BD.avi,88,1928,1512,416,27.513227513227513,morphological_dilation,3,2
0X11303E45952732BD.avi,113,1319,962,357,37.11018711018711,morphological_dilation,3,2
0X113195610E41EF2.avi,54,1702,1330,372,27.969924812030072,morphological_dilation,3,2
0X113195610E41EF2.avi,70,1112,808,304,37.62376237623762,morphological_dilation,3,2
0X1131FB2A374D34F5.avi,59,1531,1163,368,31.64230438521066,morphological_dilation,3,2
0X1131FB2A374D34F5.avi,86,1051,747,304,40.69611780455154,morphological_dilation,3,2
0X1134CC5B50757EEF.avi,64,2161,1757,404,22.993739328400682,morphological_dilation,3,2
0X1134CC5B50757EEF.avi,78,1498,1158,340,29.360967184801385,morphological_dilation,3,2
0X113E6AD75AB62781.avi,121,1397,1049,348,33.17445185891325,morphological_dilation,3,2
0X113E6AD75AB62781.avi,133,1040,740,300,40.54054054054054,morphological_dilation,3,2
0X113E9F83E605C0F5.avi,50,1438,1094,344,31.444241316270567,morphological_dilation,3,2
0X113E9F83E605C0F5.avi,59,928,636,292,45.911949685534594,morphological_dilation,3,2
0X113F9B4D1F9FA03.avi,56,2041,1629,412,25.29158993247391,morphological_dilation,3,2
0X113F9B4D1F9FA03.avi,75,1355,1019,336,32.97350343473994,morphological_dilation,3,2
0X1143688D7F946644.avi,53,2326,1842,484,26.275787187839306,morphological_dilation,3,2
0X1143688D7F946644.avi,67,1402,998,404,40.480961923847694,morphological_dilation,3,2
0X11445CEF92745462.avi,51,1143,815,328,40.24539877300614,morphological_dilation,3,2
0X11445CEF92745462.avi,66,716,456,260,57.01754385964912,morphological_dilation,3,2
0X114B58E6B34E55F1.avi,81,1576,1224,352,28.75816993464052,morphological_dilation,3,2
0X114B58E6B34E55F1.avi,92,1243,909,334,36.743674367436746,morphological_dilation,3,2
0X114DED900F0C2D7D.avi,61,2803,2297,506,22.028733130169787,morphological_dilation,3,2
0X114DED900F0C2D7D.avi,72,2356,1862,494,26.53061224489796,morphological_dilation,3,2
0X1150BD0249677E8F.avi,43,1591,1207,384,31.814415907207955,morphological_dilation,3,2
0X1150BD0249677E8F.avi,63,979,667,312,46.776611694152926,morphological_dilation,3,2
0X1151059A7824211.avi,51,1580,1204,376,31.22923588039867,morphological_dilation,3,2
0X1151059A7824211.avi,72,991,679,312,45.9499263622975,morphological_dilation,3,2
0X1151F27F45E9644F.avi,185,1091,771,320,41.50453955901427,morphological_dilation,3,2
0X1151F27F45E9644F.avi,202,603,342,261,76.31578947368422,morphological_dilation,3,2
0X11537FCF989575BB.avi,51,5201,4521,680,15.040920150409201,morphological_dilation,3,2
0X11537FCF989575BB.avi,71,3261,2709,552,20.376522702104097,morphological_dilation,3,2
0X1154F8CD483D5CD5.avi,78,2373,1921,452,23.52941176470588,morphological_dilation,3,2
0X1154F8CD483D5CD5.avi,100,1601,1209,392,32.42349048800662,morphological_dilation,3,2
0X115841DA5E9DC64D.avi,34,1765,1389,376,27.06983441324694,morphological_dilation,3,2
0X115841DA5E9DC64D.avi,49,1167,851,316,37.132784958871916,morphological_dilation,3,2
0X1161B02E0B2DBB94.avi,1,1582,1203,379,31.504571903574398,morphological_dilation,3,2
0X1161B02E0B2DBB94.avi,18,932,632,300,47.46835443037975,morphological_dilation,3,2
0X11648EA1AD4AE177.avi,38,967,659,308,46.737481031866466,morphological_dilation,3,2
0X11648EA1AD4AE177.avi,55,520,296,224,75.67567567567568,morphological_dilation,3,2
0X1167650B8BEFF863.avi,111,1387,1059,328,30.97261567516525,morphological_dilation,3,2
0X1167650B8BEFF863.avi,123,827,555,272,49.009009009009006,morphological_dilation,3,2
0X11679CCF8428C87.avi,40,2404,1981,423,21.352852094901564,morphological_dilation,3,2
0X11679CCF8428C87.avi,56,2054,1644,410,24.939172749391727,morphological_dilation,3,2
0X116D6A1EFDD8E226.avi,40,1423,1079,344,31.881371640407785,morphological_dilation,3,2
0X116D6A1EFDD8E226.avi,56,932,648,284,43.82716049382716,morphological_dilation,3,2
0X11751D404DAD3313.avi,96,3034,2522,512,20.30134813639968,morphological_dilation,3,2
0X11751D404DAD3313.avi,117,2225,1805,420,23.26869806094183,morphological_dilation,3,2
0X117CAE6A13AA3F5.avi,115,1660,1296,364,28.08641975308642,morphological_dilation,3,2
0X117CAE6A13AA3F5.avi,132,1036,744,292,39.247311827956985,morphological_dilation,3,2
0X117F243A9D657663.avi,97,1698,1298,400,30.81664098613251,morphological_dilation,3,2
0X117F243A9D657663.avi,111,1157,813,344,42.31242312423124,morphological_dilation,3,2
0X117FFBEE3018EEF.avi,37,1427,1063,364,34.24270931326435,morphological_dilation,3,2
0X117FFBEE3018EEF.avi,47,1135,803,332,41.344956413449566,morphological_dilation,3,2
0X1185DA5AB0D9BE6A.avi,54,1391,1063,328,30.85606773283161,morphological_dilation,3,2
0X1185DA5AB0D9BE6A.avi,66,980,696,284,40.804597701149426,morphological_dilation,3,2
0X11861625D2695B1F.avi,47,2228,1808,420,23.23008849557522,morphological_dilation,3,2
0X11861625D2695B1F.avi,61,1251,931,320,34.371643394199786,morphological_dilation,3,2
0X118EF5AEED2E28EC.avi,33,2171,1763,408,23.142370958593304,morphological_dilation,3,2
0X118EF5AEED2E28EC.avi,48,1451,1084,367,33.85608856088561,morphological_dilation,3,2
0X119154A48FDF0A82.avi,55,1542,1202,340,28.286189683860236,morphological_dilation,3,2
0X119154A48FDF0A82.avi,77,1034,742,292,39.35309973045822,morphological_dilation,3,2
0X1192B98E520E87C8.avi,75,1298,949,349,36.775553213909376,morphological_dilation,3,2
0X1192B98E520E87C8.avi,102,861,544,317,58.27205882352941,morphological_dilation,3,2
0X119C98019EFAA0F4.avi,48,1897,1505,392,26.046511627906977,morphological_dilation,3,2
0X119C98019EFAA0F4.avi,69,1084,780,304,38.97435897435898,morphological_dilation,3,2
0X11A07A83B21CFE1E.avi,96,1880,1500,380,25.333333333333336,morphological_dilation,3,2
0X11A07A83B21CFE1E.avi,111,1137,825,312,37.81818181818182,morphological_dilation,3,2
0X11A3165A8DC20F2D.avi,72,1253,933,320,34.29796355841372,morphological_dilation,3,2
0X11A3165A8DC20F2D.avi,85,933,647,286,44.20401854714065,morphological_dilation,3,2
0X11A3EC0D91F0CD3B.avi,42,1700,1309,391,29.87012987012987,morphological_dilation,3,2
0X11A3EC0D91F0CD3B.avi,55,1057,739,318,43.031123139377534,morphological_dilation,3,2
0X11B01A59D74693C4.avi,2,1998,1586,412,25.97730138713745,morphological_dilation,3,2
0X11B01A59D74693C4.avi,21,1384,1036,348,33.59073359073359,morphological_dilation,3,2
0X11B7D2EE96990A8D.avi,35,1669,1297,372,28.681572860447186,morphological_dilation,3,2
0X11B7D2EE96990A8D.avi,54,1127,783,344,43.93358876117497,morphological_dilation,3,2
0X11BACBBF79E25D1E.avi,25,1747,1387,360,25.95529920692141,morphological_dilation,3,2
0X11BACBBF79E25D1E.avi,34,1147,837,310,37.03703703703704,morphological_dilation,3,2
0X11BC6C9DEA4C94C7.avi,156,1771,1383,388,28.054953000723064,morphological_dilation,3,2
0X11BC6C9DEA4C94C7.avi,170,1138,818,320,39.119804400978,morphological_dilation,3,2
0X11BDF610427B903F.avi,42,1863,1467,396,26.993865030674847,morphological_dilation,3,2
0X11BDF610427B903F.avi,58,1265,941,324,34.431455897980875,morphological_dilation,3,2
0X11BE656DE80C9CF2.avi,75,1877,1473,404,27.42701968771215,morphological_dilation,3,2
0X11BE656DE80C9CF2.avi,97,1199,867,332,38.292964244521336,morphological_dilation,3,2
0X11C1412786BCBB50.avi,68,1706,1342,364,27.123695976154995,morphological_dilation,3,2
0X11C1412786BCBB50.avi,85,1441,1102,339,30.762250453720508,morphological_dilation,3,2
0X11C5F414FDFFA6FE.avi,18,1447,1087,360,33.11867525298988,morphological_dilation,3,2
0X11C5F414FDFFA6FE.avi,27,746,494,252,51.012145748987855,morphological_dilation,3,2
0X11C89001BEF939E2.avi,65,2305,1877,428,22.802344166222696,morphological_dilation,3,2
0X11C89001BEF939E2.avi,78,1742,1363,379,27.806309611151868,morphological_dilation,3,2
0X11C9572ABEDC9715.avi,86,1920,1528,392,25.654450261780106,morphological_dilation,3,2
0X11C9572ABEDC9715.avi,101,1301,977,324,33.16274309109519,morphological_dilation,3,2
0X11CC3D00A37FE7DF.avi,137,1677,1313,364,27.722772277227726,morphological_dilation,3,2
0X11CC3D00A37FE7DF.avi,148,1152,832,320,38.46153846153847,morphological_dilation,3,2
0X11D525180CDD1ECD.avi,41,1212,860,352,40.93023255813954,morphological_dilation,3,2
0X11D525180CDD1ECD.avi,59,964,656,308,46.95121951219512,morphological_dilation,3,2
0X11D53502D38B208F.avi,59,1258,926,332,35.85313174946004,morphological_dilation,3,2
0X11D53502D38B208F.avi,69,775,507,268,52.85996055226825,morphological_dilation,3,2
0X11DA79F89EE37D3B.avi,76,1367,1043,324,31.064237775647175,morphological_dilation,3,2
0X11DA79F89EE37D3B.avi,89,800,540,260,48.148148148148145,morphological_dilation,3,2
0X11DD5C8CC2A4D225.avi,37,3876,3296,580,17.597087378640776,morphological_dilation,3,2
0X11DD5C8CC2A4D225.avi,52,2274,1800,474,26.333333333333332,morphological_dilation,3,2
0X11DF3DEE0B2544FE.avi,93,1864,1456,408,28.021978021978022,morphological_dilation,3,2
0X11DF3DEE0B2544FE.avi,110,1401,1041,360,34.5821325648415,morphological_dilation,3,2
0X11E0A9338456F4AA.avi,143,1457,1097,360,32.81677301731996,morphological_dilation,3,2
0X11E0A9338456F4AA.avi,155,990,682,308,45.16129032258064,morphological_dilation,3,2
0X11E371F35DEBE8B4.avi,49,1610,1238,372,30.048465266558967,morphological_dilation,3,2
0X11E371F35DEBE8B4.avi,67,1023,707,316,44.6958981612447,morphological_dilation,3,2
0X11E3FA2DD4ADD675.avi,40,2397,1953,444,22.734254992319507,morphological_dilation,3,2
0X11E3FA2DD4ADD675.avi,54,2033,1608,425,26.430348258706466,morphological_dilation,3,2
0X11F088FA228B2BE8.avi,56,1940,1536,404,26.302083333333332,morphological_dilation,3,2
0X11F088FA228B2BE8.avi,75,1263,947,316,33.36853220696938,morphological_dilation,3,2
0X11F7628563B5B391.avi,114,2141,1697,444,26.163818503241014,morphological_dilation,3,2
0X11F7628563B5B391.avi,129,1367,938,429,45.73560767590618,morphological_dilation,3,2
0X11F798A4F0181ACF.avi,59,1523,1183,340,28.740490278951818,morphological_dilation,3,2
0X11F798A4F0181ACF.avi,77,875,619,256,41.35702746365105,morphological_dilation,3,2
0X12006C9A54BEED76.avi,34,1696,1324,372,28.09667673716012,morphological_dilation,3,2
0X12006C9A54BEED76.avi,48,1050,738,312,42.27642276422765,morphological_dilation,3,2
0X1205884E675E58B9.avi,57,1416,1092,324,29.67032967032967,morphological_dilation,3,2
0X1205884E675E58B9.avi,70,834,586,248,42.32081911262799,morphological_dilation,3,2
0X120CAF5F957C906C.avi,42,1825,1445,380,26.297577854671278,morphological_dilation,3,2
0X120CAF5F957C906C.avi,64,1357,1013,344,33.95853899308983,morphological_dilation,3,2
0X120E33CFA2D0FF00.avi,108,2061,1661,400,24.08187838651415,morphological_dilation,3,2
0X120E33CFA2D0FF00.avi,126,1289,961,328,34.13111342351717,morphological_dilation,3,2
0X1210DA53C9475EBF.avi,151,2892,2396,496,20.70116861435726,morphological_dilation,3,2
0X1210DA53C9475EBF.avi,166,1916,1492,424,28.418230563002684,morphological_dilation,3,2
0X1212FB5C4E7021B8.avi,39,2634,2174,460,21.159153633854647,morphological_dilation,3,2
0X1212FB5C4E7021B8.avi,55,1847,1451,396,27.291523087525842,morphological_dilation,3,2
0X12143BF23189A122.avi,47,1532,1172,360,30.716723549488055,morphological_dilation,3,2
0X12143BF23189A122.avi,61,961,665,296,44.51127819548872,morphological_dilation,3,2
0X12185F79407DF986.avi,51,1971,1552,419,26.99742268041237,morphological_dilation,3,2
0X12185F79407DF986.avi,67,1413,1065,348,32.67605633802817,morphological_dilation,3,2
0X121968806D66B71F.avi,38,1345,1017,328,32.25172074729597,morphological_dilation,3,2
0X121968806D66B71F.avi,50,842,574,268,46.68989547038328,morphological_dilation,3,2
0X1219DA80A35E3B5F.avi,67,2994,2482,512,20.628525382755843,morphological_dilation,3,2
0X1219DA80A35E3B5F.avi,84,1779,1379,400,29.0065264684554,morphological_dilation,3,2
0X121ED339D11C4F6B.avi,62,1601,1221,380,31.122031122031125,morphological_dilation,3,2
0X121ED339D11C4F6B.avi,74,962,666,296,44.44444444444444,morphological_dilation,3,2
0X1220B4C71FD9D82.avi,1,1521,1165,356,30.55793991416309,morphological_dilation,3,2
0X1220B4C71FD9D82.avi,14,800,532,268,50.37593984962406,morphological_dilation,3,2
0X1222EAE9D581E210.avi,35,2343,1915,428,22.349869451697128,morphological_dilation,3,2
0X1222EAE9D581E210.avi,57,1342,1002,340,33.93213572854291,morphological_dilation,3,2
0X1225C19111629C6F.avi,89,2162,1730,432,24.971098265895954,morphological_dilation,3,2
0X1225C19111629C6F.avi,105,1309,957,352,36.7816091954023,morphological_dilation,3,2
0X1227CDDF6A114129.avi,51,1410,1074,336,31.28491620111732,morphological_dilation,3,2
0X1227CDDF6A114129.avi,66,661,437,224,51.25858123569794,morphological_dilation,3,2
0X123B2FFEBC042304.avi,101,2073,1665,408,24.504504504504503,morphological_dilation,3,2
0X123B2FFEBC042304.avi,118,1210,882,328,37.188208616780045,morphological_dilation,3,2
0X123BE57301362DA4.avi,38,1692,1312,380,28.96341463414634,morphological_dilation,3,2
0X123BE57301362DA4.avi,49,1110,790,320,40.50632911392405,morphological_dilation,3,2
0X123D5FE0A5DC7E1D.avi,35,1465,1088,377,34.650735294117645,morphological_dilation,3,2
0X123D5FE0A5DC7E1D.avi,52,1011,703,308,43.81223328591749,morphological_dilation,3,2
0X123F96492CB893D6.avi,72,2416,1968,448,22.76422764227642,morphological_dilation,3,2
0X123F96492CB893D6.avi,87,1652,1268,384,30.28391167192429,morphological_dilation,3,2
0X124030F8B3C1A5AF.avi,22,1087,777,310,39.897039897039896,morphological_dilation,3,2
0X124030F8B3C1A5AF.avi,42,1686,1306,380,29.096477794793262,morphological_dilation,3,2
0X12430512E2BBCD55.avi,38,859,595,264,44.36974789915966,morphological_dilation,3,2
0X12430512E2BBCD55.avi,50,577,357,220,61.62464985994398,morphological_dilation,3,2
0X124823D11EF8E321.avi,72,3019,2535,484,19.092702169625248,morphological_dilation,3,2
0X124823D11EF8E321.avi,88,1882,1482,400,26.99055330634278,morphological_dilation,3,2
0X12508E9DD1BA59B5.avi,89,1691,1295,396,30.57915057915058,morphological_dilation,3,2
0X12508E9DD1BA59B5.avi,107,930,613,317,51.71288743882545,morphological_dilation,3,2
0X125C10BA973D3B07.avi,41,2059,1675,384,22.925373134328357,morphological_dilation,3,2
0X125C10BA973D3B07.avi,59,1775,1415,360,25.4416961130742,morphological_dilation,3,2
0X12628F033A56EB6F.avi,2,1683,1313,370,28.179741051028177,morphological_dilation,3,2
0X12628F033A56EB6F.avi,16,1025,725,300,41.37931034482759,morphological_dilation,3,2
0X1262A9E08289B606.avi,58,2391,1955,436,22.30179028132992,morphological_dilation,3,2
0X1262A9E08289B606.avi,73,1378,1042,336,32.24568138195777,morphological_dilation,3,2
0X1264B4000299A44A.avi,3,1350,1014,336,33.13609467455622,morphological_dilation,3,2
0X1264B4000299A44A.avi,14,829,569,260,45.69420035149385,morphological_dilation,3,2
0X126C02C8B984672B.avi,74,2336,1896,440,23.20675105485232,morphological_dilation,3,2
0X126C02C8B984672B.avi,92,1372,1036,336,32.432432432432435,morphological_dilation,3,2
0X126D2362E5A0A3E2.avi,86,1677,1285,392,30.505836575875488,morphological_dilation,3,2
0X126D2362E5A0A3E2.avi,100,1062,738,324,43.90243902439025,morphological_dilation,3,2
0X12743BE18328C2CB.avi,126,1544,1188,356,29.96632996632997,morphological_dilation,3,2
0X12743BE18328C2CB.avi,143,992,688,304,44.18604651162791,morphological_dilation,3,2
0X12746954583128D.avi,126,1563,1203,360,29.925187032418954,morphological_dilation,3,2
0X12746954583128D.avi,142,920,632,288,45.56962025316456,morphological_dilation,3,2
0X1274EA614B0388C1.avi,0,1565,1221,344,28.173628173628174,morphological_dilation,3,2
0X1274EA614B0388C1.avi,16,1379,1055,324,30.71090047393365,morphological_dilation,3,2
0X1276054526651444.avi,49,2951,2440,511,20.942622950819672,morphological_dilation,3,2
0X1276054526651444.avi,65,2137,1694,443,26.15112160566706,morphological_dilation,3,2
0X127779E8265AE7DF.avi,150,3911,3339,572,17.130877508235997,morphological_dilation,3,2
0X127779E8265AE7DF.avi,172,2722,2227,495,22.227211495285136,morphological_dilation,3,2
0X127A2C51D192532D.avi,42,1724,1328,396,29.819277108433734,morphological_dilation,3,2
0X127A2C51D192532D.avi,59,1170,826,344,41.64648910411623,morphological_dilation,3,2
0X127D3AEEA73EDE76.avi,64,1447,1087,360,33.11867525298988,morphological_dilation,3,2
0X127D3AEEA73EDE76.avi,73,887,595,292,49.07563025210084,morphological_dilation,3,2
0X127F452F06A3EE97.avi,91,1400,1047,353,33.715377268385865,morphological_dilation,3,2
0X127F452F06A3EE97.avi,109,991,691,300,43.41534008683068,morphological_dilation,3,2
0X12807854DFA9CC01.avi,40,1517,1169,348,29.769033361847736,morphological_dilation,3,2
0X12807854DFA9CC01.avi,54,976,700,276,39.42857142857143,morphological_dilation,3,2
0X128786C169B3ADAE.avi,0,1888,1484,404,27.22371967654987,morphological_dilation,3,2
0X128786C169B3ADAE.avi,16,1080,744,336,45.16129032258064,morphological_dilation,3,2
0X128C3C2C3A7496CB.avi,62,1741,1373,368,26.802621995630005,morphological_dilation,3,2
0X128C3C2C3A7496CB.avi,75,1506,1174,332,28.279386712095402,morphological_dilation,3,2
0X129133A90A61A59D.avi,66,2973,2505,468,18.682634730538922,morphological_dilation,3,2
0X129133A90A61A59D.avi,84,2564,2121,443,20.88637435172089,morphological_dilation,3,2
0X129682A2ECCD415.avi,33,1072,772,300,38.860103626943,morphological_dilation,3,2
0X129682A2ECCD415.avi,42,601,377,224,59.41644562334217,morphological_dilation,3,2
0X1297B85A51C2B20A.avi,49,1817,1441,376,26.092990978487162,morphological_dilation,3,2
0X1297B85A51C2B20A.avi,65,1141,845,296,35.02958579881657,morphological_dilation,3,2
0X129C303CC617D208.avi,42,3035,2523,512,20.293301625049544,morphological_dilation,3,2
0X129C303CC617D208.avi,63,2552,2084,468,22.456813819577732,morphological_dilation,3,2
0X129CDFF3A684DDB9.avi,38,1952,1568,384,24.489795918367346,morphological_dilation,3,2
0X129CDFF3A684DDB9.avi,54,1613,1273,340,26.70856245090338,morphological_dilation,3,2
0X129ED481CEECBD9.avi,49,2006,1590,416,26.163522012578618,morphological_dilation,3,2
0X129ED481CEECBD9.avi,67,1297,941,356,37.83209351753454,morphological_dilation,3,2
0X12A72A2C6FF4C400.avi,72,1602,1234,368,29.821717990275527,morphological_dilation,3,2
0X12A72A2C6FF4C400.avi,92,985,685,300,43.79562043795621,morphological_dilation,3,2
0X12AD71F42865D2A.avi,108,2681,2190,491,22.420091324200914,morphological_dilation,3,2
0X12AD71F42865D2A.avi,128,2043,1602,441,27.52808988764045,morphological_dilation,3,2
0X12B41FA5409312FE.avi,151,2084,1656,428,25.845410628019323,morphological_dilation,3,2
0X12B41FA5409312FE.avi,179,1407,1035,372,35.94202898550725,morphological_dilation,3,2
0X12B468050091669.avi,53,1932,1517,415,27.356624917600524,morphological_dilation,3,2
0X12B468050091669.avi,72,1272,938,334,35.60767590618337,morphological_dilation,3,2
0X12B70D2902C13E73.avi,55,2619,2107,512,24.299952539155196,morphological_dilation,3,2
0X12B70D2902C13E73.avi,82,1568,1150,418,36.347826086956516,morphological_dilation,3,2
0X12B79C738400F3.avi,47,2327,1871,456,24.37199358631748,morphological_dilation,3,2
0X12B79C738400F3.avi,61,1290,950,340,35.78947368421053,morphological_dilation,3,2
0X12B890B1E2E14CC4.avi,1,3394,2838,556,19.59126145172657,morphological_dilation,3,2
0X12B890B1E2E14CC4.avi,17,2097,1627,470,28.887523048555625,morphological_dilation,3,2
0X12B9FFDEA456E877.avi,46,1546,1182,364,30.79526226734349,morphological_dilation,3,2
0X12B9FFDEA456E877.avi,63,988,696,292,41.95402298850575,morphological_dilation,3,2
0X12BAD5FBFC3E4F2A.avi,97,1729,1349,380,28.169014084507044,morphological_dilation,3,2
0X12BAD5FBFC3E4F2A.avi,114,1124,820,304,37.073170731707314,morphological_dilation,3,2
0X12C17194EECA74B4.avi,31,2106,1686,420,24.91103202846975,morphological_dilation,3,2
0X12C17194EECA74B4.avi,43,1373,1038,335,32.273603082851636,morphological_dilation,3,2
0X12C75A801CBD284A.avi,67,2012,1600,412,25.75,morphological_dilation,3,2
0X12C75A801CBD284A.avi,78,1357,1009,348,34.489593657086225,morphological_dilation,3,2
0X12CC84ACC62427C1.avi,37,2328,1877,451,24.02770378263186,morphological_dilation,3,2
0X12CC84ACC62427C1.avi,49,1474,1105,369,33.393665158371036,morphological_dilation,3,2
0X12CF33089E2618A8.avi,31,1274,938,336,35.82089552238806,morphological_dilation,3,2
0X12CF33089E2618A8.avi,63,846,582,264,45.36082474226804,morphological_dilation,3,2
0X12D510DA18959EE3.avi,67,1341,1005,336,33.43283582089553,morphological_dilation,3,2
0X12D510DA18959EE3.avi,80,936,640,296,46.25,morphological_dilation,3,2
0X12D56DAF10A98037.avi,37,1411,1059,352,33.23890462700661,morphological_dilation,3,2
0X12D56DAF10A98037.avi,55,840,563,277,49.200710479573715,morphological_dilation,3,2
0X12D7CFBEBDF0EAAF.avi,38,1328,998,330,33.06613226452906,morphological_dilation,3,2
0X12D7CFBEBDF0EAAF.avi,53,831,563,268,47.60213143872114,morphological_dilation,3,2
0X12DAF7D942F818A0.avi,102,2409,1969,440,22.3463687150838,morphological_dilation,3,2
0X12DAF7D942F818A0.avi,123,1502,1154,348,30.155979202772965,morphological_dilation,3,2
0X12DC39D816351E0D.avi,57,1527,1163,364,31.29836629406707,morphological_dilation,3,2
0X12DC39D816351E0D.avi,66,1132,808,324,40.099009900990104,morphological_dilation,3,2
0X12F2890C7AEA52E8.avi,23,1517,1161,356,30.663221360895783,morphological_dilation,3,2
0X12F2890C7AEA52E8.avi,39,1131,819,312,38.095238095238095,morphological_dilation,3,2
0X12F3277B0A6EE866.avi,154,999,719,280,38.94297635605007,morphological_dilation,3,2
0X12F3277B0A6EE866.avi,172,597,373,224,60.05361930294906,morphological_dilation,3,2
0X12F3CF2F58EC699B.avi,133,1612,1229,383,31.163547599674533,morphological_dilation,3,2
0X12F3CF2F58EC699B.avi,147,1024,708,316,44.632768361581924,morphological_dilation,3,2
0X12F535C804FC3F13.avi,141,1511,1155,356,30.822510822510825,morphological_dilation,3,2
0X12F535C804FC3F13.avi,155,945,621,324,52.17391304347826,morphological_dilation,3,2
0X13031FC2687E954D.avi,3,3140,2616,524,20.03058103975535,morphological_dilation,3,2
0X13031FC2687E954D.avi,25,1835,1423,412,28.952916373858045,morphological_dilation,3,2
0X1303B567B01D9D71.avi,107,1485,1125,360,32.0,morphological_dilation,3,2
0X1303B567B01D9D71.avi,120,932,636,296,46.540880503144656,morphological_dilation,3,2
0X13078849A6B5C581.avi,0,1772,1392,380,27.298850574712645,morphological_dilation,3,2
0X13078849A6B5C581.avi,20,1131,835,296,35.449101796407184,morphological_dilation,3,2
0X130914FFD198255E.avi,120,2091,1675,416,24.83582089552239,morphological_dilation,3,2
0X130914FFD198255E.avi,139,1273,941,332,35.28161530286929,morphological_dilation,3,2
0X130ABC17C55FD6B5.avi,46,2055,1623,432,26.617375231053604,morphological_dilation,3,2
0X130ABC17C55FD6B5.avi,59,1316,957,359,37.51306165099268,morphological_dilation,3,2
0X130B57359B0E6F00.avi,157,1765,1373,392,28.55061908230153,morphological_dilation,3,2
0X130B57359B0E6F00.avi,173,1088,772,316,40.932642487046635,morphological_dilation,3,2
0X130E96B8AB4EC4DF.avi,3,1658,1284,374,29.12772585669782,morphological_dilation,3,2
0X130E96B8AB4EC4DF.avi,21,935,647,288,44.513137557959816,morphological_dilation,3,2
0X131AEF344C28F4B2.avi,122,1644,1284,360,28.037383177570092,morphological_dilation,3,2
0X131AEF344C28F4B2.avi,143,1023,723,300,41.49377593360996,morphological_dilation,3,2
0X131EE16CE9512E4E.avi,85,1245,921,324,35.17915309446254,morphological_dilation,3,2
0X131EE16CE9512E4E.avi,131,2023,1615,408,25.263157894736842,morphological_dilation,3,2
0X132A335840604190.avi,44,2177,1741,436,25.04307869040781,morphological_dilation,3,2
0X132A335840604190.avi,63,1363,996,367,36.847389558232926,morphological_dilation,3,2
0X132C1E8DBB715D1D.avi,44,1035,751,284,37.81624500665779,morphological_dilation,3,2
0X132C1E8DBB715D1D.avi,55,676,424,252,59.43396226415094,morphological_dilation,3,2
0X132E461F48559F6B.avi,72,1886,1482,404,27.26045883940621,morphological_dilation,3,2
0X132E461F48559F6B.avi,89,1050,740,310,41.891891891891895,morphological_dilation,3,2
0X1335F88662E38FD5.avi,97,3300,2777,523,18.83327331652863,morphological_dilation,3,2
0X1335F88662E38FD5.avi,113,2141,1705,436,25.57184750733138,morphological_dilation,3,2
0X1337E8945A141439.avi,73,2407,1951,456,23.37262942080984,morphological_dilation,3,2
0X1337E8945A141439.avi,87,1737,1337,400,29.917726252804787,morphological_dilation,3,2
0X13381981E598316E.avi,116,2437,1989,448,22.52388134741076,morphological_dilation,3,2
0X13381981E598316E.avi,132,1478,1110,368,33.153153153153156,morphological_dilation,3,2
0X1339B9E81946F0E8.avi,61,1485,1141,344,30.14899211218229,morphological_dilation,3,2
0X1339B9E81946F0E8.avi,82,883,619,264,42.64943457189014,morphological_dilation,3,2
0X133BD3C195F9EA2.avi,46,2584,2132,452,21.200750469043154,morphological_dilation,3,2
0X133BD3C195F9EA2.avi,65,1610,1246,364,29.213483146067414,morphological_dilation,3,2
0X133C22A8F4C643C.avi,129,1861,1465,396,27.030716723549485,morphological_dilation,3,2
0X133C22A8F4C643C.avi,141,1495,1139,356,31.255487269534683,morphological_dilation,3,2
0X133F1774D5859CF4.avi,134,1201,877,324,36.94412770809578,morphological_dilation,3,2
0X133F1774D5859CF4.avi,150,714,424,290,68.39622641509435,morphological_dilation,3,2
0X133F50BB99C6E09.avi,42,1567,1179,388,32.90924512298558,morphological_dilation,3,2
0X133F50BB99C6E09.avi,55,1043,711,332,46.69479606188467,morphological_dilation,3,2
0X13408BBC062D7EF8.avi,79,2412,1960,452,23.06122448979592,morphological_dilation,3,2
0X13408BBC062D7EF8.avi,85,1512,1124,388,34.519572953736656,morphological_dilation,3,2
0X13419AC126FD7685.avi,32,2385,1929,456,23.63919129082426,morphological_dilation,3,2
0X13419AC126FD7685.avi,50,1390,1034,356,34.4294003868472,morphological_dilation,3,2
0X1345D6698FB8834D.avi,65,4073,3469,604,17.411357739982705,morphological_dilation,3,2
0X1345D6698FB8834D.avi,86,2690,2190,500,22.831050228310502,morphological_dilation,3,2
0X13491A03D3184C5A.avi,57,2224,1808,416,23.008849557522122,morphological_dilation,3,2
0X13491A03D3184C5A.avi,75,1683,1327,356,26.827430293896004,morphological_dilation,3,2
0X134A337D9B4C1948.avi,45,1942,1558,384,24.646983311938385,morphological_dilation,3,2
0X134A337D9B4C1948.avi,57,1658,1302,356,27.342549923195087,morphological_dilation,3,2
0X134CE85850028C74.avi,92,2107,1679,428,25.49136390708755,morphological_dilation,3,2
0X134CE85850028C74.avi,110,1250,906,344,37.969094922737305,morphological_dilation,3,2
0X1351FD090B93589F.avi,29,1482,1126,356,31.616341030195382,morphological_dilation,3,2
0X1351FD090B93589F.avi,45,938,646,292,45.20123839009288,morphological_dilation,3,2
0X135A31260870D960.avi,144,1697,1321,376,28.463285389856168,morphological_dilation,3,2
0X135A31260870D960.avi,162,997,693,304,43.867243867243864,morphological_dilation,3,2
0X135AADB11C76E482.avi,86,1909,1517,392,25.84047462096243,morphological_dilation,3,2
0X135AADB11C76E482.avi,99,1086,774,312,40.310077519379846,morphological_dilation,3,2
0X13621A689D1114C3.avi,65,1913,1517,396,26.104152933421226,morphological_dilation,3,2
0X13621A689D1114C3.avi,81,1132,824,308,37.37864077669903,morphological_dilation,3,2
0X1364306109381555.avi,57,1960,1556,404,25.96401028277635,morphological_dilation,3,2
0X1364306109381555.avi,78,1779,1383,396,28.633405639913235,morphological_dilation,3,2
0X136492E67BFF8CB3.avi,95,4503,3891,612,15.728604471858135,morphological_dilation,3,2
0X136492E67BFF8CB3.avi,112,2778,2239,539,24.073246985261278,morphological_dilation,3,2
0X136601DC3725F327.avi,95,1517,1137,380,33.42128408091469,morphological_dilation,3,2
0X136601DC3725F327.avi,112,988,648,340,52.46913580246913,morphological_dilation,3,2
0X1366FB9F3F37807D.avi,103,1544,1196,348,29.09698996655518,morphological_dilation,3,2
0X1366FB9F3F37807D.avi,114,1036,752,284,37.765957446808514,morphological_dilation,3,2
0X13682394806BB587.avi,40,2784,2300,484,21.043478260869566,morphological_dilation,3,2
0X13682394806BB587.avi,55,1794,1378,416,30.18867924528302,morphological_dilation,3,2
0X1369E49954F0EAEC.avi,46,1941,1541,400,25.957170668397143,morphological_dilation,3,2
0X1369E49954F0EAEC.avi,62,1329,977,352,36.02865916069601,morphological_dilation,3,2
0X13745EE94756A394.avi,97,1744,1344,400,29.761904761904763,morphological_dilation,3,2
0X13745EE94756A394.avi,113,1109,773,336,43.46701164294955,morphological_dilation,3,2
0X13881965FA7312E.avi,93,1045,757,288,38.0449141347424,morphological_dilation,3,2
0X13881965FA7312E.avi,105,729,453,276,60.9271523178808,morphological_dilation,3,2
0X13888ED03221D0D4.avi,126,1513,1165,348,29.871244635193133,morphological_dilation,3,2
0X13888ED03221D0D4.avi,139,1015,715,300,41.95804195804196,morphological_dilation,3,2
0X138BF0FABD298C5.avi,175,2196,1792,404,22.544642857142858,morphological_dilation,3,2
0X138BF0FABD298C5.avi,194,1450,1114,336,30.16157989228007,morphological_dilation,3,2
0X1390B905E366F035.avi,35,1438,1078,360,33.39517625231911,morphological_dilation,3,2
0X1390B905E366F035.avi,50,1047,727,320,44.01650618982118,morphological_dilation,3,2
0X139DEEAD6326D6C5.avi,47,1738,1359,379,27.888153053715968,morphological_dilation,3,2
0X139DEEAD6326D6C5.avi,62,1065,761,304,39.94743758212878,morphological_dilation,3,2
0X13A3E602CCA508D6.avi,127,1516,1164,352,30.240549828178693,morphological_dilation,3,2
0X13A3E602CCA508D6.avi,151,994,714,280,39.21568627450981,morphological_dilation,3,2
0X13A4AE3152A4D752.avi,64,2058,1648,410,24.87864077669903,morphological_dilation,3,2
0X13A4AE3152A4D752.avi,76,1484,1102,382,34.66424682395644,morphological_dilation,3,2
0X13A5B3EF1C1004FC.avi,38,3917,3321,596,17.946401686239085,morphological_dilation,3,2
0X13A5B3EF1C1004FC.avi,53,2199,1711,488,28.52133255406195,morphological_dilation,3,2
0X13A5F88444B588E0.avi,37,743,483,260,53.83022774327122,morphological_dilation,3,2
0X13A5F88444B588E0.avi,49,551,323,228,70.58823529411765,morphological_dilation,3,2
0X13ACF1360A23F50F.avi,40,2045,1657,388,23.415811707905853,morphological_dilation,3,2
0X13ACF1360A23F50F.avi,56,1214,902,312,34.58980044345898,morphological_dilation,3,2
0X13AF8C4530219270.avi,2,2582,2118,464,21.907459867799812,morphological_dilation,3,2
0X13AF8C4530219270.avi,19,1618,1231,387,31.437855402112103,morphological_dilation,3,2
0X13B0A1DABEDA5EDF.avi,60,1970,1479,491,33.19810682893847,morphological_dilation,3,2
0X13B0A1DABEDA5EDF.avi,73,1176,755,421,55.76158940397351,morphological_dilation,3,2
0X13B4430D1930FF80.avi,49,1939,1547,392,25.339366515837103,morphological_dilation,3,2
0X13B4430D1930FF80.avi,65,1235,911,324,35.56531284302964,morphological_dilation,3,2
0X13B5EC7F42AF217.avi,119,1653,1277,376,29.444009397024274,morphological_dilation,3,2
0X13B5EC7F42AF217.avi,131,1078,758,320,42.21635883905013,morphological_dilation,3,2
0X13B783ADFB252C8.avi,62,670,398,272,68.34170854271356,morphological_dilation,3,2
0X13B783ADFB252C8.avi,81,1060,748,312,41.711229946524064,morphological_dilation,3,2
0X13B8F91C9C8074AF.avi,0,1566,1218,348,28.57142857142857,morphological_dilation,3,2
0X13B8F91C9C8074AF.avi,19,1078,774,304,39.276485788113696,morphological_dilation,3,2
0X13B98D39BC103032.avi,68,1946,1512,434,28.703703703703702,morphological_dilation,3,2
0X13B98D39BC103032.avi,83,1153,797,356,44.66750313676286,morphological_dilation,3,2
0X13BD3AC66BD12220.avi,37,1605,1261,344,27.279936558287073,morphological_dilation,3,2
0X13BD3AC66BD12220.avi,53,1000,720,280,38.88888888888889,morphological_dilation,3,2
0X13BF1C6E527440F.avi,58,2034,1634,400,24.479804161566708,morphological_dilation,3,2
0X13BF1C6E527440F.avi,72,1310,986,324,32.86004056795132,morphological_dilation,3,2
0X13BF81440466675F.avi,96,1940,1528,412,26.96335078534031,morphological_dilation,3,2
0X13BF81440466675F.avi,113,1227,895,332,37.09497206703911,morphological_dilation,3,2
0X13C061D2FD255419.avi,48,2951,2463,488,19.813235891189606,morphological_dilation,3,2
0X13C061D2FD255419.avi,65,2313,1861,452,24.288017195056423,morphological_dilation,3,2
0X13C1FEB745C8B810.avi,0,3325,2773,552,19.90623873061666,morphological_dilation,3,2
0X13C1FEB745C8B810.avi,21,1552,1151,401,34.83927019982624,morphological_dilation,3,2
0X13C378D617ABCBEF.avi,35,1413,1073,340,31.68685927306617,morphological_dilation,3,2
0X13C378D617ABCBEF.avi,53,918,634,284,44.79495268138801,morphological_dilation,3,2
0X13C611744D86E729.avi,51,2238,1774,464,26.155580608793688,morphological_dilation,3,2
0X13C611744D86E729.avi,66,1677,1253,424,33.83878691141261,morphological_dilation,3,2
0X13C7281794656150.avi,52,2187,1771,416,23.489553924336533,morphological_dilation,3,2
0X13C7281794656150.avi,70,1209,897,312,34.78260869565217,morphological_dilation,3,2
0X13CAF66BDD4EBEA0.avi,87,1217,894,323,36.12975391498882,morphological_dilation,3,2
0X13CAF66BDD4EBEA0.avi,101,919,590,329,55.762711864406775,morphological_dilation,3,2
0X13CE2039E2D706A.avi,56,2445,2021,424,20.979713013359724,morphological_dilation,3,2
0X13CE2039E2D706A.avi,76,2129,1729,400,23.13475997686524,morphological_dilation,3,2
0X13CE28139B5F8E2D.avi,53,2091,1675,416,24.83582089552239,morphological_dilation,3,2
0X13CE28139B5F8E2D.avi,71,1386,1026,360,35.08771929824561,morphological_dilation,3,2
0X13CF32153B3B30B7.avi,101,2035,1619,416,25.694873378628785,morphological_dilation,3,2
0X13CF32153B3B30B7.avi,115,1318,974,344,35.318275154004105,morphological_dilation,3,2
0X13CFD73EA4694798.avi,41,3519,3007,512,17.026937146657797,morphological_dilation,3,2
0X13CFD73EA4694798.avi,59,3197,2709,488,18.014027316352898,morphological_dilation,3,2
0X13D0DD096DFED1C7.avi,51,1432,1072,360,33.582089552238806,morphological_dilation,3,2
0X13D0DD096DFED1C7.avi,69,950,650,300,46.15384615384615,morphological_dilation,3,2
0X13D1459C51B5C32E.avi,25,1101,809,292,36.093943139678615,morphological_dilation,3,2
0X13D1459C51B5C32E.avi,43,1338,1004,334,33.266932270916335,morphological_dilation,3,2
0X13D6BC74D088CACA.avi,70,2282,1850,432,23.35135135135135,morphological_dilation,3,2
0X13D6BC74D088CACA.avi,80,1505,1129,376,33.30380868024801,morphological_dilation,3,2
0X13D875B7A4A97001.avi,0,2431,1969,462,23.463687150837988,morphological_dilation,3,2
0X13D875B7A4A97001.avi,21,1524,1152,372,32.29166666666667,morphological_dilation,3,2
0X13D9B0A4BC16701D.avi,70,1152,828,324,39.130434782608695,morphological_dilation,3,2
0X13D9B0A4BC16701D.avi,84,699,451,248,54.988913525498894,morphological_dilation,3,2
0X13DEAEAFDF1338AD.avi,111,1126,818,308,37.65281173594132,morphological_dilation,3,2
0X13DEAEAFDF1338AD.avi,122,764,504,260,51.587301587301596,morphological_dilation,3,2
0X13E043A35E3EB490.avi,80,1503,1159,344,29.68075927523727,morphological_dilation,3,2
0X13E043A35E3EB490.avi,97,994,703,291,41.39402560455192,morphological_dilation,3,2
0X13E260DF39629AC9.avi,143,1646,1278,368,28.794992175273865,morphological_dilation,3,2
0X13E260DF39629AC9.avi,161,1232,896,336,37.5,morphological_dilation,3,2
0X13E488CF5C7C934C.avi,23,1450,1102,348,31.57894736842105,morphological_dilation,3,2
0X13E488CF5C7C934C.avi,35,961,644,317,49.22360248447205,morphological_dilation,3,2
0X13E9B31F9C5D5660.avi,129,2083,1659,424,25.557564798071127,morphological_dilation,3,2
0X13E9B31F9C5D5660.avi,146,1313,981,332,33.84301732925586,morphological_dilation,3,2
0X13EA5DE4962B3822.avi,162,3890,3310,580,17.522658610271904,morphological_dilation,3,2
0X13EA5DE4962B3822.avi,198,2497,2017,480,23.797719385225584,morphological_dilation,3,2
0X13ECF4B877219D8B.avi,1,1629,1245,384,30.843373493975907,morphological_dilation,3,2
0X13ECF4B877219D8B.avi,16,986,674,312,46.29080118694362,morphological_dilation,3,2
0X13EFD6BF683801F.avi,91,1246,946,300,31.712473572938688,morphological_dilation,3,2
0X13EFD6BF683801F.avi,106,971,707,264,37.34087694483734,morphological_dilation,3,2
0X13F04450E6B7D249.avi,39,2576,2124,452,21.28060263653484,morphological_dilation,3,2
0X13F04450E6B7D249.avi,56,1716,1332,384,28.82882882882883,morphological_dilation,3,2
0X13F0F314138CE831.avi,150,999,696,303,43.53448275862069,morphological_dilation,3,2
0X13F0F314138CE831.avi,168,703,441,262,59.410430839002274,morphological_dilation,3,2
0X13F52A775D9F62D0.avi,66,2018,1587,431,27.15816005040958,morphological_dilation,3,2
0X13F52A775D9F62D0.avi,79,1516,1116,400,35.842293906810035,morphological_dilation,3,2
0X13F7CAB4C719ACA3.avi,6,1520,1176,344,29.25170068027211,morphological_dilation,3,2
0X13F7CAB4C719ACA3.avi,17,1135,823,312,37.91008505467801,morphological_dilation,3,2
0X14017B26554F7A5E.avi,101,1714,1326,388,29.260935143288087,morphological_dilation,3,2
0X14017B26554F7A5E.avi,116,940,652,288,44.171779141104295,morphological_dilation,3,2
0X140A0F27BE9116F5.avi,74,1786,1399,387,27.662616154395998,morphological_dilation,3,2
0X140A0F27BE9116F5.avi,91,1308,952,356,37.39495798319328,morphological_dilation,3,2
0X140AAFB14918E8A4.avi,38,2278,1806,472,26.135105204872644,morphological_dilation,3,2
0X140AAFB14918E8A4.avi,47,1362,935,427,45.66844919786096,morphological_dilation,3,2
0X140D4A2F475712FA.avi,49,1938,1542,396,25.680933852140075,morphological_dilation,3,2
0X140D4A2F475712FA.avi,66,1225,897,328,36.56633221850613,morphological_dilation,3,2
0X141103C96A34DA6C.avi,212,3293,2765,528,19.095840867992766,morphological_dilation,3,2
0X141103C96A34DA6C.avi,237,2128,1701,427,25.102880658436217,morphological_dilation,3,2
0X1412F3A856C40C82.avi,28,1839,1451,388,26.740179186767747,morphological_dilation,3,2
0X1412F3A856C40C82.avi,39,1074,758,316,41.68865435356201,morphological_dilation,3,2
0X141E714781DEE463.avi,35,3352,2828,524,18.528995756718526,morphological_dilation,3,2
0X141E714781DEE463.avi,48,2313,1881,432,22.966507177033492,morphological_dilation,3,2
0X142C9C144BF16FAE.avi,123,1869,1489,380,25.52048354600403,morphological_dilation,3,2
0X142C9C144BF16FAE.avi,142,1212,896,316,35.267857142857146,morphological_dilation,3,2
0X142CA9754A01C189.avi,95,1617,1245,372,29.87951807228916,morphological_dilation,3,2
0X142CA9754A01C189.avi,111,1128,812,316,38.91625615763547,morphological_dilation,3,2
0X142D95A439C28FD0.avi,114,1370,1006,364,36.18290258449304,morphological_dilation,3,2
0X142D95A439C28FD0.avi,127,879,579,300,51.813471502590666,morphological_dilation,3,2
0X142EFADA9AF9DC99.avi,157,1861,1473,388,26.3408010862186,morphological_dilation,3,2
0X142EFADA9AF9DC99.avi,177,1167,859,308,35.85564610011641,morphological_dilation,3,2
0X1430480BD524AA15.avi,114,1261,953,308,32.3189926547744,morphological_dilation,3,2
0X1430480BD524AA15.avi,148,759,507,252,49.70414201183432,morphological_dilation,3,2
0X143952B6F3131E88.avi,28,1213,869,344,39.58573072497123,morphological_dilation,3,2
0X143952B6F3131E88.avi,41,752,429,323,75.29137529137529,morphological_dilation,3,2
0X1439627ADB475793.avi,136,2696,2240,456,20.357142857142858,morphological_dilation,3,2
0X1439627ADB475793.avi,152,1609,1229,380,30.919446704637917,morphological_dilation,3,2
0X143B72A804BC7AE7.avi,40,1239,899,340,37.81979977753059,morphological_dilation,3,2
0X143B72A804BC7AE7.avi,57,761,489,272,55.623721881390594,morphological_dilation,3,2
0X143D9B52A85BF561.avi,91,2076,1649,427,25.894481503941787,morphological_dilation,3,2
0X143D9B52A85BF561.avi,111,1373,996,377,37.851405622489956,morphological_dilation,3,2
0X143DC0C8FB089A18.avi,0,3043,2511,532,21.186778176025488,morphological_dilation,3,2
0X143DC0C8FB089A18.avi,19,2590,2088,502,24.042145593869733,morphological_dilation,3,2
0X1441AEEF1315F95F.avi,3,1793,1398,395,28.25464949928469,morphological_dilation,3,2
0X1441AEEF1315F95F.avi,22,1014,706,308,43.626062322946176,morphological_dilation,3,2
0X1444E316F0AD1ECD.avi,114,2531,2071,460,22.21149203283438,morphological_dilation,3,2
0X1444E316F0AD1ECD.avi,132,1691,1291,400,30.983733539891556,morphological_dilation,3,2
0X14458B9410D73E11.avi,2,1563,1199,364,30.35863219349458,morphological_dilation,3,2
0X14458B9410D73E11.avi,17,988,692,296,42.77456647398844,morphological_dilation,3,2
0X144DF7C585233D4C.avi,51,2347,1904,443,23.266806722689076,morphological_dilation,3,2
0X144DF7C585233D4C.avi,66,1599,1199,400,33.361134278565466,morphological_dilation,3,2
0X1453F1CB3615D8E6.avi,46,2368,1916,452,23.59081419624217,morphological_dilation,3,2
0X1453F1CB3615D8E6.avi,60,1579,1199,380,31.693077564637196,morphological_dilation,3,2
0X14586BA47B83C598.avi,86,2268,1832,436,23.799126637554586,morphological_dilation,3,2
0X14586BA47B83C598.avi,106,1352,1004,348,34.66135458167331,morphological_dilation,3,2
0X145985C5A34EFCC.avi,124,1710,1330,380,28.57142857142857,morphological_dilation,3,2
0X145985C5A34EFCC.avi,141,1008,708,300,42.3728813559322,morphological_dilation,3,2
0X1459E82A63876D49.avi,122,2901,2401,500,20.824656393169512,morphological_dilation,3,2
0X1459E82A63876D49.avi,140,1718,1315,403,30.646387832699617,morphological_dilation,3,2
0X146617301504663D.avi,165,1552,1204,348,28.903654485049834,morphological_dilation,3,2
0X146617301504663D.avi,188,929,645,284,44.031007751937985,morphological_dilation,3,2
0X1469FC68080F968F.avi,39,1734,1342,392,29.210134128166914,morphological_dilation,3,2
0X1469FC68080F968F.avi,53,988,632,356,56.32911392405063,morphological_dilation,3,2
0X146DFEE92CCEC4E2.avi,86,1727,1339,388,28.976848394324122,morphological_dilation,3,2
0X146DFEE92CCEC4E2.avi,100,1038,730,308,42.19178082191781,morphological_dilation,3,2
0X146FA81A1880E0DB.avi,39,2072,1665,407,24.444444444444443,morphological_dilation,3,2
0X146FA81A1880E0DB.avi,56,1243,882,361,40.929705215419496,morphological_dilation,3,2
0X148536C2B06F8C88.avi,3,1519,1139,380,33.362598770851626,morphological_dilation,3,2
0X148536C2B06F8C88.avi,20,1002,690,312,45.21739130434783,morphological_dilation,3,2
0X148B59B7E2DE8071.avi,131,3354,2822,532,18.851878100637844,morphological_dilation,3,2
0X148B59B7E2DE8071.avi,150,2041,1601,440,27.482823235477827,morphological_dilation,3,2
0X148BFBF596042FF5.avi,196,1136,836,300,35.88516746411483,morphological_dilation,3,2
0X148BFBF596042FF5.avi,214,759,493,266,53.9553752535497,morphological_dilation,3,2
0X148FD32A15B26865.avi,105,2406,1954,452,23.132036847492323,morphological_dilation,3,2
0X148FD32A15B26865.avi,122,1717,1325,392,29.58490566037736,morphological_dilation,3,2
0X148FFCBF4D0C398F.avi,128,2062,1650,412,24.96969696969697,morphological_dilation,3,2
0X148FFCBF4D0C398F.avi,150,1208,884,324,36.65158371040724,morphological_dilation,3,2
0X1494CF8E521C3FEF.avi,92,1948,1534,414,26.988265971316817,morphological_dilation,3,2
0X1494CF8E521C3FEF.avi,107,1570,1195,375,31.380753138075313,morphological_dilation,3,2
0X1498806542CEE367.avi,15,1683,1295,388,29.961389961389962,morphological_dilation,3,2
0X1498806542CEE367.avi,27,1203,879,324,36.86006825938566,morphological_dilation,3,2
0X1499CC196E57EFB.avi,136,1657,1281,376,29.352068696330992,morphological_dilation,3,2
0X1499CC196E57EFB.avi,152,1016,716,300,41.899441340782126,morphological_dilation,3,2
0X149C551B9CC4DED.avi,116,1308,980,328,33.46938775510204,morphological_dilation,3,2
0X149C551B9CC4DED.avi,127,758,505,253,50.0990099009901,morphological_dilation,3,2
0X149CE42387608CEC.avi,106,1340,1006,334,33.20079522862823,morphological_dilation,3,2
0X149CE42387608CEC.avi,121,933,613,320,52.20228384991843,morphological_dilation,3,2
0X149D7652015AA236.avi,78,1545,1185,360,30.37974683544304,morphological_dilation,3,2
0X149D7652015AA236.avi,93,1008,700,308,44.0,morphological_dilation,3,2
0X149DCE7F77B408F4.avi,54,1337,989,348,35.18705763397371,morphological_dilation,3,2
0X149DCE7F77B408F4.avi,72,845,569,276,48.50615114235501,morphological_dilation,3,2
0X14A6F87817547A95.avi,36,1736,1364,372,27.27272727272727,morphological_dilation,3,2
0X14A6F87817547A95.avi,49,961,669,292,43.64723467862481,morphological_dilation,3,2
0X14A943AC8D162D36.avi,82,3092,2572,520,20.21772939346812,morphological_dilation,3,2
0X14A943AC8D162D36.avi,100,1987,1559,428,27.453495830660678,morphological_dilation,3,2
0X14A96DC7D16968CA.avi,41,1905,1513,392,25.908790482485127,morphological_dilation,3,2
0X14A96DC7D16968CA.avi,55,1123,798,325,40.72681704260652,morphological_dilation,3,2
0X14AD611ACCAD1161.avi,33,1689,1321,368,27.857683573050718,morphological_dilation,3,2
0X14AD611ACCAD1161.avi,48,1038,738,300,40.65040650406504,morphological_dilation,3,2
0X14AE436F61819521.avi,33,2029,1617,412,25.479282622139763,morphological_dilation,3,2
0X14AE436F61819521.avi,49,1403,1063,340,31.984948259642522,morphological_dilation,3,2
0X14B62F1593336331.avi,105,1236,904,332,36.72566371681416,morphological_dilation,3,2
0X14B62F1593336331.avi,124,773,502,271,53.98406374501992,morphological_dilation,3,2
0X14B9AD04DC394090.avi,118,2217,1801,416,23.098278734036644,morphological_dilation,3,2
0X14B9AD04DC394090.avi,143,1422,1070,352,32.89719626168225,morphological_dilation,3,2
0X14BF7A33B6A3FAC4.avi,27,1086,782,304,38.87468030690537,morphological_dilation,3,2
0X14BF7A33B6A3FAC4.avi,40,715,459,256,55.773420479302835,morphological_dilation,3,2
0X14BFDFE46468D601.avi,157,1954,1554,400,25.74002574002574,morphological_dilation,3,2
0X14BFDFE46468D601.avi,175,1403,1063,340,31.984948259642522,morphological_dilation,3,2
0X14C05BE120AEAFA3.avi,47,1712,1340,372,27.761194029850746,morphological_dilation,3,2
0X14C05BE120AEAFA3.avi,66,944,652,292,44.785276073619634,morphological_dilation,3,2
0X14C5B3A3DFECAC76.avi,109,2028,1621,407,25.10795805058606,morphological_dilation,3,2
0X14C5B3A3DFECAC76.avi,127,1290,950,340,35.78947368421053,morphological_dilation,3,2
0X14C8F7E6EBDBC708.avi,104,1994,1590,404,25.40880503144654,morphological_dilation,3,2
0X14C8F7E6EBDBC708.avi,123,1050,746,304,40.75067024128686,morphological_dilation,3,2
0X14C8FE5C30084CB3.avi,106,1451,1107,344,31.07497741644083,morphological_dilation,3,2
0X14C8FE5C30084CB3.avi,122,887,603,284,47.09784411276949,morphological_dilation,3,2
0X14C9558E01709E65.avi,49,2431,1987,444,22.34524408656266,morphological_dilation,3,2
0X14C9558E01709E65.avi,64,1490,1142,348,30.472854640980735,morphological_dilation,3,2
0X14CA2B7814B1B9EF.avi,81,1587,1191,396,33.249370277078086,morphological_dilation,3,2
0X14CA2B7814B1B9EF.avi,97,1037,709,328,46.262341325811,morphological_dilation,3,2
0X14CDF03D85703540.avi,138,3790,3248,542,16.6871921182266,morphological_dilation,3,2
0X14CDF03D85703540.avi,176,2455,1987,468,23.553095118268747,morphological_dilation,3,2
0X14CFCEAD6539D3DC.avi,111,1916,1508,408,27.055702917771885,morphological_dilation,3,2
0X14CFCEAD6539D3DC.avi,125,1169,837,332,39.66547192353644,morphological_dilation,3,2
0X14D50036EAB69EA.avi,71,1642,1274,368,28.885400313971743,morphological_dilation,3,2
0X14D50036EAB69EA.avi,82,1096,784,312,39.795918367346935,morphological_dilation,3,2
0X14D6CCAC550E278B.avi,134,982,682,300,43.988269794721404,morphological_dilation,3,2
0X14D6CCAC550E278B.avi,151,552,332,220,66.26506024096386,morphological_dilation,3,2
0X14DDD7911ED612B8.avi,180,1238,922,316,34.273318872017356,morphological_dilation,3,2
0X14DDD7911ED612B8.avi,197,847,567,280,49.382716049382715,morphological_dilation,3,2
0X14E954E2A0878925.avi,30,1554,1210,344,28.429752066115704,morphological_dilation,3,2
0X14E954E2A0878925.avi,43,1202,894,308,34.45190156599553,morphological_dilation,3,2
0X14E98112C64DA88B.avi,100,2644,2192,452,20.62043795620438,morphological_dilation,3,2
0X14E98112C64DA88B.avi,118,2225,1798,427,23.74860956618465,morphological_dilation,3,2
0X14EAF6EAE837F32D.avi,84,918,634,284,44.79495268138801,morphological_dilation,3,2
0X14EAF6EAE837F32D.avi,94,580,356,224,62.92134831460674,morphological_dilation,3,2
0X14F0C15097590562.avi,52,1367,1007,360,35.749751737835155,morphological_dilation,3,2
0X14F0C15097590562.avi,71,867,579,288,49.740932642487046,morphological_dilation,3,2
0X14F4B815A5210B8A.avi,39,1343,970,373,38.453608247422686,morphological_dilation,3,2
0X14F4B815A5210B8A.avi,54,806,499,307,61.523046092184366,morphological_dilation,3,2
0X14F639B3E0EC3A72.avi,64,1827,1447,380,26.261230131306153,morphological_dilation,3,2
0X14F639B3E0EC3A72.avi,83,1102,806,296,36.72456575682382,morphological_dilation,3,2
0X14F7F25545E76A73.avi,46,1613,1257,356,28.32140015910899,morphological_dilation,3,2
0X14F7F25545E76A73.avi,65,1040,748,292,39.037433155080215,morphological_dilation,3,2
0X14FC5096F3E4145D.avi,49,1974,1566,408,26.053639846743295,morphological_dilation,3,2
0X14FC5096F3E4145D.avi,67,1163,859,304,35.389988358556465,morphological_dilation,3,2
0X14FC7EEB6ACFE0BF.avi,46,1893,1497,396,26.452905811623246,morphological_dilation,3,2
0X14FC7EEB6ACFE0BF.avi,69,1354,1006,348,34.59244532803181,morphological_dilation,3,2
0X1502E38D5D99E2E4.avi,51,1005,705,300,42.5531914893617,morphological_dilation,3,2
0X1502E38D5D99E2E4.avi,68,734,478,256,53.55648535564853,morphological_dilation,3,2
0X15031D084B3EEC96.avi,69,1040,760,280,36.84210526315789,morphological_dilation,3,2
0X15031D084B3EEC96.avi,83,615,386,229,59.32642487046632,morphological_dilation,3,2
0X150D2E5A2E09ADC.avi,1,1461,1141,320,28.045574057843996,morphological_dilation,3,2
0X150D2E5A2E09ADC.avi,12,1202,906,296,32.671081677704194,morphological_dilation,3,2
0X1512DC6CBD8EA12A.avi,44,1414,1062,352,33.14500941619586,morphological_dilation,3,2
0X1512DC6CBD8EA12A.avi,56,1254,914,340,37.199124726477024,morphological_dilation,3,2
0X15146FB55B5697A0.avi,69,2500,2028,472,23.274161735700197,morphological_dilation,3,2
0X15146FB55B5697A0.avi,88,1779,1371,408,29.75929978118162,morphological_dilation,3,2
0X15213080EC9FA05.avi,53,1374,1050,324,30.857142857142854,morphological_dilation,3,2
0X15213080EC9FA05.avi,70,927,643,284,44.16796267496112,morphological_dilation,3,2
0X15260A2D31648922.avi,47,2049,1637,412,25.167990226023214,morphological_dilation,3,2
0X15260A2D31648922.avi,64,1336,992,344,34.67741935483871,morphological_dilation,3,2
0X152F36A552DD2930.avi,106,1368,1040,328,31.538461538461537,morphological_dilation,3,2
0X152F36A552DD2930.avi,119,867,595,272,45.714285714285715,morphological_dilation,3,2
0X152F4B797A15C43F.avi,85,3131,2623,508,19.36713686618376,morphological_dilation,3,2
0X152F4B797A15C43F.avi,99,2564,2092,472,22.562141491395792,morphological_dilation,3,2
0X1531B80C56297FD2.avi,110,1517,1177,340,28.88700084961767,morphological_dilation,3,2
0X1531B80C56297FD2.avi,129,988,704,284,40.340909090909086,morphological_dilation,3,2
0X153A76426320A57B.avi,98,1936,1548,388,25.064599483204137,morphological_dilation,3,2
0X153A76426320A57B.avi,113,1729,1365,364,26.666666666666668,morphological_dilation,3,2
0X153F6AD036CBC30B.avi,32,2340,1884,456,24.203821656050955,morphological_dilation,3,2
0X153F6AD036CBC30B.avi,51,2142,1726,416,24.10196987253766,morphological_dilation,3,2
0X1545ED054E5CE01D.avi,42,2376,1929,447,23.17262830482115,morphological_dilation,3,2
0X1545ED054E5CE01D.avi,56,1384,1020,364,35.68627450980392,morphological_dilation,3,2
0X154827D058D6A9D0.avi,158,1371,1043,328,31.447746883988493,morphological_dilation,3,2
0X154827D058D6A9D0.avi,179,808,541,267,49.35304990757856,morphological_dilation,3,2
0X154A3BABDF5193B6.avi,55,2119,1693,426,25.162433549911402,morphological_dilation,3,2
0X154A3BABDF5193B6.avi,76,1393,1037,356,34.3297974927676,morphological_dilation,3,2
0X154B75E4EF6184AE.avi,2,1478,1138,340,29.876977152899826,morphological_dilation,3,2
0X154B75E4EF6184AE.avi,17,1040,748,292,39.037433155080215,morphological_dilation,3,2
0X15505C1D0357A434.avi,272,3715,3180,535,16.82389937106918,morphological_dilation,3,2
0X15505C1D0357A434.avi,307,3150,2639,511,19.363395225464192,morphological_dilation,3,2
0X1556825C5295368F.avi,86,1657,1297,360,27.756360832690824,morphological_dilation,3,2
0X1556825C5295368F.avi,100,981,705,276,39.148936170212764,morphological_dilation,3,2
0X155A7771ACB14472.avi,62,2268,1827,441,24.137931034482758,morphological_dilation,3,2
0X155A7771ACB14472.avi,79,1495,1104,391,35.41666666666667,morphological_dilation,3,2
0X155E07DE20CF09F5.avi,54,1983,1559,424,27.196921103271325,morphological_dilation,3,2
0X155E07DE20CF09F5.avi,72,1009,697,312,44.76327116212339,morphological_dilation,3,2
0X1563E9D9834E5A52.avi,100,1892,1474,418,28.35820895522388,morphological_dilation,3,2
0X1563E9D9834E5A52.avi,121,1418,1066,352,33.02063789868668,morphological_dilation,3,2
0X1564DE8D0D40F195.avi,45,1829,1437,392,27.279053583855255,morphological_dilation,3,2
0X1564DE8D0D40F195.avi,62,1180,864,316,36.574074074074076,morphological_dilation,3,2
0X15672D90E3EC7303.avi,112,1779,1399,380,27.162258756254467,morphological_dilation,3,2
0X15672D90E3EC7303.avi,130,1162,842,320,38.00475059382423,morphological_dilation,3,2
0X156A170A2372A74D.avi,36,1797,1413,384,27.176220806794056,morphological_dilation,3,2
0X156A170A2372A74D.avi,53,1030,730,300,41.0958904109589,morphological_dilation,3,2
0X156B1DF0112EDD64.avi,55,3036,2552,484,18.96551724137931,morphological_dilation,3,2
0X156B1DF0112EDD64.avi,75,1963,1563,400,25.591810620601407,morphological_dilation,3,2
0X156F3A66548E593A.avi,143,1612,1252,360,28.753993610223645,morphological_dilation,3,2
0X156F3A66548E593A.avi,159,905,629,276,43.87917329093799,morphological_dilation,3,2
0X1572A0615437CE09.avi,60,1330,1010,320,31.683168316831683,morphological_dilation,3,2
0X1572A0615437CE09.avi,69,808,548,260,47.44525547445255,morphological_dilation,3,2
0X157528EBA14B2EB6.avi,42,1916,1516,400,26.385224274406333,morphological_dilation,3,2
0X157528EBA14B2EB6.avi,58,1236,888,348,39.189189189189186,morphological_dilation,3,2
0X1578E7D18F51EBBA.avi,18,1370,1010,360,35.64356435643564,morphological_dilation,3,2
0X1578E7D18F51EBBA.avi,51,2336,1888,448,23.728813559322035,morphological_dilation,3,2
0X157AC89BC2BB953E.avi,47,1890,1510,380,25.165562913907287,morphological_dilation,3,2
0X157AC89BC2BB953E.avi,65,1670,1314,356,27.09284627092846,morphological_dilation,3,2
0X157BF8C4D154D45D.avi,63,1633,1256,377,30.015923566878982,morphological_dilation,3,2
0X157BF8C4D154D45D.avi,92,1370,974,396,40.6570841889117,morphological_dilation,3,2
0X158518565B5C46D8.avi,61,1777,1373,404,29.42461762563729,morphological_dilation,3,2
0X158518565B5C46D8.avi,79,1117,778,339,43.573264781491,morphological_dilation,3,2
0X15861B0853DB6E4D.avi,168,1788,1416,372,26.27118644067797,morphological_dilation,3,2
0X15861B0853DB6E4D.avi,189,1099,803,296,36.86176836861768,morphological_dilation,3,2
0X158B03C45BB55DAC.avi,81,3112,2604,508,19.508448540706606,morphological_dilation,3,2
0X158B03C45BB55DAC.avi,98,1838,1422,416,29.254571026722925,morphological_dilation,3,2
0X158C469B8C462A10.avi,46,3573,2986,587,19.658405894172805,morphological_dilation,3,2
0X158C469B8C462A10.avi,61,2793,2249,544,24.18852823477101,morphological_dilation,3,2
0X1592A79667250EA1.avi,49,2102,1678,424,25.26817640047676,morphological_dilation,3,2
0X1592A79667250EA1.avi,67,1262,914,348,38.074398249452955,morphological_dilation,3,2
0X159307C65686B64D.avi,128,1710,1304,406,31.13496932515337,morphological_dilation,3,2
0X159307C65686B64D.avi,141,1133,756,377,49.86772486772487,morphological_dilation,3,2
0X1597DA4581B6F4AD.avi,39,1445,1113,332,29.829290206648697,morphological_dilation,3,2
0X1597DA4581B6F4AD.avi,63,827,571,256,44.833625218914186,morphological_dilation,3,2
0X1599E3BC17BB6A01.avi,36,1749,1345,404,30.03717472118959,morphological_dilation,3,2
0X1599E3BC17BB6A01.avi,50,995,674,321,47.62611275964392,morphological_dilation,3,2
0X159BDA520C61736A.avi,43,1193,889,304,34.19572553430822,morphological_dilation,3,2
0X159BDA520C61736A.avi,62,742,470,272,57.87234042553191,morphological_dilation,3,2
0X15A62E3A92DFFF7.avi,44,2422,1970,452,22.944162436548226,morphological_dilation,3,2
0X15A62E3A92DFFF7.avi,60,1566,1198,368,30.71786310517529,morphological_dilation,3,2
0X15A89931D5E83C23.avi,163,1319,1007,312,30.98311817279047,morphological_dilation,3,2
0X15A89931D5E83C23.avi,182,1097,809,288,35.59950556242274,morphological_dilation,3,2
0X15A912A3822431A9.avi,1,2504,2048,456,22.265625,morphological_dilation,3,2
0X15A912A3822431A9.avi,15,1574,1230,344,27.967479674796746,morphological_dilation,3,2
0X15AA1BAFC9C0CCB2.avi,68,2705,2238,467,20.8668453976765,morphological_dilation,3,2
0X15AA1BAFC9C0CCB2.avi,94,2174,1743,431,24.72748135398738,morphological_dilation,3,2
0X15ACD275B96CDD05.avi,59,2142,1714,428,24.970828471411902,morphological_dilation,3,2
0X15ACD275B96CDD05.avi,79,1243,923,320,34.66955579631636,morphological_dilation,3,2
0X15B26FE0D3CD6E0F.avi,68,1834,1432,402,28.07262569832402,morphological_dilation,3,2
0X15B26FE0D3CD6E0F.avi,93,1217,874,343,39.244851258581235,morphological_dilation,3,2
0X15B2A840A070DCC9.avi,48,1555,1187,368,31.002527379949452,morphological_dilation,3,2
0X15B2A840A070DCC9.avi,67,1024,710,314,44.225352112676056,morphological_dilation,3,2
0X15B6905E8EC410FA.avi,88,3223,2699,524,19.414597999258984,morphological_dilation,3,2
0X15B6905E8EC410FA.avi,103,2675,2203,472,21.425329096686337,morphological_dilation,3,2
0X15B980AC8A6B5EF1.avi,36,1868,1472,396,26.902173913043477,morphological_dilation,3,2
0X15B980AC8A6B5EF1.avi,52,1168,848,320,37.735849056603776,morphological_dilation,3,2
0X15BA82A1F6BF8B6.avi,100,2637,2173,464,21.352968246663597,morphological_dilation,3,2
0X15BA82A1F6BF8B6.avi,114,1707,1319,388,29.41622441243366,morphological_dilation,3,2
0X15BE180F1CCF0F3B.avi,39,1336,1004,332,33.067729083665334,morphological_dilation,3,2
0X15BE180F1CCF0F3B.avi,52,859,591,268,45.346869712351946,morphological_dilation,3,2
0X15C0D7DBFF8E4FC8.avi,48,1608,1244,364,29.260450160771708,morphological_dilation,3,2
0X15C0D7DBFF8E4FC8.avi,67,1276,944,332,35.16949152542373,morphological_dilation,3,2
0X15C4831F7DDCA462.avi,3,2019,1615,404,25.01547987616099,morphological_dilation,3,2
0X15C4831F7DDCA462.avi,19,1249,928,321,34.59051724137931,morphological_dilation,3,2
0X15C85161F8F9A55B.avi,3,1316,992,324,32.66129032258064,morphological_dilation,3,2
0X15C85161F8F9A55B.avi,18,851,575,276,48.0,morphological_dilation,3,2
0X15C904A855E4FF2B.avi,45,2408,1961,447,22.79449260581336,morphological_dilation,3,2
0X15C904A855E4FF2B.avi,62,1425,1069,356,33.302151543498596,morphological_dilation,3,2
0X15CBECA136CF18CD.avi,55,1312,982,330,33.604887983706725,morphological_dilation,3,2
0X15CBECA136CF18CD.avi,75,950,654,296,45.25993883792049,morphological_dilation,3,2
0X15CC2CDE8C2CD542.avi,66,1769,1379,390,28.281363306744016,morphological_dilation,3,2
0X15CC2CDE8C2CD542.avi,80,1194,858,336,39.16083916083916,morphological_dilation,3,2
0X15CC6C50F1763B61.avi,41,2495,2051,444,21.647976596782055,morphological_dilation,3,2
0X15CC6C50F1763B61.avi,60,1761,1377,384,27.886710239651418,morphological_dilation,3,2
0X15D24A43FD766AB9.avi,58,1700,1309,391,29.87012987012987,morphological_dilation,3,2
0X15D24A43FD766AB9.avi,75,1017,692,325,46.96531791907515,morphological_dilation,3,2
0X15D27BEDBDC09AA0.avi,46,2040,1648,392,23.78640776699029,morphological_dilation,3,2
0X15D27BEDBDC09AA0.avi,64,1637,1287,350,27.195027195027194,morphological_dilation,3,2
0X15D82D31755657.avi,57,1604,1224,380,31.045751633986928,morphological_dilation,3,2
0X15D82D31755657.avi,70,995,703,292,41.53627311522048,morphological_dilation,3,2
0X15D8B127660F649C.avi,42,1417,1077,340,31.569173630454966,morphological_dilation,3,2
0X15D8B127660F649C.avi,54,897,617,280,45.38087520259319,morphological_dilation,3,2
0X15D9F9EC9BA764E7.avi,93,3088,2596,492,18.952234206471495,morphological_dilation,3,2
0X15D9F9EC9BA764E7.avi,104,1714,1330,384,28.87218045112782,morphological_dilation,3,2
0X15DA8D60960ABB2B.avi,53,1773,1393,380,27.27925340990668,morphological_dilation,3,2
0X15DA8D60960ABB2B.avi,71,1274,942,332,35.24416135881104,morphological_dilation,3,2
0X15DC7EFD8DB3D0A6.avi,38,1362,1034,328,31.721470019342355,morphological_dilation,3,2
0X15DC7EFD8DB3D0A6.avi,53,1129,829,300,36.18817852834741,morphological_dilation,3,2
0X15DF6B9DA16DAD07.avi,42,1900,1516,384,25.32981530343008,morphological_dilation,3,2
0X15DF6B9DA16DAD07.avi,58,1184,876,308,35.15981735159817,morphological_dilation,3,2
0X15E22119724FDD7D.avi,95,1756,1384,372,26.878612716763005,morphological_dilation,3,2
0X15E22119724FDD7D.avi,111,973,693,280,40.4040404040404,morphological_dilation,3,2
0X15E8BE2AE8C05C88.avi,52,3193,2701,492,18.215475749722327,morphological_dilation,3,2
0X15E8BE2AE8C05C88.avi,72,2293,1857,436,23.47872913301023,morphological_dilation,3,2
0X15E987778BEC99D5.avi,113,2125,1709,416,24.3417203042715,morphological_dilation,3,2
0X15E987778BEC99D5.avi,130,1376,1012,364,35.96837944664031,morphological_dilation,3,2
0X15E9928F7242538E.avi,42,2553,2109,444,21.052631578947366,morphological_dilation,3,2
0X15E9928F7242538E.avi,62,1576,1203,373,31.005818786367417,morphological_dilation,3,2
0X15F1317B1354152B.avi,49,1623,1251,372,29.73621103117506,morphological_dilation,3,2
0X15F1317B1354152B.avi,64,1002,694,308,44.38040345821326,morphological_dilation,3,2
0X15F216DB6201C0F.avi,86,1413,1055,358,33.93364928909953,morphological_dilation,3,2
0X15F216DB6201C0F.avi,105,851,572,279,48.77622377622377,morphological_dilation,3,2
0X15FFEB32E5D2ECF2.avi,32,1342,1002,340,33.93213572854291,morphological_dilation,3,2
0X15FFEB32E5D2ECF2.avi,43,931,615,316,51.38211382113821,morphological_dilation,3,2
0X1603C982E33D045E.avi,36,1353,1025,328,32.0,morphological_dilation,3,2
0X1603C982E33D045E.avi,51,841,565,276,48.849557522123895,morphological_dilation,3,2
0X160563B6A541752C.avi,86,1325,989,336,33.9737108190091,morphological_dilation,3,2
0X160563B6A541752C.avi,97,860,572,288,50.349650349650354,morphological_dilation,3,2
0X160C233C08E7E8DE.avi,49,2467,2007,460,22.9197807673144,morphological_dilation,3,2
0X160C233C08E7E8DE.avi,64,1519,1136,383,33.71478873239437,morphological_dilation,3,2
0X160DBDFED541D2D9.avi,61,2094,1674,420,25.089605734767023,morphological_dilation,3,2
0X160DBDFED541D2D9.avi,72,1515,1154,361,31.28249566724437,morphological_dilation,3,2
0X160E1BD0E636CC69.avi,46,2461,2025,436,21.530864197530864,morphological_dilation,3,2
0X160E1BD0E636CC69.avi,63,1813,1429,384,26.871938418474457,morphological_dilation,3,2
0X160FFE14D950D4C0.avi,43,2350,1914,436,22.77951933124347,morphological_dilation,3,2
0X160FFE14D950D4C0.avi,61,1434,1086,348,32.04419889502763,morphological_dilation,3,2
0X1611B3A479A63A01.avi,65,2232,1786,446,24.972004479283314,morphological_dilation,3,2
0X1611B3A479A63A01.avi,84,1427,1079,348,32.252085264133456,morphological_dilation,3,2
0X16134D6B554889A.avi,40,2987,2473,514,20.78447230084917,morphological_dilation,3,2
0X16134D6B554889A.avi,62,1809,1362,447,32.819383259911895,morphological_dilation,3,2
0X16139FAA2B68E8FD.avi,50,1715,1331,384,28.850488354620584,morphological_dilation,3,2
0X16139FAA2B68E8FD.avi,66,1097,777,320,41.184041184041185,morphological_dilation,3,2
0X16148C355E993321.avi,67,2250,1822,428,23.490669593852907,morphological_dilation,3,2
0X16148C355E993321.avi,83,1933,1541,392,25.4380272550292,morphological_dilation,3,2
0X1616791A7190BBA0.avi,42,2623,2155,468,21.7169373549884,morphological_dilation,3,2
0X1616791A7190BBA0.avi,59,1867,1467,400,27.266530334015,morphological_dilation,3,2
0X1619E4697D8673B4.avi,42,1814,1430,384,26.853146853146853,morphological_dilation,3,2
0X1619E4697D8673B4.avi,64,1255,927,328,35.382955771305284,morphological_dilation,3,2
0X1622EDE923576CF4.avi,67,1765,1385,380,27.436823104693143,morphological_dilation,3,2
0X1622EDE923576CF4.avi,81,1135,815,320,39.263803680981596,morphological_dilation,3,2
0X1623BBE488F0EC89.avi,47,1901,1501,400,26.648900732844773,morphological_dilation,3,2
0X1623BBE488F0EC89.avi,64,1351,1001,350,34.96503496503497,morphological_dilation,3,2
0X162DC693CC98C01F.avi,73,2039,1631,408,25.015328019619865,morphological_dilation,3,2
0X162DC693CC98C01F.avi,88,1533,1165,368,31.587982832618028,morphological_dilation,3,2
0X1631C52C25D15DEE.avi,1,1988,1584,404,25.5050505050505,morphological_dilation,3,2
0X1631C52C25D15DEE.avi,17,1432,1084,348,32.10332103321033,morphological_dilation,3,2
0X163A374094D066E8.avi,112,1526,1144,382,33.39160839160839,morphological_dilation,3,2
0X163A374094D066E8.avi,143,2616,2140,476,22.242990654205606,morphological_dilation,3,2
0X163D02E41A3A93D.avi,40,1108,808,300,37.12871287128713,morphological_dilation,3,2
0X163D02E41A3A93D.avi,47,989,709,280,39.492242595204516,morphological_dilation,3,2
0X163EBCB6784FC30B.avi,41,1796,1388,408,29.394812680115272,morphological_dilation,3,2
0X163EBCB6784FC30B.avi,58,1162,834,328,39.328537170263786,morphological_dilation,3,2
0X163FFB185E479D0C.avi,88,2888,2396,492,20.534223706176963,morphological_dilation,3,2
0X163FFB185E479D0C.avi,101,1786,1386,400,28.86002886002886,morphological_dilation,3,2
0X164D9C71CC801B34.avi,40,2167,1735,432,24.89913544668588,morphological_dilation,3,2
0X164D9C71CC801B34.avi,60,1771,1387,384,27.68565248738284,morphological_dilation,3,2
0X164E6F5DA8503204.avi,47,1744,1348,396,29.376854599406528,morphological_dilation,3,2
0X164E6F5DA8503204.avi,66,1192,862,330,38.2830626450116,morphological_dilation,3,2
0X1653CEFBC9986D9F.avi,60,1293,957,336,35.10971786833856,morphological_dilation,3,2
0X1653CEFBC9986D9F.avi,74,844,552,292,52.89855072463768,morphological_dilation,3,2
0X1655D3F044EB6BB2.avi,195,1050,759,291,38.3399209486166,morphological_dilation,3,2
0X1655D3F044EB6BB2.avi,206,668,423,245,57.919621749408975,morphological_dilation,3,2
0X1655F3F4D2943C1D.avi,58,1280,956,324,33.89121338912134,morphological_dilation,3,2
0X1655F3F4D2943C1D.avi,76,856,572,284,49.65034965034965,morphological_dilation,3,2
0X16562EC4F3B6646B.avi,82,1605,1237,368,29.74939369442199,morphological_dilation,3,2
0X16562EC4F3B6646B.avi,94,1042,742,300,40.43126684636118,morphological_dilation,3,2
0X1659FD6165A50811.avi,46,1582,1206,376,31.17744610281924,morphological_dilation,3,2
0X1659FD6165A50811.avi,64,1004,696,308,44.252873563218394,morphological_dilation,3,2
0X165D339CF0773DFD.avi,41,1359,1027,332,32.327166504381694,morphological_dilation,3,2
0X165D339CF0773DFD.avi,53,968,676,292,43.19526627218935,morphological_dilation,3,2
0X165EC58045A8A8BF.avi,66,1876,1500,376,25.066666666666666,morphological_dilation,3,2
0X165EC58045A8A8BF.avi,84,1170,866,304,35.10392609699769,morphological_dilation,3,2
0X166087A5E749713A.avi,119,1500,1164,336,28.865979381443296,morphological_dilation,3,2
0X166087A5E749713A.avi,132,1184,888,296,33.33333333333333,morphological_dilation,3,2
0X166A033F6DC02086.avi,77,1069,781,288,36.875800256081945,morphological_dilation,3,2
0X166A033F6DC02086.avi,96,778,506,272,53.75494071146245,morphological_dilation,3,2
0X166B0D5A9407635F.avi,44,2189,1753,436,24.871648602395894,morphological_dilation,3,2
0X166B0D5A9407635F.avi,62,1416,1036,380,36.67953667953668,morphological_dilation,3,2
0X166B717BBC2ECADA.avi,78,1210,886,324,36.56884875846501,morphological_dilation,3,2
0X166B717BBC2ECADA.avi,88,864,576,288,50.0,morphological_dilation,3,2
0X166BF85033848E4E.avi,33,1759,1387,372,26.820475847152125,morphological_dilation,3,2
0X166BF85033848E4E.avi,46,1649,1293,356,27.532869296210364,morphological_dilation,3,2
0X166F42C7B9DD12C.avi,59,2118,1666,452,27.13085234093637,morphological_dilation,3,2
0X166F42C7B9DD12C.avi,74,1263,891,372,41.75084175084175,morphological_dilation,3,2
0X1674C7C6F8A8B313.avi,3,2375,1935,440,22.739018087855296,morphological_dilation,3,2
0X1674C7C6F8A8B313.avi,26,1466,1099,367,33.393994540491356,morphological_dilation,3,2
0X16763AF254837506.avi,90,1792,1408,384,27.27272727272727,morphological_dilation,3,2
0X16763AF254837506.avi,109,1177,853,324,37.98358733880422,morphological_dilation,3,2
0X16765E1EDC5E93BE.avi,78,1640,1288,352,27.32919254658385,morphological_dilation,3,2
0X16765E1EDC5E93BE.avi,93,1343,1015,328,32.31527093596059,morphological_dilation,3,2
0X1677A8B7AAA975A1.avi,76,1598,1242,356,28.663446054750402,morphological_dilation,3,2
0X1677A8B7AAA975A1.avi,92,931,647,284,43.89489953632149,morphological_dilation,3,2
0X167EC6F7A8986FED.avi,51,2155,1743,412,23.63740676993689,morphological_dilation,3,2
0X167EC6F7A8986FED.avi,67,1683,1315,368,27.984790874524716,morphological_dilation,3,2
0X167F487F9DF04A97.avi,98,1609,1245,364,29.23694779116466,morphological_dilation,3,2
0X167F487F9DF04A97.avi,113,949,669,280,41.85351270553064,morphological_dilation,3,2
0X168065C1F6FCF27C.avi,58,2564,2104,460,21.863117870722434,morphological_dilation,3,2
0X168065C1F6FCF27C.avi,72,2077,1661,416,25.04515352197472,morphological_dilation,3,2
0X1685EEE356F42581.avi,116,1385,1041,344,33.04514889529299,morphological_dilation,3,2
0X1685EEE356F42581.avi,130,871,580,291,50.172413793103445,morphological_dilation,3,2
0X16862634E89FB736.avi,82,1503,1151,352,30.582102519548222,morphological_dilation,3,2
0X16862634E89FB736.avi,96,903,611,292,47.79050736497545,morphological_dilation,3,2
0X1689802F6D3093D2.avi,90,2048,1624,424,26.108374384236456,morphological_dilation,3,2
0X1689802F6D3093D2.avi,105,1280,944,336,35.59322033898305,morphological_dilation,3,2
0X16902A1B1A139923.avi,30,1342,970,372,38.35051546391753,morphological_dilation,3,2
0X16902A1B1A139923.avi,39,739,463,276,59.611231101511876,morphological_dilation,3,2
0X169062AB1FF38E72.avi,112,1850,1454,396,27.235213204951858,morphological_dilation,3,2
0X169062AB1FF38E72.avi,141,1133,801,332,41.4481897627965,morphological_dilation,3,2
0X1694973B204EAB.avi,145,1533,1193,340,28.499580888516345,morphological_dilation,3,2
0X1694973B204EAB.avi,158,962,678,284,41.88790560471977,morphological_dilation,3,2
0X16967BF5B2546925.avi,127,1676,1305,371,28.42911877394636,morphological_dilation,3,2
0X16967BF5B2546925.avi,145,1333,999,334,33.433433433433436,morphological_dilation,3,2
0X169B747DFB6D2415.avi,61,1888,1508,380,25.198938992042443,morphological_dilation,3,2
0X169B747DFB6D2415.avi,76,1186,882,304,34.467120181405896,morphological_dilation,3,2
0X169BC7341D79E051.avi,60,1929,1525,404,26.491803278688526,morphological_dilation,3,2
0X169BC7341D79E051.avi,73,1289,965,324,33.575129533678755,morphological_dilation,3,2
0X169D3A3AC16C2CE2.avi,89,1611,1235,376,30.44534412955466,morphological_dilation,3,2
0X169D3A3AC16C2CE2.avi,105,1074,766,308,40.2088772845953,morphological_dilation,3,2
0X16A017AC10918091.avi,92,1517,1115,402,36.053811659192824,morphological_dilation,3,2
0X16A017AC10918091.avi,109,1194,837,357,42.65232974910394,morphological_dilation,3,2
0X16A129DE47B81909.avi,69,1475,1147,328,28.596338273757627,morphological_dilation,3,2
0X16A129DE47B81909.avi,82,959,683,276,40.4099560761347,morphological_dilation,3,2
0X16A6CEDE7F61E211.avi,131,1422,1090,332,30.458715596330276,morphological_dilation,3,2
0X16A6CEDE7F61E211.avi,145,897,629,268,42.60731319554849,morphological_dilation,3,2
0X16A9F4D08E4677A1.avi,51,2920,2432,488,20.065789473684212,morphological_dilation,3,2
0X16A9F4D08E4677A1.avi,68,1701,1305,396,30.344827586206897,morphological_dilation,3,2
0X16ACC4514A457BBA.avi,56,1424,1084,340,31.365313653136536,morphological_dilation,3,2
0X16ACC4514A457BBA.avi,72,907,639,268,41.94053208137715,morphological_dilation,3,2
0X16AF26F9A372EEDE.avi,99,2494,2062,432,20.950533462657614,morphological_dilation,3,2
0X16AF26F9A372EEDE.avi,118,1649,1297,352,27.139552814186587,morphological_dilation,3,2
0X16B28DDAC5D81FDF.avi,65,1330,994,336,33.80281690140845,morphological_dilation,3,2
0X16B28DDAC5D81FDF.avi,84,882,594,288,48.484848484848484,morphological_dilation,3,2
0X16B2D41C50E4082C.avi,56,1038,746,292,39.14209115281501,morphological_dilation,3,2
0X16B2D41C50E4082C.avi,70,656,412,244,59.22330097087378,morphological_dilation,3,2
0X16B5A10BF77BE425.avi,26,1275,943,332,35.2067868504772,morphological_dilation,3,2
0X16B5A10BF77BE425.avi,53,2049,1637,412,25.167990226023214,morphological_dilation,3,2
0X16B76AB7F9D95270.avi,39,1589,1233,356,28.872668288726683,morphological_dilation,3,2
0X16B76AB7F9D95270.avi,53,1035,739,296,40.054127198917456,morphological_dilation,3,2
0X16B85222D7B28245.avi,79,2525,2077,448,21.56957149735195,morphological_dilation,3,2
0X16B85222D7B28245.avi,97,2196,1776,420,23.64864864864865,morphological_dilation,3,2
0X16BB1F509B1D9721.avi,47,2137,1709,428,25.043885313048563,morphological_dilation,3,2
0X16BB1F509B1D9721.avi,61,1336,984,352,35.77235772357724,morphological_dilation,3,2
0X16CEA7710E200570.avi,47,1821,1417,404,28.510938602681723,morphological_dilation,3,2
0X16CEA7710E200570.avi,67,1029,733,296,40.381991814461124,morphological_dilation,3,2
0X16CFBE094453AA79.avi,97,2233,1770,463,26.15819209039548,morphological_dilation,3,2
0X16CFBE094453AA79.avi,115,1378,989,389,39.33265925176946,morphological_dilation,3,2
0X16CFE39107BFF8A7.avi,34,1194,898,296,32.962138084632514,morphological_dilation,3,2
0X16CFE39107BFF8A7.avi,43,785,529,256,48.39319470699433,morphological_dilation,3,2
0X16D883017E8A7734.avi,100,1419,1087,332,30.542778288868444,morphological_dilation,3,2
0X16D883017E8A7734.avi,119,913,641,272,42.43369734789392,morphological_dilation,3,2
0X16F87B98A2C09E62.avi,39,1203,899,304,33.815350389321466,morphological_dilation,3,2
0X16F87B98A2C09E62.avi,59,845,585,260,44.44444444444444,morphological_dilation,3,2
0X16FA4A372C724D22.avi,46,1230,906,324,35.76158940397351,morphological_dilation,3,2
0X16FA4A372C724D22.avi,61,788,508,280,55.118110236220474,morphological_dilation,3,2
0X16FB5FF81284B942.avi,1,1551,1195,356,29.7907949790795,morphological_dilation,3,2
0X16FB5FF81284B942.avi,17,1186,870,316,36.321839080459775,morphological_dilation,3,2
0X16FBD79EE1C8DA26.avi,87,1492,1148,344,29.965156794425084,morphological_dilation,3,2
0X16FBD79EE1C8DA26.avi,98,872,596,276,46.308724832214764,morphological_dilation,3,2
0X16FC9AA0AD5D8136.avi,47,1946,1546,400,25.873221216041397,morphological_dilation,3,2
0X16FC9AA0AD5D8136.avi,68,1788,1396,392,28.08022922636103,morphological_dilation,3,2
0X16FE5AFA8320ACD3.avi,33,3273,2749,524,19.06147690069116,morphological_dilation,3,2
0X16FE5AFA8320ACD3.avi,52,2489,2049,440,21.473889702293803,morphological_dilation,3,2
0X1702B6CCB7E8812B.avi,36,1939,1543,396,25.664290343486712,morphological_dilation,3,2
0X1702B6CCB7E8812B.avi,50,1280,940,340,36.17021276595745,morphological_dilation,3,2
0X1702CEEC44104760.avi,57,2527,2047,480,23.44894968246214,morphological_dilation,3,2
0X1702CEEC44104760.avi,71,2172,1736,436,25.115207373271893,morphological_dilation,3,2
0X17057442E198A967.avi,63,1977,1577,400,25.36461636017755,morphological_dilation,3,2
0X17057442E198A967.avi,78,1330,978,352,35.991820040899796,morphological_dilation,3,2
0X17098CFCB688AD91.avi,48,1992,1564,428,27.365728900255753,morphological_dilation,3,2
0X17098CFCB688AD91.avi,65,1163,823,340,41.31227217496962,morphological_dilation,3,2
0X170AA34F7E4EFB6B.avi,54,2045,1609,436,27.09757613424487,morphological_dilation,3,2
0X170AA34F7E4EFB6B.avi,75,1236,876,360,41.0958904109589,morphological_dilation,3,2
0X170DDD15D26D5F83.avi,44,1314,970,344,35.4639175257732,morphological_dilation,3,2
0X170DDD15D26D5F83.avi,62,951,643,308,47.900466562986004,morphological_dilation,3,2
0X170F2698C1A90A77.avi,58,2730,2243,487,21.711992866696388,morphological_dilation,3,2
0X170F2698C1A90A77.avi,80,1786,1384,402,29.046242774566473,morphological_dilation,3,2
0X1711A2ED181823F0.avi,39,2002,1594,408,25.59598494353827,morphological_dilation,3,2
0X1711A2ED181823F0.avi,55,1314,974,340,34.90759753593429,morphological_dilation,3,2
0X17174AB357750B03.avi,38,1632,1260,372,29.523809523809526,morphological_dilation,3,2
0X17174AB357750B03.avi,53,1030,730,300,41.0958904109589,morphological_dilation,3,2
0X17190A139A853180.avi,111,3936,3308,628,18.98428053204353,morphological_dilation,3,2
0X17190A139A853180.avi,130,2645,2105,540,25.653206650831358,morphological_dilation,3,2
0X17197B4B5AE30CC7.avi,115,2128,1708,420,24.59016393442623,morphological_dilation,3,2
0X17197B4B5AE30CC7.avi,132,1350,1010,340,33.663366336633665,morphological_dilation,3,2
0X171A7C9E7E1129D.avi,53,1585,1221,364,29.811629811629814,morphological_dilation,3,2
0X171A7C9E7E1129D.avi,71,1287,967,320,33.092037228541884,morphological_dilation,3,2
0X171A888D1B17304F.avi,157,1678,1278,400,31.29890453834116,morphological_dilation,3,2
0X171A888D1B17304F.avi,174,920,568,352,61.97183098591549,morphological_dilation,3,2
0X171B390B95FD0FAE.avi,77,1819,1436,383,26.67130919220056,morphological_dilation,3,2
0X171B390B95FD0FAE.avi,91,1107,807,300,37.174721189591075,morphological_dilation,3,2
0X171B52ED0054DF49.avi,127,2454,1990,464,23.316582914572866,morphological_dilation,3,2
0X171B52ED0054DF49.avi,151,1523,1139,384,33.71378402107111,morphological_dilation,3,2
0X171C87FA9E52210F.avi,48,1552,1212,340,28.052805280528055,morphological_dilation,3,2
0X171C87FA9E52210F.avi,66,1263,955,308,32.25130890052356,morphological_dilation,3,2
0X171C9D28B996267E.avi,115,1535,1207,328,27.174813587406792,morphological_dilation,3,2
0X171C9D28B996267E.avi,131,1209,913,296,32.420591456736034,morphological_dilation,3,2
0X171CF9695943319A.avi,42,2043,1635,408,24.954128440366972,morphological_dilation,3,2
0X171CF9695943319A.avi,63,1267,913,354,38.77327491785323,morphological_dilation,3,2
0X171FD888481D524D.avi,100,2039,1631,408,25.015328019619865,morphological_dilation,3,2
0X171FD888481D524D.avi,118,1229,905,324,35.80110497237569,morphological_dilation,3,2
0X1725C38816FAAED5.avi,56,1490,1134,356,31.393298059964724,morphological_dilation,3,2
0X1725C38816FAAED5.avi,75,972,672,300,44.642857142857146,morphological_dilation,3,2
0X17270F0DF580E06B.avi,100,3035,2535,500,19.723865877712033,morphological_dilation,3,2
0X17270F0DF580E06B.avi,122,1667,1283,384,29.929851909586908,morphological_dilation,3,2
0X172821226E303BA6.avi,133,1759,1359,400,29.433406916850625,morphological_dilation,3,2
0X172821226E303BA6.avi,155,1048,728,320,43.956043956043956,morphological_dilation,3,2
0X17294454521A97BB.avi,1,2109,1689,420,24.866785079928952,morphological_dilation,3,2
0X17294454521A97BB.avi,17,1324,972,352,36.21399176954733,morphological_dilation,3,2
0X1729DA199F862403.avi,140,1004,712,292,41.01123595505618,morphological_dilation,3,2
0X1729DA199F862403.avi,158,590,362,228,62.98342541436463,morphological_dilation,3,2
0X172CA389F7A02EEF.avi,161,2863,2323,540,23.245802841153683,morphological_dilation,3,2
0X172CA389F7A02EEF.avi,179,1871,1435,436,30.383275261324044,morphological_dilation,3,2
0X172D986B9780F9DE.avi,53,1676,1300,376,28.923076923076923,morphological_dilation,3,2
0X172D986B9780F9DE.avi,69,1149,829,320,38.600723763570564,morphological_dilation,3,2
0X172F640B239CBFCA.avi,105,2219,1795,424,23.62116991643454,morphological_dilation,3,2
0X172F640B239CBFCA.avi,124,1311,968,343,35.43388429752066,morphological_dilation,3,2
0X172FE96C1B43E4CF.avi,35,1616,1227,389,31.703341483292586,morphological_dilation,3,2
0X172FE96C1B43E4CF.avi,50,1462,1098,364,33.1511839708561,morphological_dilation,3,2
0X17344D3535D790EF.avi,41,1833,1449,384,26.501035196687372,morphological_dilation,3,2
0X17344D3535D790EF.avi,60,1022,710,312,43.94366197183099,morphological_dilation,3,2
0X173A0C055813A634.avi,101,2023,1595,428,26.83385579937304,morphological_dilation,3,2
0X173A0C055813A634.avi,122,1251,911,340,37.32162458836443,morphological_dilation,3,2
0X173D74409C3E5652.avi,39,1468,1144,324,28.321678321678323,morphological_dilation,3,2
0X173D74409C3E5652.avi,54,1318,998,320,32.06412825651302,morphological_dilation,3,2
0X174090E59512E733.avi,113,2324,1880,444,23.617021276595747,morphological_dilation,3,2
0X174090E59512E733.avi,134,1582,1186,396,33.38954468802699,morphological_dilation,3,2
0X17458D83D9F9B188.avi,42,2667,2183,484,22.17132386623912,morphological_dilation,3,2
0X17458D83D9F9B188.avi,66,1721,1313,408,31.073876618431072,morphological_dilation,3,2
0X174A9943AB689618.avi,1,1551,1211,340,28.075970272502065,morphological_dilation,3,2
0X174A9943AB689618.avi,11,1322,998,324,32.46492985971944,morphological_dilation,3,2
0X174ADA9A145CAD74.avi,90,1461,1077,384,35.65459610027855,morphological_dilation,3,2
0X174ADA9A145CAD74.avi,111,920,600,320,53.333333333333336,morphological_dilation,3,2
0X174D0098F99A290E.avi,38,1836,1452,384,26.446280991735538,morphological_dilation,3,2
0X174D0098F99A290E.avi,55,1296,964,332,34.439834024896264,morphological_dilation,3,2
0X174E853B58F29959.avi,88,4038,3434,604,17.58881770529994,morphological_dilation,3,2
0X174E853B58F29959.avi,102,2423,1935,488,25.219638242894053,morphological_dilation,3,2
0X175303C2D48B91CA.avi,34,1523,1171,352,30.0597779675491,morphological_dilation,3,2
0X175303C2D48B91CA.avi,48,1003,707,296,41.86704384724187,morphological_dilation,3,2
0X1756A6A345D31CB3.avi,31,1633,1245,388,31.16465863453815,morphological_dilation,3,2
0X1756A6A345D31CB3.avi,47,1419,1051,368,35.01427212178878,morphological_dilation,3,2
0X1760612A101EA2EB.avi,102,980,704,276,39.20454545454545,morphological_dilation,3,2
0X1760612A101EA2EB.avi,120,567,359,208,57.938718662952645,morphological_dilation,3,2
0X176394EB0FCFBD35.avi,84,2072,1680,392,23.333333333333332,morphological_dilation,3,2
0X176394EB0FCFBD35.avi,105,1328,996,332,33.33333333333333,morphological_dilation,3,2
0X1763FB53ABCFB176.avi,107,1660,1300,360,27.692307692307693,morphological_dilation,3,2
0X1763FB53ABCFB176.avi,126,1090,798,292,36.59147869674185,morphological_dilation,3,2
0X176B5602BC2BF57B.avi,59,1006,700,306,43.714285714285715,morphological_dilation,3,2
0X176B5602BC2BF57B.avi,76,588,336,252,75.0,morphological_dilation,3,2
0X176C1E76AD804467.avi,153,2444,2004,440,21.956087824351297,morphological_dilation,3,2
0X176C1E76AD804467.avi,168,1574,1214,360,29.654036243822073,morphological_dilation,3,2
0X1770B6D3A7C462B6.avi,56,2948,2460,488,19.83739837398374,morphological_dilation,3,2
0X1770B6D3A7C462B6.avi,74,1757,1381,376,27.226647356987687,morphological_dilation,3,2
0X1770D3F5C2EA5142.avi,48,1323,995,328,32.96482412060301,morphological_dilation,3,2
0X1770D3F5C2EA5142.avi,65,1002,714,288,40.33613445378151,morphological_dilation,3,2
0X17734E8CA72A687A.avi,42,1556,1216,340,27.960526315789476,morphological_dilation,3,2
0X17734E8CA72A687A.avi,54,940,657,283,43.07458143074581,morphological_dilation,3,2
0X1779C609E2B8B8C6.avi,85,1085,775,310,40.0,morphological_dilation,3,2
0X1779C609E2B8B8C6.avi,102,623,379,244,64.37994722955145,morphological_dilation,3,2
0X1779FEC3D7DEA8C2.avi,48,1967,1579,388,24.572514249525014,morphological_dilation,3,2
0X1779FEC3D7DEA8C2.avi,64,1570,1214,356,29.32454695222405,morphological_dilation,3,2
0X178269A4C18FC6B.avi,85,1756,1364,392,28.739002932551323,morphological_dilation,3,2
0X178269A4C18FC6B.avi,101,1102,778,324,41.645244215938305,morphological_dilation,3,2
0X17828CD670289D36.avi,2,1491,1139,352,30.90430201931519,morphological_dilation,3,2
0X17828CD670289D36.avi,16,935,643,292,45.41213063763608,morphological_dilation,3,2
0X17859AAFF455F6DF.avi,139,1719,1343,376,27.997021593447506,morphological_dilation,3,2
0X17859AAFF455F6DF.avi,162,1170,838,332,39.618138424821005,morphological_dilation,3,2
0X1786055C7E6EFCE6.avi,32,2178,1762,416,23.609534619750285,morphological_dilation,3,2
0X1786055C7E6EFCE6.avi,48,1624,1260,364,28.888888888888886,morphological_dilation,3,2
0X17865EC85AD080B0.avi,57,2212,1788,424,23.713646532438478,morphological_dilation,3,2
0X17865EC85AD080B0.avi,77,1290,950,340,35.78947368421053,morphological_dilation,3,2
0X178A34206F5D376E.avi,2,2899,2371,528,22.269084774356813,morphological_dilation,3,2
0X178A34206F5D376E.avi,19,1800,1380,420,30.434782608695656,morphological_dilation,3,2
0X178DE58CE0367682.avi,103,1649,1281,368,28.727556596409055,morphological_dilation,3,2
0X178DE58CE0367682.avi,123,1094,782,312,39.89769820971867,morphological_dilation,3,2
0X178DF5359B89AD06.avi,29,1312,960,352,36.666666666666664,morphological_dilation,3,2
0X178DF5359B89AD06.avi,46,1043,698,345,49.4269340974212,morphological_dilation,3,2
0X17918422FAD01F20.avi,42,1871,1495,376,25.150501672240804,morphological_dilation,3,2
0X17918422FAD01F20.avi,56,1150,838,312,37.23150357995227,morphological_dilation,3,2
0X1793039C294208A0.avi,83,2513,2069,444,21.459642339294348,morphological_dilation,3,2
0X1793039C294208A0.avi,104,1889,1489,400,26.863666890530556,morphological_dilation,3,2
0X1798604CE5F68C34.avi,63,1552,1204,348,28.903654485049834,morphological_dilation,3,2
0X1798604CE5F68C34.avi,75,951,664,287,43.22289156626506,morphological_dilation,3,2
0X179A9ADE4B5A5B88.avi,61,2300,1868,432,23.126338329764454,morphological_dilation,3,2
0X179A9ADE4B5A5B88.avi,76,1522,1138,384,33.74340949033392,morphological_dilation,3,2
0X179B579A585FF160.avi,1,2594,2138,456,21.328344246959777,morphological_dilation,3,2
0X179B579A585FF160.avi,21,1940,1532,408,26.631853785900784,morphological_dilation,3,2
0X179BA5C70ACC402D.avi,52,2368,1896,472,24.894514767932492,morphological_dilation,3,2
0X179BA5C70ACC402D.avi,68,1444,1068,376,35.2059925093633,morphological_dilation,3,2
0X179C10878AAE691E.avi,137,1125,821,304,37.028014616321556,morphological_dilation,3,2
0X179C10878AAE691E.avi,149,757,498,259,52.00803212851406,morphological_dilation,3,2
0X179CFD0E04B039FB.avi,57,2231,1807,424,23.464305478693966,morphological_dilation,3,2
0X179CFD0E04B039FB.avi,74,1694,1315,379,28.8212927756654,morphological_dilation,3,2
0X179D5051F8526C08.avi,32,2241,1825,416,22.794520547945204,morphological_dilation,3,2
0X179D5051F8526C08.avi,53,2050,1658,392,23.64294330518697,morphological_dilation,3,2
0X17A28F565B51B841.avi,163,2805,2341,464,19.820589491670226,morphological_dilation,3,2
0X17A28F565B51B841.avi,179,2134,1726,408,23.638470451911935,morphological_dilation,3,2
0X17A339D2A6706C11.avi,0,1647,1283,364,28.37100545596259,morphological_dilation,3,2
0X17A339D2A6706C11.avi,14,1033,725,308,42.48275862068965,morphological_dilation,3,2
0X17A44C8A2D0EE533.avi,41,2332,1900,432,22.736842105263158,morphological_dilation,3,2
0X17A44C8A2D0EE533.avi,58,1560,1200,360,30.0,morphological_dilation,3,2
0X17A5854FEC963F9A.avi,50,1781,1385,396,28.592057761732853,morphological_dilation,3,2
0X17A5854FEC963F9A.avi,68,1122,791,331,41.845764854614416,morphological_dilation,3,2
0X17A59B0D289D4643.avi,46,1487,1131,356,31.47656940760389,morphological_dilation,3,2
0X17A59B0D289D4643.avi,60,1025,704,321,45.596590909090914,morphological_dilation,3,2
0X17A9A432333A840F.avi,53,1540,1192,348,29.194630872483224,morphological_dilation,3,2
0X17A9A432333A840F.avi,69,1357,1033,324,31.364956437560505,morphological_dilation,3,2
0X17A9DF475F90B6C6.avi,64,2979,2471,508,20.55847834884662,morphological_dilation,3,2
0X17A9DF475F90B6C6.avi,75,2036,1605,431,26.853582554517136,morphological_dilation,3,2
0X17AA98EC842092E3.avi,38,2345,1885,460,24.40318302387268,morphological_dilation,3,2
0X17AA98EC842092E3.avi,50,1776,1376,400,29.069767441860467,morphological_dilation,3,2
0X17ADB25B1E90B6C.avi,48,3312,2796,516,18.4549356223176,morphological_dilation,3,2
0X17ADB25B1E90B6C.avi,66,2146,1714,432,25.204200700116687,morphological_dilation,3,2
0X17AE431AF06F53AB.avi,64,1026,730,296,40.54794520547945,morphological_dilation,3,2
0X17AE431AF06F53AB.avi,76,732,457,275,60.17505470459519,morphological_dilation,3,2
0X17AF6DB1F62C771C.avi,90,1665,1271,394,30.99921321793863,morphological_dilation,3,2
0X17AF6DB1F62C771C.avi,114,1076,748,328,43.85026737967914,morphological_dilation,3,2
0X17B3AF86CDF82B5C.avi,70,1592,1240,352,28.387096774193548,morphological_dilation,3,2
0X17B3AF86CDF82B5C.avi,95,1111,803,308,38.35616438356164,morphological_dilation,3,2
0X17BA5ABF4E82034B.avi,25,2515,2031,484,23.830625307730184,morphological_dilation,3,2
0X17BA5ABF4E82034B.avi,34,1270,818,452,55.256723716381416,morphological_dilation,3,2
0X17BC4EF4BF83368B.avi,101,1873,1445,428,29.619377162629757,morphological_dilation,3,2
0X17BC4EF4BF83368B.avi,124,1524,1124,400,35.587188612099645,morphological_dilation,3,2
0X17C42DA572378352.avi,40,2230,1778,452,25.421822272215973,morphological_dilation,3,2
0X17C42DA572378352.avi,55,1291,935,356,38.074866310160424,morphological_dilation,3,2
0X17C5541071D4E52E.avi,39,1261,933,328,35.155412647374064,morphological_dilation,3,2
0X17C5541071D4E52E.avi,49,763,495,268,54.141414141414145,morphological_dilation,3,2
0X17C6F77ABE9266AF.avi,45,1933,1525,408,26.754098360655735,morphological_dilation,3,2
0X17C6F77ABE9266AF.avi,62,1171,847,324,38.252656434474616,morphological_dilation,3,2
0X17CA14AB3CB05770.avi,40,2203,1775,428,24.112676056338028,morphological_dilation,3,2
0X17CA14AB3CB05770.avi,60,1286,942,344,36.51804670912951,morphological_dilation,3,2
0X17CAFC6BB1CA2DE.avi,50,2013,1621,392,24.18260333127699,morphological_dilation,3,2
0X17CAFC6BB1CA2DE.avi,66,1102,814,288,35.38083538083538,morphological_dilation,3,2
0X17D229C79845F458.avi,95,1850,1462,388,26.538987688098498,morphological_dilation,3,2
0X17D229C79845F458.avi,106,1229,881,348,39.500567536889896,morphological_dilation,3,2
0X17D6DA5B33D4069C.avi,4,2698,2214,484,21.860885275519422,morphological_dilation,3,2
0X17D6DA5B33D4069C.avi,17,2060,1624,436,26.84729064039409,morphological_dilation,3,2
0X17D958175C4CE2F3.avi,126,1483,1135,348,30.66079295154185,morphological_dilation,3,2
0X17D958175C4CE2F3.avi,141,970,686,284,41.39941690962099,morphological_dilation,3,2
0X17DA9A44189C6A38.avi,73,2560,2084,476,22.84069097888676,morphological_dilation,3,2
0X17DA9A44189C6A38.avi,88,1507,1123,384,34.19412288512912,morphological_dilation,3,2
0X17E230402D71C497.avi,48,1705,1333,372,27.906976744186046,morphological_dilation,3,2
0X17E230402D71C497.avi,65,1079,767,312,40.67796610169492,morphological_dilation,3,2
0X17E51BF21235E28B.avi,68,1580,1224,356,29.08496732026144,morphological_dilation,3,2
0X17E51BF21235E28B.avi,83,1033,734,299,40.735694822888284,morphological_dilation,3,2
0X17E5929A007B9E32.avi,36,1842,1458,384,26.337448559670783,morphological_dilation,3,2
0X17E5929A007B9E32.avi,50,1155,851,304,35.72267920094007,morphological_dilation,3,2
0X17E6608AC5511D03.avi,63,1924,1528,396,25.916230366492147,morphological_dilation,3,2
0X17E6608AC5511D03.avi,78,1502,1154,348,30.155979202772965,morphological_dilation,3,2
0X17E6B8EDDD62F739.avi,108,2509,2061,448,21.73702086365842,morphological_dilation,3,2
0X17E6B8EDDD62F739.avi,123,1608,1252,356,28.434504792332266,morphological_dilation,3,2
0X17E8971B356D72C7.avi,40,1402,1066,336,31.51969981238274,morphological_dilation,3,2
0X17E8971B356D72C7.avi,57,876,604,272,45.033112582781456,morphological_dilation,3,2
0X17EFE782884D63BA.avi,41,3013,2525,488,19.326732673267326,morphological_dilation,3,2
0X17EFE782884D63BA.avi,55,1770,1398,372,26.609442060085836,morphological_dilation,3,2
0X17F142F80B72740D.avi,42,1298,966,332,34.368530020703936,morphological_dilation,3,2
0X17F142F80B72740D.avi,56,780,519,261,50.28901734104046,morphological_dilation,3,2
0X17F29C21E6144BAB.avi,36,1877,1473,404,27.42701968771215,morphological_dilation,3,2
0X17F29C21E6144BAB.avi,50,1190,846,344,40.66193853427896,morphological_dilation,3,2
0X17F6D551F5734D8B.avi,66,3303,2799,504,18.006430868167204,morphological_dilation,3,2
0X17F6D551F5734D8B.avi,84,2628,2172,456,20.994475138121548,morphological_dilation,3,2
0X17F7CCE4FCD76726.avi,31,1527,1156,371,32.09342560553633,morphological_dilation,3,2
0X17F7CCE4FCD76726.avi,40,1018,698,320,45.845272206303726,morphological_dilation,3,2
0X17F940E1C4298D7.avi,16,1548,1180,368,31.186440677966104,morphological_dilation,3,2
0X17F940E1C4298D7.avi,35,1029,741,288,38.8663967611336,morphological_dilation,3,2
0X17FA348140E338F7.avi,38,1011,711,300,42.19409282700422,morphological_dilation,3,2
0X17FA348140E338F7.avi,55,641,385,256,66.49350649350649,morphological_dilation,3,2
0X17FD9808C073BC07.avi,103,3628,3072,556,18.098958333333336,morphological_dilation,3,2
0X17FD9808C073BC07.avi,123,1981,1534,447,29.139504563233377,morphological_dilation,3,2
0X17FE6C8963488DAC.avi,112,1362,1006,356,35.387673956262425,morphological_dilation,3,2
0X17FE6C8963488DAC.avi,125,862,572,290,50.6993006993007,morphological_dilation,3,2
0X18039FAD713F594F.avi,101,1567,1199,368,30.692243536280234,morphological_dilation,3,2
0X18039FAD713F594F.avi,111,961,669,292,43.64723467862481,morphological_dilation,3,2
0X180951979820CA64.avi,78,2330,1863,467,25.067096081588836,morphological_dilation,3,2
0X180951979820CA64.avi,99,1362,947,415,43.822597676874345,morphological_dilation,3,2
0X18111FDA1FD455D5.avi,3,1453,1101,352,31.970935513169845,morphological_dilation,3,2
0X18111FDA1FD455D5.avi,18,943,647,296,45.749613601236476,morphological_dilation,3,2
0X1815E6741A8B2CFA.avi,56,1430,1078,352,32.6530612244898,morphological_dilation,3,2
0X1815E6741A8B2CFA.avi,72,867,591,276,46.7005076142132,morphological_dilation,3,2
0X1818FF06D5E762A8.avi,4,1395,1059,336,31.728045325779036,morphological_dilation,3,2
0X1818FF06D5E762A8.avi,14,919,647,272,42.040185471406495,morphological_dilation,3,2
0X181A0445205F1D79.avi,134,2105,1701,404,23.750734861845974,morphological_dilation,3,2
0X181A0445205F1D79.avi,151,1395,1047,348,33.2378223495702,morphological_dilation,3,2
0X182114B9EB84D61B.avi,84,1281,949,332,34.98419388830348,morphological_dilation,3,2
0X182114B9EB84D61B.avi,96,987,695,292,42.014388489208635,morphological_dilation,3,2
0X18247588296B45DF.avi,3,1148,852,296,34.74178403755869,morphological_dilation,3,2
0X18247588296B45DF.avi,20,789,537,252,46.927374301675975,morphological_dilation,3,2
0X182717968AF362F0.avi,144,2174,1746,428,24.513172966781212,morphological_dilation,3,2
0X182717968AF362F0.avi,163,1507,1143,364,31.84601924759405,morphological_dilation,3,2
0X18277456188D3B13.avi,191,2616,2160,456,21.11111111111111,morphological_dilation,3,2
0X18277456188D3B13.avi,207,1898,1498,400,26.702269692923895,morphological_dilation,3,2
0X18353D8F5AB7B324.avi,105,2338,1878,460,24.494142705005327,morphological_dilation,3,2
0X18353D8F5AB7B324.avi,124,1323,959,364,37.95620437956204,morphological_dilation,3,2
0X18354FFCDBCF9EBB.avi,52,2010,1602,408,25.468164794007492,morphological_dilation,3,2
0X18354FFCDBCF9EBB.avi,67,1162,822,340,41.3625304136253,morphological_dilation,3,2
0X183BECFC41F9E3E0.avi,81,1278,954,324,33.9622641509434,morphological_dilation,3,2
0X183BECFC41F9E3E0.avi,100,841,565,276,48.849557522123895,morphological_dilation,3,2
0X183FA1CAAEA9C545.avi,28,2071,1675,396,23.64179104477612,morphological_dilation,3,2
0X183FA1CAAEA9C545.avi,33,2161,1614,547,33.8909541511772,morphological_dilation,3,2
0X1840607E4AF92B3E.avi,80,1525,1141,384,33.654688869412794,morphological_dilation,3,2
0X1840607E4AF92B3E.avi,98,1042,676,366,54.142011834319526,morphological_dilation,3,2
0X184173B598997780.avi,1,1560,1204,356,29.568106312292358,morphological_dilation,3,2
0X184173B598997780.avi,16,909,636,273,42.924528301886795,morphological_dilation,3,2
0X184432EACE258EBF.avi,52,2226,1778,448,25.196850393700785,morphological_dilation,3,2
0X184432EACE258EBF.avi,72,1394,1026,368,35.86744639376218,morphological_dilation,3,2
0X1847DC558AF3C423.avi,79,1650,1274,376,29.513343799058084,morphological_dilation,3,2
0X1847DC558AF3C423.avi,97,1335,995,340,34.17085427135678,morphological_dilation,3,2
0X1847E925CBCEB6CE.avi,5,1788,1420,368,25.915492957746476,morphological_dilation,3,2
0X1847E925CBCEB6CE.avi,22,1570,1222,348,28.477905073649758,morphological_dilation,3,2
0X184B997FF61BB28B.avi,48,2457,1938,519,26.78018575851393,morphological_dilation,3,2
0X184B997FF61BB28B.avi,66,1927,1427,500,35.0385423966363,morphological_dilation,3,2
0X184DEB337FF5AB9.avi,69,1649,1293,356,27.532869296210364,morphological_dilation,3,2
0X184DEB337FF5AB9.avi,86,923,655,268,40.916030534351144,morphological_dilation,3,2
0X184E4A64C93BE06.avi,64,1058,750,308,41.06666666666667,morphological_dilation,3,2
0X184E4A64C93BE06.avi,81,699,439,260,59.2255125284738,morphological_dilation,3,2
0X184ECC87D1A8A226.avi,209,2245,1813,432,23.827909542195254,morphological_dilation,3,2
0X184ECC87D1A8A226.avi,234,1612,1248,364,29.166666666666668,morphological_dilation,3,2
0X1855EB02B676DC2.avi,97,1897,1513,384,25.380039656311965,morphological_dilation,3,2
0X1855EB02B676DC2.avi,119,1159,855,304,35.55555555555556,morphological_dilation,3,2
0X185672E7C8FF1212.avi,4,2822,2342,480,20.495303159692572,morphological_dilation,3,2
0X185672E7C8FF1212.avi,14,2134,1702,432,25.381903642773207,morphological_dilation,3,2
0X18579C8EAEFC2713.avi,88,1747,1379,368,26.68600435097897,morphological_dilation,3,2
0X18579C8EAEFC2713.avi,105,1099,799,300,37.546933667083856,morphological_dilation,3,2
0X1858AFC9464E1463.avi,59,3154,2638,516,19.56027293404094,morphological_dilation,3,2
0X1858AFC9464E1463.avi,69,2720,2249,471,20.942641173855048,morphological_dilation,3,2
0X185A9362099F3094.avi,42,1424,1072,352,32.83582089552239,morphological_dilation,3,2
0X185A9362099F3094.avi,52,890,598,292,48.82943143812709,morphological_dilation,3,2
0X185D65EA647B5C61.avi,54,2085,1665,420,25.225225225225223,morphological_dilation,3,2
0X185D65EA647B5C61.avi,70,1246,898,348,38.75278396436526,morphological_dilation,3,2
0X18610C37F29E80E4.avi,134,1269,960,309,32.1875,morphological_dilation,3,2
0X18610C37F29E80E4.avi,148,751,499,252,50.50100200400801,morphological_dilation,3,2
0X1865C8A28648E2F0.avi,65,1902,1471,431,29.29979605710401,morphological_dilation,3,2
0X1865C8A28648E2F0.avi,81,1192,857,335,39.08984830805134,morphological_dilation,3,2
0X1865E116F085C53D.avi,32,1545,1197,348,29.07268170426065,morphological_dilation,3,2
0X1865E116F085C53D.avi,43,1376,1044,332,31.800766283524908,morphological_dilation,3,2
0X186FC3D4ED309B9E.avi,1,1583,1207,376,31.15161557580779,morphological_dilation,3,2
0X186FC3D4ED309B9E.avi,13,802,530,272,51.320754716981135,morphological_dilation,3,2
0X1870E70784D77469.avi,140,1673,1309,364,27.807486631016044,morphological_dilation,3,2
0X1870E70784D77469.avi,156,1055,755,300,39.735099337748345,morphological_dilation,3,2
0X1871B1379385763C.avi,103,3970,3418,552,16.14979520187244,morphological_dilation,3,2
0X1871B1379385763C.avi,120,3193,2689,504,18.74302714763853,morphological_dilation,3,2
0X1874F566992B7FF6.avi,52,1135,823,312,37.91008505467801,morphological_dilation,3,2
0X1874F566992B7FF6.avi,70,802,526,276,52.47148288973384,morphological_dilation,3,2
0X18752855DF343E36.avi,6,1876,1493,383,25.653047555257867,morphological_dilation,3,2
0X18752855DF343E36.avi,22,1651,1285,366,28.48249027237354,morphological_dilation,3,2
0X1876806A464A0093.avi,55,3279,2755,524,19.019963702359348,morphological_dilation,3,2
0X1876806A464A0093.avi,72,2733,2245,488,21.73719376391982,morphological_dilation,3,2
0X1878080DBC95E7FC.avi,110,2008,1576,432,27.411167512690355,morphological_dilation,3,2
0X1878080DBC95E7FC.avi,121,1261,909,352,38.72387238723872,morphological_dilation,3,2
0X187B0E5DB0E285DD.avi,132,1713,1341,372,27.740492170022375,morphological_dilation,3,2
0X187B0E5DB0E285DD.avi,152,1128,816,312,38.23529411764706,morphological_dilation,3,2
0X187EFDFCE3BEA77C.avi,56,1420,1068,352,32.958801498127336,morphological_dilation,3,2
0X187EFDFCE3BEA77C.avi,76,915,635,280,44.09448818897638,morphological_dilation,3,2
0X1880CD40F8586DBC.avi,42,2863,2363,500,21.159542953872197,morphological_dilation,3,2
0X1880CD40F8586DBC.avi,58,1855,1427,428,29.99299229152067,morphological_dilation,3,2
0X1883BBE20F1DC05D.avi,66,2711,2243,468,20.86491306286224,morphological_dilation,3,2
0X1883BBE20F1DC05D.avi,80,1569,1209,360,29.776674937965257,morphological_dilation,3,2
0X18888A4FEDCAC3AA.avi,49,1779,1407,372,26.439232409381663,morphological_dilation,3,2
0X18888A4FEDCAC3AA.avi,66,1095,791,304,38.43236409608091,morphological_dilation,3,2
0X188AFC939CDA11FC.avi,38,1802,1418,384,27.080394922425953,morphological_dilation,3,2
0X188AFC939CDA11FC.avi,58,1031,735,296,40.27210884353741,morphological_dilation,3,2
0X18916084CE523264.avi,109,1159,835,324,38.80239520958084,morphological_dilation,3,2
0X18916084CE523264.avi,122,593,357,236,66.1064425770308,morphological_dilation,3,2
0X1891E25994F489B9.avi,70,1246,930,316,33.97849462365591,morphological_dilation,3,2
0X1891E25994F489B9.avi,85,791,527,264,50.094876660341555,morphological_dilation,3,2
0X18923DCFDE784034.avi,51,1666,1310,356,27.175572519083968,morphological_dilation,3,2
0X18923DCFDE784034.avi,71,1101,793,308,38.839848675914254,morphological_dilation,3,2
0X18989A4754914D96.avi,2,2137,1697,440,25.928108426635237,morphological_dilation,3,2
0X18989A4754914D96.avi,13,1208,876,332,37.89954337899543,morphological_dilation,3,2
0X189B31C02B819CB9.avi,45,1657,1269,388,30.575256107171,morphological_dilation,3,2
0X189B31C02B819CB9.avi,62,1031,727,304,41.81568088033013,morphological_dilation,3,2
0X18A306D062D926FB.avi,3,1244,900,344,38.22222222222222,morphological_dilation,3,2
0X18A306D062D926FB.avi,26,718,427,291,68.14988290398126,morphological_dilation,3,2
0X18A467C9DDA7707A.avi,81,2186,1747,439,25.128792215226103,morphological_dilation,3,2
0X18A467C9DDA7707A.avi,96,1439,1066,373,34.990619136960596,morphological_dilation,3,2
0X18A4DD625B52E53E.avi,96,2006,1606,400,24.906600249066003,morphological_dilation,3,2
0X18A4DD625B52E53E.avi,115,1281,941,340,36.1317747077577,morphological_dilation,3,2
0X18A69B7961D01D28.avi,38,1173,845,328,38.81656804733728,morphological_dilation,3,2
0X18A69B7961D01D28.avi,53,769,485,284,58.55670103092784,morphological_dilation,3,2
0X18AB58EA130B3A90.avi,121,1464,1088,376,34.55882352941176,morphological_dilation,3,2
0X18AB58EA130B3A90.avi,133,845,553,292,52.80289330922242,morphological_dilation,3,2
0X18B3A9EB362299CF.avi,119,1760,1392,368,26.436781609195403,morphological_dilation,3,2
0X18B3A9EB362299CF.avi,136,1270,950,320,33.68421052631579,morphological_dilation,3,2
0X18B4FD6B23A94C8A.avi,3,1715,1351,364,26.94300518134715,morphological_dilation,3,2
0X18B4FD6B23A94C8A.avi,19,1134,813,321,39.48339483394834,morphological_dilation,3,2
0X18B8CD7AD450F707.avi,56,1219,895,324,36.201117318435756,morphological_dilation,3,2
0X18B8CD7AD450F707.avi,69,776,508,268,52.75590551181102,morphological_dilation,3,2
0X18B8E705314BF4C0.avi,34,2009,1589,420,26.431718061674008,morphological_dilation,3,2
0X18B8E705314BF4C0.avi,52,1329,973,356,36.58787255909558,morphological_dilation,3,2
0X18BA5512BE5D6FFA.avi,56,2662,2166,496,22.899353647276087,morphological_dilation,3,2
0X18BA5512BE5D6FFA.avi,74,1762,1350,412,30.518518518518515,morphological_dilation,3,2
0X18BFFDF053671070.avi,50,1903,1483,420,28.320971004720164,morphological_dilation,3,2
0X18BFFDF053671070.avi,66,1154,822,332,40.38929440389295,morphological_dilation,3,2
0X18C24CABDF058431.avi,81,1524,1156,368,31.833910034602077,morphological_dilation,3,2
0X18C24CABDF058431.avi,101,977,669,308,46.038863976083704,morphological_dilation,3,2
0X18C67769235E4C58.avi,37,1216,908,308,33.92070484581498,morphological_dilation,3,2
0X18C67769235E4C58.avi,55,766,500,266,53.2,morphological_dilation,3,2
0X18C711A3AC175647.avi,106,2663,2192,471,21.48722627737226,morphological_dilation,3,2
0X18C711A3AC175647.avi,126,2106,1666,440,26.410564225690276,morphological_dilation,3,2
0X18CB62C594EB4DDC.avi,4,1604,1244,360,28.938906752411576,morphological_dilation,3,2
0X18CB62C594EB4DDC.avi,15,1025,721,304,42.163661581137305,morphological_dilation,3,2
0X18CE4A36AE88A585.avi,101,2083,1683,400,23.767082590612002,morphological_dilation,3,2
0X18CE4A36AE88A585.avi,118,1402,1058,344,32.514177693761816,morphological_dilation,3,2
0X18D009E44F62FDA3.avi,52,1783,1403,380,27.084818246614397,morphological_dilation,3,2
0X18D009E44F62FDA3.avi,68,1186,878,308,35.079726651480634,morphological_dilation,3,2
0X18D12F1D70B64D0C.avi,88,2973,2457,516,21.001221001221,morphological_dilation,3,2
0X18D12F1D70B64D0C.avi,107,2079,1651,428,25.923682616596,morphological_dilation,3,2
0X18D2B28FBD7DD266.avi,73,2472,2004,468,23.353293413173652,morphological_dilation,3,2
0X18D2B28FBD7DD266.avi,101,1401,1025,376,36.68292682926829,morphological_dilation,3,2
0X18D52232BF832BA.avi,33,1547,1195,352,29.456066945606697,morphological_dilation,3,2
0X18D52232BF832BA.avi,44,927,647,280,43.27666151468315,morphological_dilation,3,2
0X18DA846E9699358F.avi,36,2113,1701,412,24.221046443268666,morphological_dilation,3,2
0X18DA846E9699358F.avi,52,1372,1028,344,33.46303501945525,morphological_dilation,3,2
0X18DF4351AAEEF3C9.avi,45,1008,703,305,43.3854907539118,morphological_dilation,3,2
0X18DF4351AAEEF3C9.avi,59,587,341,246,72.14076246334311,morphological_dilation,3,2
0X18E7B26CAD98175.avi,153,2668,2164,504,23.290203327171906,morphological_dilation,3,2
0X18E7B26CAD98175.avi,170,1607,1196,411,34.364548494983275,morphological_dilation,3,2
0X18EAA8BD773D0B43.avi,60,1540,1184,356,30.067567567567565,morphological_dilation,3,2
0X18EAA8BD773D0B43.avi,82,921,628,293,46.65605095541402,morphological_dilation,3,2
0X18EF8F4C9A35641.avi,54,1548,1184,364,30.743243243243246,morphological_dilation,3,2
0X18EF8F4C9A35641.avi,69,984,674,310,45.99406528189911,morphological_dilation,3,2
0X18FC2192952D0349.avi,56,3198,2674,524,19.596110695587136,morphological_dilation,3,2
0X18FC2192952D0349.avi,73,2004,1584,420,26.515151515151516,morphological_dilation,3,2
0X19001827BA355232.avi,85,950,672,278,41.36904761904761,morphological_dilation,3,2
0X19001827BA355232.avi,103,674,418,256,61.24401913875598,morphological_dilation,3,2
0X1902FC225A954D67.avi,34,1715,1319,396,30.022744503411676,morphological_dilation,3,2
0X1902FC225A954D67.avi,45,1150,822,328,39.90267639902677,morphological_dilation,3,2
0X190403EC57259998.avi,53,2071,1671,400,23.937761819269898,morphological_dilation,3,2
0X190403EC57259998.avi,68,1154,846,308,36.40661938534279,morphological_dilation,3,2
0X1904DC1BFE26592F.avi,48,2309,1857,452,24.340333871836293,morphological_dilation,3,2
0X1904DC1BFE26592F.avi,67,1722,1327,395,29.766390354182366,morphological_dilation,3,2
0X1905CFC5951B4F7F.avi,184,1947,1567,380,24.250159540523292,morphological_dilation,3,2
0X1905CFC5951B4F7F.avi,199,1700,1344,356,26.488095238095237,morphological_dilation,3,2
0X19063156A3F3C14E.avi,52,1944,1544,400,25.906735751295333,morphological_dilation,3,2
0X19063156A3F3C14E.avi,72,1194,846,348,41.13475177304964,morphological_dilation,3,2
0X1915042866B81B09.avi,41,1623,1251,372,29.73621103117506,morphological_dilation,3,2
0X1915042866B81B09.avi,57,1061,749,312,41.655540720961284,morphological_dilation,3,2
0X19152A7A3ABDFFBB.avi,82,1845,1433,412,28.75087229588276,morphological_dilation,3,2
0X19152A7A3ABDFFBB.avi,114,1102,773,329,42.5614489003881,morphological_dilation,3,2
0X19163DCC129B0134.avi,71,1450,1122,328,29.233511586452764,morphological_dilation,3,2
0X19163DCC129B0134.avi,86,1119,815,304,37.30061349693251,morphological_dilation,3,2
0X1917BD1A03DD500B.avi,3,1352,1016,336,33.07086614173229,morphological_dilation,3,2
0X1917BD1A03DD500B.avi,20,915,635,280,44.09448818897638,morphological_dilation,3,2
0X191A73CA019BCD1B.avi,39,2068,1648,420,25.485436893203882,morphological_dilation,3,2
0X191A73CA019BCD1B.avi,56,1328,956,372,38.912133891213394,morphological_dilation,3,2
0X191F4BD1E4262B78.avi,84,1789,1402,387,27.60342368045649,morphological_dilation,3,2
0X191F4BD1E4262B78.avi,98,1211,879,332,37.770193401592714,morphological_dilation,3,2
0X1922FC3605A29BD7.avi,42,1292,956,336,35.146443514644346,morphological_dilation,3,2
0X1922FC3605A29BD7.avi,59,813,533,280,52.5328330206379,morphological_dilation,3,2
0X192BF0F7E30FAEE2.avi,71,1525,1173,352,30.008525149190113,morphological_dilation,3,2
0X192BF0F7E30FAEE2.avi,85,999,688,311,45.20348837209303,morphological_dilation,3,2
0X192E809348BF4D86.avi,28,1475,1131,344,30.41556145004421,morphological_dilation,3,2
0X192E809348BF4D86.avi,40,891,603,288,47.76119402985074,morphological_dilation,3,2
0X19325CFA88842F2E.avi,62,1351,999,352,35.23523523523524,morphological_dilation,3,2
0X19325CFA88842F2E.avi,80,739,433,306,70.66974595842956,morphological_dilation,3,2
0X1933C9D846A59DB1.avi,134,1597,1233,364,29.521492295214923,morphological_dilation,3,2
0X1933C9D846A59DB1.avi,156,1277,938,339,36.140724946695094,morphological_dilation,3,2
0X19359F9246BB8A33.avi,58,1871,1463,408,27.8879015721121,morphological_dilation,3,2
0X19359F9246BB8A33.avi,75,1101,777,324,41.6988416988417,morphological_dilation,3,2
0X1936B58B8E1F0305.avi,61,1987,1563,424,27.12731925783749,morphological_dilation,3,2
0X1936B58B8E1F0305.avi,76,1283,941,342,36.344314558979804,morphological_dilation,3,2
0X193DAE2D1CE519CE.avi,71,3037,2525,512,20.277227722772277,morphological_dilation,3,2
0X193DAE2D1CE519CE.avi,88,2059,1647,412,25.01517911353977,morphological_dilation,3,2
0X193E071BCB23C9C3.avi,97,1395,1051,344,32.730732635585156,morphological_dilation,3,2
0X193E071BCB23C9C3.avi,110,1015,699,316,45.20743919885551,morphological_dilation,3,2
0X19467C739783524D.avi,133,2108,1696,412,24.29245283018868,morphological_dilation,3,2
0X19467C739783524D.avi,153,1237,905,332,36.68508287292818,morphological_dilation,3,2
0X19480FDA24A00E4A.avi,43,1658,1270,388,30.551181102362207,morphological_dilation,3,2
0X19480FDA24A00E4A.avi,60,1008,700,308,44.0,morphological_dilation,3,2
0X1956F412DA2FE4C6.avi,95,2526,2070,456,22.028985507246375,morphological_dilation,3,2
0X1956F412DA2FE4C6.avi,110,1570,1194,376,31.490787269681743,morphological_dilation,3,2
0X1959D1C10DEB5749.avi,59,1957,1557,400,25.690430314707775,morphological_dilation,3,2
0X1959D1C10DEB5749.avi,73,1248,924,324,35.064935064935064,morphological_dilation,3,2
0X195D3B45D8A0DB2D.avi,69,1109,825,284,34.42424242424242,morphological_dilation,3,2
0X195D3B45D8A0DB2D.avi,84,688,440,248,56.36363636363636,morphological_dilation,3,2
0X195F60292B968F31.avi,68,2287,1855,432,23.288409703504044,morphological_dilation,3,2
0X195F60292B968F31.avi,87,1328,975,353,36.205128205128204,morphological_dilation,3,2
0X196186BDD71D1431.avi,58,1887,1511,376,24.884182660489742,morphological_dilation,3,2
0X196186BDD71D1431.avi,80,1053,756,297,39.285714285714285,morphological_dilation,3,2
0X19618B8C8B4DF34B.avi,0,2123,1699,424,24.955856386109478,morphological_dilation,3,2
0X19618B8C8B4DF34B.avi,17,1194,882,312,35.374149659863946,morphological_dilation,3,2
0X1965872D32B60581.avi,43,1555,1199,356,29.69140950792327,morphological_dilation,3,2
0X1965872D32B60581.avi,58,1025,717,308,42.95676429567643,morphological_dilation,3,2
0X19661E4F455D7F61.avi,106,1616,1238,378,30.533117932148627,morphological_dilation,3,2
0X19661E4F455D7F61.avi,123,945,647,298,46.05873261205564,morphological_dilation,3,2
0X19681D039967D016.avi,49,2210,1770,440,24.858757062146893,morphological_dilation,3,2
0X19681D039967D016.avi,67,1502,1102,400,36.29764065335753,morphological_dilation,3,2
0X196C052551A4CABB.avi,52,2071,1671,400,23.937761819269898,morphological_dilation,3,2
0X196C052551A4CABB.avi,68,1333,997,336,33.70110330992979,morphological_dilation,3,2
0X196DC930B3905A7.avi,72,1970,1558,412,26.44415917843389,morphological_dilation,3,2
0X196DC930B3905A7.avi,89,1669,1285,384,29.883268482490273,morphological_dilation,3,2
0X196F26E35CDAC977.avi,49,1291,955,336,35.18324607329843,morphological_dilation,3,2
0X196F26E35CDAC977.avi,70,797,525,272,51.8095238095238,morphological_dilation,3,2
0X197084FCEC4148B9.avi,0,1283,951,332,34.910620399579386,morphological_dilation,3,2
0X197084FCEC4148B9.avi,15,835,571,264,46.234676007005255,morphological_dilation,3,2
0X1972FA470600C81E.avi,63,2963,2471,492,19.91096721974909,morphological_dilation,3,2
0X1972FA470600C81E.avi,77,2059,1631,428,26.241569589209075,morphological_dilation,3,2
0X197911F5F8F8E21C.avi,132,2003,1607,396,24.64219041692595,morphological_dilation,3,2
0X197911F5F8F8E21C.avi,142,1391,1047,344,32.855778414517665,morphological_dilation,3,2
0X197DF6A1F73E7DFC.avi,19,1279,959,320,33.36809176225234,morphological_dilation,3,2
0X197DF6A1F73E7DFC.avi,26,926,646,280,43.343653250774,morphological_dilation,3,2
0X197E4CD40A2201F5.avi,50,2173,1737,436,25.100748416810593,morphological_dilation,3,2
0X197E4CD40A2201F5.avi,66,1448,1065,383,35.96244131455399,morphological_dilation,3,2
0X19816523D8096AC8.avi,107,1886,1490,396,26.57718120805369,morphological_dilation,3,2
0X19816523D8096AC8.avi,122,1198,872,326,37.38532110091743,morphological_dilation,3,2
0X19840511812269C2.avi,44,2227,1783,444,24.901850813236116,morphological_dilation,3,2
0X19840511812269C2.avi,63,1522,1114,408,36.62477558348294,morphological_dilation,3,2
0X1985B619CF9BF669.avi,102,1854,1434,420,29.288702928870293,morphological_dilation,3,2
0X1985B619CF9BF669.avi,122,1220,860,360,41.86046511627907,morphological_dilation,3,2
0X19900411C55CBC8.avi,103,2592,2125,467,21.976470588235294,morphological_dilation,3,2
0X19900411C55CBC8.avi,120,1789,1393,396,28.427853553481697,morphological_dilation,3,2
0X1993275B5FC115CF.avi,0,2405,1981,424,21.403331650681473,morphological_dilation,3,2
0X1993275B5FC115CF.avi,15,1814,1450,364,25.103448275862068,morphological_dilation,3,2
0X199715475BB10B69.avi,83,1738,1366,372,27.232796486090777,morphological_dilation,3,2
0X199715475BB10B69.avi,100,1097,801,296,36.95380774032459,morphological_dilation,3,2
0X1999533C6100442C.avi,33,1296,964,332,34.439834024896264,morphological_dilation,3,2
0X1999533C6100442C.avi,52,810,526,284,53.99239543726235,morphological_dilation,3,2
0X199FB3987429A7B1.avi,72,1787,1391,396,28.468727534148098,morphological_dilation,3,2
0X199FB3987429A7B1.avi,100,1066,742,324,43.66576819407008,morphological_dilation,3,2
0X19A2CB675FA38526.avi,72,2324,1876,448,23.88059701492537,morphological_dilation,3,2
0X19A2CB675FA38526.avi,87,1445,1077,368,34.16898792943361,morphological_dilation,3,2
0X19A7A51DBF1CFEC6.avi,112,1767,1399,368,26.304503216583274,morphological_dilation,3,2
0X19A7A51DBF1CFEC6.avi,135,1259,943,316,33.51007423117709,morphological_dilation,3,2
0X19AC153896677B58.avi,32,2252,1824,428,23.464912280701753,morphological_dilation,3,2
0X19AC153896677B58.avi,46,1364,1016,348,34.25196850393701,morphological_dilation,3,2
0X19AC1E6345765C03.avi,0,2359,1931,428,22.16468151216986,morphological_dilation,3,2
0X19AC1E6345765C03.avi,18,1974,1578,396,25.09505703422053,morphological_dilation,3,2
0X19ACDC7E0119034A.avi,2,1375,1031,344,33.365664403491756,morphological_dilation,3,2
0X19ACDC7E0119034A.avi,16,856,576,280,48.61111111111111,morphological_dilation,3,2
0X19AD6B318F7CEFFD.avi,143,2114,1674,440,26.28434886499403,morphological_dilation,3,2
0X19AD6B318F7CEFFD.avi,158,1289,921,368,39.95656894679696,morphological_dilation,3,2
0X19B044F932C6BC6C.avi,53,1845,1473,372,25.254582484725052,morphological_dilation,3,2
0X19B044F932C6BC6C.avi,71,1098,814,284,34.88943488943489,morphological_dilation,3,2
0X19B8983673C64F6E.avi,51,1710,1346,364,27.043090638930163,morphological_dilation,3,2
0X19B8983673C64F6E.avi,62,1242,926,316,34.12526997840173,morphological_dilation,3,2
0X19B9109694DE642.avi,11,741,476,265,55.67226890756303,morphological_dilation,3,2
0X19B9109694DE642.avi,27,1110,801,309,38.57677902621723,morphological_dilation,3,2
0X19BC228D5D5F58.avi,117,2199,1768,431,24.377828054298643,morphological_dilation,3,2
0X19BC228D5D5F58.avi,137,1372,1008,364,36.11111111111111,morphological_dilation,3,2
0X19BCCFDA31770A23.avi,38,2316,1864,452,24.248927038626608,morphological_dilation,3,2
0X19BCCFDA31770A23.avi,52,1380,1016,364,35.826771653543304,morphological_dilation,3,2
0X19BDD7CE32887463.avi,47,1831,1455,376,25.841924398625434,morphological_dilation,3,2
0X19BDD7CE32887463.avi,67,1418,1059,359,33.89990557129367,morphological_dilation,3,2
0X19C391E6D353A95E.avi,99,2029,1613,416,25.79045257284563,morphological_dilation,3,2
0X19C391E6D353A95E.avi,118,1338,978,360,36.809815950920246,morphological_dilation,3,2
0X19C41F308D6663A1.avi,94,1801,1417,384,27.09950599858857,morphological_dilation,3,2
0X19C41F308D6663A1.avi,111,1072,780,292,37.43589743589744,morphological_dilation,3,2
0X19C438542B668FA.avi,84,1670,1282,388,30.265210608424336,morphological_dilation,3,2
0X19C438542B668FA.avi,104,1002,686,316,46.06413994169096,morphological_dilation,3,2
0X19CA4A53B93AFB3E.avi,0,1774,1386,388,27.994227994227995,morphological_dilation,3,2
0X19CA4A53B93AFB3E.avi,19,1146,807,339,42.00743494423792,morphological_dilation,3,2
0X19D448273C0BF59F.avi,72,1944,1540,404,26.233766233766232,morphological_dilation,3,2
0X19D448273C0BF59F.avi,92,1335,987,348,35.25835866261398,morphological_dilation,3,2
0X19D929CBB3056FCE.avi,93,1763,1384,379,27.38439306358382,morphological_dilation,3,2
0X19D929CBB3056FCE.avi,110,983,695,288,41.43884892086331,morphological_dilation,3,2
0X19DDDD5F1F429BA0.avi,28,2164,1752,412,23.515981735159816,morphological_dilation,3,2
0X19DDDD5F1F429BA0.avi,39,1531,1167,364,31.191088260497,morphological_dilation,3,2
0X19DF9461CA5F498F.avi,50,1618,1222,396,32.40589198036006,morphological_dilation,3,2
0X19DF9461CA5F498F.avi,68,949,645,304,47.13178294573643,morphological_dilation,3,2
0X19E240FFEFEBBD.avi,36,2052,1656,396,23.91304347826087,morphological_dilation,3,2
0X19E240FFEFEBBD.avi,52,1187,871,316,36.28013777267508,morphological_dilation,3,2
0X19E42A10F0077B9F.avi,45,3396,2852,544,19.074333800841515,morphological_dilation,3,2
0X19E42A10F0077B9F.avi,58,2948,2433,515,21.167283189478013,morphological_dilation,3,2
0X19E6ED76090F947D.avi,0,2235,1831,404,22.064445658110323,morphological_dilation,3,2
0X19E6ED76090F947D.avi,17,1886,1518,368,24.242424242424242,morphological_dilation,3,2
0X19E76D0B6EF68709.avi,52,1615,1235,380,30.76923076923077,morphological_dilation,3,2
0X19E76D0B6EF68709.avi,68,1251,911,340,37.32162458836443,morphological_dilation,3,2
0X19E82707BBBA6452.avi,112,1378,1042,336,32.24568138195777,morphological_dilation,3,2
0X19E82707BBBA6452.avi,132,948,660,288,43.63636363636363,morphological_dilation,3,2
0X19EA5CB11FC1BC78.avi,37,1541,1181,360,30.482641828958513,morphological_dilation,3,2
0X19EA5CB11FC1BC78.avi,50,907,615,292,47.479674796747965,morphological_dilation,3,2
0X19EC4368A6646DE8.avi,36,1351,1007,344,34.16087388282026,morphological_dilation,3,2
0X19EC4368A6646DE8.avi,49,869,585,284,48.547008547008545,morphological_dilation,3,2
0X19EDAE3C1312197A.avi,83,3347,2815,532,18.898756660746002,morphological_dilation,3,2
0X19EDAE3C1312197A.avi,96,1823,1395,428,30.681003584229387,morphological_dilation,3,2
0X19EE8D8054A106AF.avi,53,1861,1481,380,25.65833896016205,morphological_dilation,3,2
0X19EE8D8054A106AF.avi,74,1096,776,320,41.23711340206185,morphological_dilation,3,2
0X19EEE7F19EFB69DF.avi,42,1799,1427,372,26.06867554309741,morphological_dilation,3,2
0X19EEE7F19EFB69DF.avi,56,1475,1127,348,30.87843833185448,morphological_dilation,3,2
0X19F05146FAAACB83.avi,123,1736,1340,396,29.55223880597015,morphological_dilation,3,2
0X19F05146FAAACB83.avi,140,995,687,308,44.832605531295485,morphological_dilation,3,2
0X19F169BA719D9E9F.avi,99,2250,1794,456,25.418060200668897,morphological_dilation,3,2
0X19F169BA719D9E9F.avi,121,1128,796,332,41.70854271356784,morphological_dilation,3,2
0X19F41F4CC412632E.avi,48,1723,1323,400,30.234315948601665,morphological_dilation,3,2
0X19F41F4CC412632E.avi,58,1042,714,328,45.938375350140056,morphological_dilation,3,2
0X19F5F732B9ED2EC7.avi,54,1717,1337,380,28.421839940164546,morphological_dilation,3,2
0X19F5F732B9ED2EC7.avi,75,1193,853,340,39.859320046893316,morphological_dilation,3,2
0X19FD06A9BF46A803.avi,30,2027,1603,424,26.450405489706803,morphological_dilation,3,2
0X19FD06A9BF46A803.avi,51,1398,1034,364,35.20309477756286,morphological_dilation,3,2
0X1A030EFDD45062FA.avi,52,1514,1160,354,30.517241379310345,morphological_dilation,3,2
0X1A030EFDD45062FA.avi,70,1153,829,324,39.0832328106152,morphological_dilation,3,2
0X1A05829AEDF6C65.avi,3,1985,1565,420,26.837060702875398,morphological_dilation,3,2
0X1A05829AEDF6C65.avi,24,1164,825,339,41.090909090909086,morphological_dilation,3,2
0X1A05DFFFCAFB253B.avi,48,1990,1582,408,25.790139064475348,morphological_dilation,3,2
0X1A05DFFFCAFB253B.avi,68,1192,852,340,39.906103286384976,morphological_dilation,3,2
0X1A09BE7969DA1508.avi,110,2562,2090,472,22.583732057416267,morphological_dilation,3,2
0X1A09BE7969DA1508.avi,124,1462,1058,404,38.18525519848771,morphological_dilation,3,2
0X1A0A263B22CCD966.avi,72,1215,891,324,36.36363636363637,morphological_dilation,3,2
0X1A0A263B22CCD966.avi,83,735,471,264,56.05095541401274,morphological_dilation,3,2
0X1A1891A9F821324E.avi,124,1759,1375,384,27.92727272727273,morphological_dilation,3,2
0X1A1891A9F821324E.avi,140,996,699,297,42.48927038626609,morphological_dilation,3,2
0X1A193199E812B948.avi,50,1801,1409,392,27.82114975159688,morphological_dilation,3,2
0X1A193199E812B948.avi,65,1052,732,320,43.71584699453552,morphological_dilation,3,2
0X1A193A8138F4DD0F.avi,87,1256,932,324,34.763948497854074,morphological_dilation,3,2
0X1A193A8138F4DD0F.avi,107,792,519,273,52.601156069364166,morphological_dilation,3,2
0X1A2629BF0939E381.avi,39,1501,1145,356,31.09170305676856,morphological_dilation,3,2
0X1A2629BF0939E381.avi,58,914,614,300,48.85993485342019,morphological_dilation,3,2
0X1A296F5FCD5A0ED8.avi,68,1911,1515,396,26.13861386138614,morphological_dilation,3,2
0X1A296F5FCD5A0ED8.avi,80,1098,786,312,39.69465648854962,morphological_dilation,3,2
0X1A2A76BDB5B98BED.avi,63,1580,1208,372,30.79470198675497,morphological_dilation,3,2
0X1A2A76BDB5B98BED.avi,78,921,637,284,44.5839874411303,morphological_dilation,3,2
0X1A2C60147AF9FDAE.avi,46,1323,983,340,34.58799593082401,morphological_dilation,3,2
0X1A2C60147AF9FDAE.avi,62,821,561,260,46.3458110516934,morphological_dilation,3,2
0X1A2E9496910EFF5B.avi,39,1131,821,310,37.758830694275275,morphological_dilation,3,2
0X1A2E9496910EFF5B.avi,55,797,525,272,51.8095238095238,morphological_dilation,3,2
0X1A349D84388BD74B.avi,44,1500,1144,356,31.11888111888112,morphological_dilation,3,2
0X1A349D84388BD74B.avi,61,936,640,296,46.25,morphological_dilation,3,2
0X1A36AE0874972BBE.avi,40,1605,1245,360,28.915662650602407,morphological_dilation,3,2
0X1A36AE0874972BBE.avi,55,1004,712,292,41.01123595505618,morphological_dilation,3,2
0X1A3D565B371DC573.avi,152,1541,1177,364,30.92608326253186,morphological_dilation,3,2
0X1A3D565B371DC573.avi,176,1024,699,325,46.49499284692418,morphological_dilation,3,2
0X1A3E7BF1DFB132FB.avi,55,2843,2328,515,22.121993127147764,morphological_dilation,3,2
0X1A3E7BF1DFB132FB.avi,73,1522,1142,380,33.274956217162874,morphological_dilation,3,2
0X1A481BE9AE4F2DCD.avi,61,2172,1760,412,23.40909090909091,morphological_dilation,3,2
0X1A481BE9AE4F2DCD.avi,82,1204,868,336,38.70967741935484,morphological_dilation,3,2
0X1A494FC3B214947B.avi,101,2384,1930,454,23.523316062176168,morphological_dilation,3,2
0X1A494FC3B214947B.avi,114,1848,1440,408,28.333333333333332,morphological_dilation,3,2
0X1A50422240E04D03.avi,93,1503,1151,352,30.582102519548222,morphological_dilation,3,2
0X1A50422240E04D03.avi,110,991,695,296,42.589928057553955,morphological_dilation,3,2
0X1A58B506ED05C1D4.avi,66,1569,1221,348,28.501228501228503,morphological_dilation,3,2
0X1A58B506ED05C1D4.avi,88,1286,966,320,33.126293995859214,morphological_dilation,3,2
0X1A58C9DFE12C7953.avi,38,1684,1308,376,28.74617737003058,morphological_dilation,3,2
0X1A58C9DFE12C7953.avi,55,1070,758,312,41.16094986807388,morphological_dilation,3,2
0X1A5FAE3F9D37794E.avi,35,1784,1391,393,28.253055355859097,morphological_dilation,3,2
0X1A5FAE3F9D37794E.avi,48,1212,894,318,35.57046979865772,morphological_dilation,3,2
0X1A62D321A1A1821B.avi,60,2810,2322,488,21.016365202411713,morphological_dilation,3,2
0X1A62D321A1A1821B.avi,78,1840,1416,424,29.943502824858758,morphological_dilation,3,2
0X1A6699291D449F74.avi,47,1765,1373,392,28.55061908230153,morphological_dilation,3,2
0X1A6699291D449F74.avi,63,1045,741,304,41.02564102564102,morphological_dilation,3,2
0X1A6ACFE7B286DAFC.avi,124,2618,2162,456,21.091581868640148,morphological_dilation,3,2
0X1A6ACFE7B286DAFC.avi,142,1717,1337,380,28.421839940164546,morphological_dilation,3,2
0X1A75652DD11C1689.avi,54,1184,880,304,34.54545454545455,morphological_dilation,3,2
0X1A75652DD11C1689.avi,72,725,481,244,50.72765072765073,morphological_dilation,3,2
0X1A75CDAE16981DBC.avi,4,2244,1816,428,23.568281938325992,morphological_dilation,3,2
0X1A75CDAE16981DBC.avi,19,1391,1050,341,32.476190476190474,morphological_dilation,3,2
0X1A76A1A8448B456.avi,2,1494,1138,356,31.282952548330407,morphological_dilation,3,2
0X1A76A1A8448B456.avi,18,974,690,284,41.15942028985507,morphological_dilation,3,2
0X1A8797C532A3F0EF.avi,96,1252,944,308,32.6271186440678,morphological_dilation,3,2
0X1A8797C532A3F0EF.avi,107,1119,827,292,35.30834340991535,morphological_dilation,3,2
0X1A8D85542DBE8204.avi,91,2378,1918,460,23.983315954118876,morphological_dilation,3,2
0X1A8D85542DBE8204.avi,117,1609,1221,388,31.77723177723178,morphological_dilation,3,2
0X1A8F20B8BF0B4B45.avi,131,1240,912,328,35.96491228070175,morphological_dilation,3,2
0X1A8F20B8BF0B4B45.avi,146,783,505,278,55.049504950495056,morphological_dilation,3,2
0X1A970F020826E7FA.avi,100,1844,1441,403,27.966689798750867,morphological_dilation,3,2
0X1A970F020826E7FA.avi,120,1121,781,340,43.53393085787452,morphological_dilation,3,2
0X1A9827D58AC404D1.avi,60,1824,1428,396,27.73109243697479,morphological_dilation,3,2
0X1A9827D58AC404D1.avi,78,1468,1120,348,31.071428571428573,morphological_dilation,3,2
0X1A9D7251E9464D49.avi,143,1502,1154,348,30.155979202772965,morphological_dilation,3,2
0X1A9D7251E9464D49.avi,160,890,617,273,44.246353322528364,morphological_dilation,3,2
0X1AA00FE97F010F42.avi,77,2320,1872,448,23.931623931623932,morphological_dilation,3,2
0X1AA00FE97F010F42.avi,91,1469,1089,380,34.89439853076217,morphological_dilation,3,2
0X1AA2E82F7F577905.avi,56,722,470,252,53.61702127659574,morphological_dilation,3,2
0X1AA2E82F7F577905.avi,66,480,268,212,79.1044776119403,morphological_dilation,3,2
0X1AA30623C1AE4641.avi,49,2787,2291,496,21.649934526407684,morphological_dilation,3,2
0X1AA30623C1AE4641.avi,65,1546,1150,396,34.43478260869565,morphological_dilation,3,2
0X1AA5F075905B8FE9.avi,39,2652,2145,507,23.636363636363637,morphological_dilation,3,2
0X1AA5F075905B8FE9.avi,56,1656,1221,435,35.62653562653563,morphological_dilation,3,2
0X1AA6A2C3ADD3E2F1.avi,73,1584,1192,392,32.88590604026846,morphological_dilation,3,2
0X1AA6A2C3ADD3E2F1.avi,94,941,645,296,45.89147286821705,morphological_dilation,3,2
0X1AA8E4C0155A02E0.avi,44,1586,1234,352,28.52512155591572,morphological_dilation,3,2
0X1AA8E4C0155A02E0.avi,60,964,684,280,40.93567251461988,morphological_dilation,3,2
0X1AA923C15A9F0D3E.avi,28,2768,2288,480,20.97902097902098,morphological_dilation,3,2
0X1AA923C15A9F0D3E.avi,43,2386,1935,451,23.30749354005168,morphological_dilation,3,2
0X1AACBE51D95E0698.avi,26,2484,2040,444,21.764705882352942,morphological_dilation,3,2
0X1AACBE51D95E0698.avi,43,1419,1060,359,33.867924528301884,morphological_dilation,3,2
0X1AADD51FAA94E4E.avi,80,2278,1822,456,25.027442371020857,morphological_dilation,3,2
0X1AADD51FAA94E4E.avi,97,1367,999,368,36.83683683683684,morphological_dilation,3,2
0X1AB987597AF39E3B.avi,44,2236,1820,416,22.857142857142858,morphological_dilation,3,2
0X1AB987597AF39E3B.avi,63,1753,1393,360,25.843503230437904,morphological_dilation,3,2
0X1ABAD3C70E6D0F27.avi,0,1828,1460,368,25.205479452054796,morphological_dilation,3,2
0X1ABAD3C70E6D0F27.avi,12,1254,958,296,30.89770354906054,morphological_dilation,3,2
0X1ABE578AF99E8F3E.avi,45,1299,963,336,34.890965732087224,morphological_dilation,3,2
0X1ABE578AF99E8F3E.avi,58,1057,745,312,41.87919463087248,morphological_dilation,3,2
0X1ACB73BE8C1F2C0C.avi,44,1111,819,292,35.653235653235654,morphological_dilation,3,2
0X1ACB73BE8C1F2C0C.avi,53,749,485,264,54.43298969072165,morphological_dilation,3,2
0X1ACC87A912A57EDA.avi,135,1160,868,292,33.6405529953917,morphological_dilation,3,2
0X1ACC87A912A57EDA.avi,146,715,475,240,50.526315789473685,morphological_dilation,3,2
0X1AD23DC4055A4B6A.avi,29,2270,1854,416,22.43797195253506,morphological_dilation,3,2
0X1AD23DC4055A4B6A.avi,52,1391,1035,356,34.39613526570049,morphological_dilation,3,2
0X1AD3CDEC841DA50.avi,156,1394,1050,344,32.761904761904766,morphological_dilation,3,2
0X1AD3CDEC841DA50.avi,176,735,495,240,48.484848484848484,morphological_dilation,3,2
0X1ADDEA184822F38E.avi,45,2611,2105,506,24.038004750593824,morphological_dilation,3,2
0X1ADDEA184822F38E.avi,62,1733,1325,408,30.792452830188676,morphological_dilation,3,2
0X1ADEAFA4D59610C8.avi,51,1974,1586,388,24.4640605296343,morphological_dilation,3,2
0X1ADEAFA4D59610C8.avi,61,1100,784,316,40.30612244897959,morphological_dilation,3,2
0X1AE20B8AE3B5E9EF.avi,100,1819,1429,390,27.29181245626312,morphological_dilation,3,2
0X1AE20B8AE3B5E9EF.avi,118,1107,769,338,43.953185955786736,morphological_dilation,3,2
0X1AE66E51AC2B077C.avi,58,2159,1711,448,26.183518410286382,morphological_dilation,3,2
0X1AE66E51AC2B077C.avi,73,1341,971,370,38.10504634397528,morphological_dilation,3,2
0X1AE829B4D710C61B.avi,36,2700,2203,497,22.560145256468452,morphological_dilation,3,2
0X1AE829B4D710C61B.avi,54,1599,1162,437,37.607573149741825,morphological_dilation,3,2
0X1AE89E8AFB9A3EFA.avi,95,1780,1400,380,27.142857142857142,morphological_dilation,3,2
0X1AE89E8AFB9A3EFA.avi,117,1077,769,308,40.05201560468141,morphological_dilation,3,2
0X1AE9BF9AC0788D0F.avi,40,1269,949,320,33.719704952581665,morphological_dilation,3,2
0X1AE9BF9AC0788D0F.avi,54,827,537,290,54.00372439478585,morphological_dilation,3,2
0X1AEAD01BDFAB0A10.avi,0,1278,950,328,34.526315789473685,morphological_dilation,3,2
0X1AEAD01BDFAB0A10.avi,16,822,558,264,47.31182795698925,morphological_dilation,3,2
0X1AECADC95492F71D.avi,36,1790,1406,384,27.311522048364157,morphological_dilation,3,2
0X1AECADC95492F71D.avi,51,956,658,298,45.2887537993921,morphological_dilation,3,2
0X1AEE3CDCAEC1A61.avi,36,2125,1677,448,26.71437090041741,morphological_dilation,3,2
0X1AEE3CDCAEC1A61.avi,54,1395,1007,388,38.530287984111226,morphological_dilation,3,2
0X1AEE776BCC482134.avi,54,3008,2520,488,19.365079365079367,morphological_dilation,3,2
0X1AEE776BCC482134.avi,75,2590,2150,440,20.46511627906977,morphological_dilation,3,2
0X1AF21B7690DB0BCB.avi,117,1276,968,308,31.818181818181817,morphological_dilation,3,2
0X1AF21B7690DB0BCB.avi,134,817,561,256,45.632798573975045,morphological_dilation,3,2
0X1AFA6BA6C2E2132C.avi,1,2396,1925,471,24.467532467532468,morphological_dilation,3,2
0X1AFA6BA6C2E2132C.avi,30,1609,1196,413,34.531772575250834,morphological_dilation,3,2
0X1AFB0F66AC312843.avi,114,1637,1269,368,28.99921197793538,morphological_dilation,3,2
0X1AFB0F66AC312843.avi,128,1102,810,292,36.04938271604938,morphological_dilation,3,2
0X1AFEC568103E25C7.avi,49,2308,1840,468,25.43478260869565,morphological_dilation,3,2
0X1AFEC568103E25C7.avi,69,1239,883,356,40.31710079275198,morphological_dilation,3,2
0X1B000374EAD0EC4C.avi,56,1195,875,320,36.57142857142857,morphological_dilation,3,2
0X1B000374EAD0EC4C.avi,75,750,482,268,55.601659751037346,morphological_dilation,3,2
0X1B00A1770ABC7BD2.avi,117,2173,1761,412,23.39579784213515,morphological_dilation,3,2
0X1B00A1770ABC7BD2.avi,138,1859,1479,380,25.693035835023665,morphological_dilation,3,2
0X1B01EAEFBE83BEB0.avi,54,1719,1343,376,27.997021593447506,morphological_dilation,3,2
0X1B01EAEFBE83BEB0.avi,74,1108,780,328,42.05128205128205,morphological_dilation,3,2
0X1B025FF1F6B21C16.avi,59,1963,1540,423,27.467532467532468,morphological_dilation,3,2
0X1B025FF1F6B21C16.avi,79,3223,2691,532,19.769602378298032,morphological_dilation,3,2
0X1B05B56F239276F3.avi,113,1622,1262,360,28.526148969889064,morphological_dilation,3,2
0X1B05B56F239276F3.avi,125,1073,769,304,39.531859557867364,morphological_dilation,3,2
0X1B0895E4993C1F79.avi,77,1931,1519,412,27.123107307439103,morphological_dilation,3,2
0X1B0895E4993C1F79.avi,93,1259,923,336,36.403033586132175,morphological_dilation,3,2
0X1B0B2312599F9EA2.avi,3,2780,2324,456,19.62134251290878,morphological_dilation,3,2
0X1B0B2312599F9EA2.avi,22,2138,1722,416,24.15795586527294,morphological_dilation,3,2
0X1B15DFCD442A799C.avi,155,1126,830,296,35.66265060240964,morphological_dilation,3,2
0X1B15DFCD442A799C.avi,173,699,446,253,56.72645739910314,morphological_dilation,3,2
0X1B165975B5EF65D9.avi,136,1864,1488,376,25.268817204301076,morphological_dilation,3,2
0X1B165975B5EF65D9.avi,152,1393,1057,336,31.788079470198678,morphological_dilation,3,2
0X1B170168A6449950.avi,41,2029,1601,428,26.733291692692067,morphological_dilation,3,2
0X1B170168A6449950.avi,55,1358,998,360,36.07214428857716,morphological_dilation,3,2
0X1B1798BF5669FB07.avi,103,2042,1630,412,25.2760736196319,morphological_dilation,3,2
0X1B1798BF5669FB07.avi,117,1190,858,332,38.6946386946387,morphological_dilation,3,2
0X1B18BF458FEFF359.avi,52,1268,952,316,33.193277310924366,morphological_dilation,3,2
0X1B18BF458FEFF359.avi,74,829,569,260,45.69420035149385,morphological_dilation,3,2
0X1B1C20A5745C92CA.avi,45,2462,2015,447,22.18362282878412,morphological_dilation,3,2
0X1B1C20A5745C92CA.avi,63,1437,1081,356,32.932469935245145,morphological_dilation,3,2
0X1B2089E659E6AA87.avi,78,2132,1688,444,26.303317535545023,morphological_dilation,3,2
0X1B2089E659E6AA87.avi,93,1387,1003,384,38.2851445663011,morphological_dilation,3,2
0X1B2241C91CCDEF05.avi,35,1935,1547,388,25.080801551389786,morphological_dilation,3,2
0X1B2241C91CCDEF05.avi,51,1541,1193,348,29.170159262363786,morphological_dilation,3,2
0X1B25F9E969909539.avi,3,1377,1053,324,30.76923076923077,morphological_dilation,3,2
0X1B25F9E969909539.avi,13,900,632,268,42.405063291139236,morphological_dilation,3,2
0X1B281A660811E1EA.avi,92,1753,1365,388,28.424908424908423,morphological_dilation,3,2
0X1B281A660811E1EA.avi,110,1208,868,340,39.1705069124424,morphological_dilation,3,2
0X1B2900BF089AD45F.avi,74,927,651,276,42.3963133640553,morphological_dilation,3,2
0X1B2900BF089AD45F.avi,88,639,397,242,60.957178841309826,morphological_dilation,3,2
0X1B2B05C3C40B72BA.avi,82,1928,1524,404,26.509186351706038,morphological_dilation,3,2
0X1B2B05C3C40B72BA.avi,97,1065,728,337,46.291208791208796,morphological_dilation,3,2
0X1B2BCDAE290F6015.avi,5,2520,2068,452,21.8568665377176,morphological_dilation,3,2
0X1B2BCDAE290F6015.avi,30,2178,1750,428,24.45714285714286,morphological_dilation,3,2
0X1B2C915522B844C2.avi,40,1327,999,328,32.83283283283283,morphological_dilation,3,2
0X1B2C915522B844C2.avi,55,780,494,286,57.89473684210527,morphological_dilation,3,2
0X1B2E5940872E3373.avi,77,1567,1199,368,30.692243536280234,morphological_dilation,3,2
0X1B2E5940872E3373.avi,94,940,640,300,46.875,morphological_dilation,3,2
0X1B307E34A69B4030.avi,36,1610,1246,364,29.213483146067414,morphological_dilation,3,2
0X1B307E34A69B4030.avi,48,1073,777,296,38.095238095238095,morphological_dilation,3,2
0X1B30B4E3D0465503.avi,49,2579,2111,468,22.169587873045952,morphological_dilation,3,2
0X1B30B4E3D0465503.avi,64,1562,1182,380,32.14890016920474,morphological_dilation,3,2
0X1B357C0B6C82BB18.avi,157,1559,1207,352,29.16321458160729,morphological_dilation,3,2
0X1B357C0B6C82BB18.avi,176,969,683,286,41.874084919472914,morphological_dilation,3,2
0X1B379931357428C0.avi,142,1303,969,334,34.46852425180599,morphological_dilation,3,2
0X1B379931357428C0.avi,166,788,505,283,56.03960396039604,morphological_dilation,3,2
0X1B37FD032ECC5F3B.avi,55,1431,1107,324,29.268292682926827,morphological_dilation,3,2
0X1B37FD032ECC5F3B.avi,69,981,705,276,39.148936170212764,morphological_dilation,3,2
0X1B3DB601BDE717E3.avi,98,2828,2348,480,20.442930153321974,morphological_dilation,3,2
0X1B3DB601BDE717E3.avi,114,2005,1569,436,27.78840025493945,morphological_dilation,3,2
0X1B3EC325B3E2311B.avi,75,1925,1517,408,26.895187870797628,morphological_dilation,3,2
0X1B3EC325B3E2311B.avi,93,1199,843,356,42.23013048635824,morphological_dilation,3,2
0X1B3FFA6126553D43.avi,0,1590,1218,372,30.541871921182267,morphological_dilation,3,2
0X1B3FFA6126553D43.avi,15,1362,1026,336,32.748538011695906,morphological_dilation,3,2
0X1B41B8EBA3A7FCCA.avi,50,1928,1520,408,26.842105263157894,morphological_dilation,3,2
0X1B41B8EBA3A7FCCA.avi,66,1277,933,344,36.87031082529475,morphological_dilation,3,2
0X1B43F368B235BE28.avi,60,1589,1226,363,29.608482871125613,morphological_dilation,3,2
0X1B43F368B235BE28.avi,80,1109,797,312,39.146800501882055,morphological_dilation,3,2
0X1B48047F9A40121.avi,81,1943,1523,420,27.57715036112935,morphological_dilation,3,2
0X1B48047F9A40121.avi,99,1529,1157,372,32.15211754537597,morphological_dilation,3,2
0X1B4BD1E75ADB69FF.avi,117,1154,844,310,36.72985781990521,morphological_dilation,3,2
0X1B4BD1E75ADB69FF.avi,135,811,535,276,51.58878504672897,morphological_dilation,3,2
0X1B4BEF07F46727E5.avi,129,1407,1063,344,32.36124176857949,morphological_dilation,3,2
0X1B4BEF07F46727E5.avi,143,964,663,301,45.399698340874814,morphological_dilation,3,2
0X1B4F427BC662B727.avi,42,2047,1635,412,25.198776758409785,morphological_dilation,3,2
0X1B4F427BC662B727.avi,58,1429,1069,360,33.67633302151544,morphological_dilation,3,2
0X1B4F9C7AEC750887.avi,34,1552,1180,372,31.52542372881356,morphological_dilation,3,2
0X1B4F9C7AEC750887.avi,48,941,641,300,46.80187207488299,morphological_dilation,3,2
0X1B50C4EFCE4201B9.avi,38,1735,1359,376,27.66740250183959,morphological_dilation,3,2
0X1B50C4EFCE4201B9.avi,58,1039,747,292,39.08969210174029,morphological_dilation,3,2
0X1B53202748E0AB3F.avi,164,3010,2510,500,19.9203187250996,morphological_dilation,3,2
0X1B53202748E0AB3F.avi,182,2302,1858,444,23.896663078579117,morphological_dilation,3,2
0X1B54B78D0A2101E4.avi,42,1319,983,336,34.18107833163784,morphological_dilation,3,2
0X1B54B78D0A2101E4.avi,62,907,623,284,45.585874799357946,morphological_dilation,3,2
0X1B55DFD67FEA873F.avi,95,1851,1463,388,26.520847573479152,morphological_dilation,3,2
0X1B55DFD67FEA873F.avi,108,1134,810,324,40.0,morphological_dilation,3,2
0X1B5F80BEE43A4CE0.avi,128,2360,1924,436,22.66112266112266,morphological_dilation,3,2
0X1B5F80BEE43A4CE0.avi,147,1595,1247,348,27.906976744186046,morphological_dilation,3,2
0X1B6045BB53151A4A.avi,34,2048,1640,408,24.878048780487806,morphological_dilation,3,2
0X1B6045BB53151A4A.avi,48,1459,1111,348,31.323132313231323,morphological_dilation,3,2
0X1B65D8D908C385B.avi,65,1365,1013,352,34.748272458045406,morphological_dilation,3,2
0X1B65D8D908C385B.avi,82,833,549,284,51.73041894353369,morphological_dilation,3,2
0X1B68B516EEF78BA1.avi,45,1757,1385,372,26.859205776173283,morphological_dilation,3,2
0X1B68B516EEF78BA1.avi,64,1184,864,320,37.03703703703704,morphological_dilation,3,2
0X1B6A0E49BE9C0472.avi,81,2503,2015,488,24.21836228287841,morphological_dilation,3,2
0X1B6A0E49BE9C0472.avi,106,1404,1024,380,37.109375,morphological_dilation,3,2
0X1B6B465FEA68FBEA.avi,49,1710,1346,364,27.043090638930163,morphological_dilation,3,2
0X1B6B465FEA68FBEA.avi,69,1199,891,308,34.5679012345679,morphological_dilation,3,2
0X1B71C9A73CCCC8B7.avi,52,2339,1915,424,22.140992167101828,morphological_dilation,3,2
0X1B71C9A73CCCC8B7.avi,68,1959,1579,380,24.065864471184295,morphological_dilation,3,2
0X1B780BD98DA7D4D9.avi,65,1812,1448,364,25.13812154696133,morphological_dilation,3,2
0X1B780BD98DA7D4D9.avi,82,1287,975,312,32.0,morphological_dilation,3,2
0X1B7833C5A54B5FF2.avi,42,4834,4211,623,14.794585609118974,morphological_dilation,3,2
0X1B7833C5A54B5FF2.avi,60,4201,3613,588,16.274564074176585,morphological_dilation,3,2
0X1B78D94323028328.avi,46,1781,1401,380,27.123483226266952,morphological_dilation,3,2
0X1B78D94323028328.avi,65,1199,883,316,35.78708946772367,morphological_dilation,3,2
0X1B7B728C3E99A716.avi,94,1160,836,324,38.75598086124402,morphological_dilation,3,2
0X1B7B728C3E99A716.avi,106,689,417,272,65.22781774580336,morphological_dilation,3,2
0X1B7E00757AF6858B.avi,80,1467,1123,344,30.632235084594832,morphological_dilation,3,2
0X1B7E00757AF6858B.avi,98,978,699,279,39.91416309012876,morphological_dilation,3,2
0X1B7EDA7973C0A9E.avi,40,1541,1169,372,31.822070145423435,morphological_dilation,3,2
0X1B7EDA7973C0A9E.avi,56,931,637,294,46.15384615384615,morphological_dilation,3,2
0X1B861DB510984105.avi,76,3671,3115,556,17.849117174959872,morphological_dilation,3,2
0X1B861DB510984105.avi,95,1842,1404,438,31.196581196581196,morphological_dilation,3,2
0X1B86D91E09FF9EBA.avi,39,1459,1103,356,32.27561196736174,morphological_dilation,3,2
0X1B86D91E09FF9EBA.avi,51,866,574,292,50.87108013937283,morphological_dilation,3,2
0X1B8D4F0D26BB0826.avi,59,1727,1355,372,27.45387453874539,morphological_dilation,3,2
0X1B8D4F0D26BB0826.avi,78,1009,717,292,40.72524407252441,morphological_dilation,3,2
0X1B8DC2233ED16EA9.avi,72,1940,1544,396,25.647668393782386,morphological_dilation,3,2
0X1B8DC2233ED16EA9.avi,89,1296,964,332,34.439834024896264,morphological_dilation,3,2
0X1B8FD7CA891CA2CD.avi,37,2362,1938,424,21.878224974200204,morphological_dilation,3,2
0X1B8FD7CA891CA2CD.avi,52,2218,1802,416,23.085460599334073,morphological_dilation,3,2
0X1B94E05BA6E96C70.avi,54,1676,1301,375,28.823981552651805,morphological_dilation,3,2
0X1B94E05BA6E96C70.avi,76,1323,983,340,34.58799593082401,morphological_dilation,3,2
0X1BA1268DB195A3F.avi,33,1599,1247,352,28.22774659182037,morphological_dilation,3,2
0X1BA1268DB195A3F.avi,46,1374,1050,324,30.857142857142854,morphological_dilation,3,2
0X1BA265AD5BF096E5.avi,51,2090,1654,436,26.360338573155985,morphological_dilation,3,2
0X1BA265AD5BF096E5.avi,66,1666,1264,402,31.80379746835443,morphological_dilation,3,2
0X1BA53DA5F128AB92.avi,46,2538,2059,479,23.26372025254978,morphological_dilation,3,2
0X1BA53DA5F128AB92.avi,61,1754,1312,442,33.6890243902439,morphological_dilation,3,2
0X1BA556585D2FE6A7.avi,68,2799,2323,476,20.49074472664658,morphological_dilation,3,2
0X1BA556585D2FE6A7.avi,83,2129,1692,437,25.8274231678487,morphological_dilation,3,2
0X1BA619D4A0E2746.avi,90,1573,1225,348,28.408163265306126,morphological_dilation,3,2
0X1BA619D4A0E2746.avi,109,1077,773,304,39.32729624838293,morphological_dilation,3,2
0X1BA7A8147245AB28.avi,48,1976,1552,424,27.31958762886598,morphological_dilation,3,2
0X1BA7A8147245AB28.avi,66,1084,752,332,44.148936170212764,morphological_dilation,3,2
0X1BA8C753E08FB53F.avi,57,3607,3079,528,17.148424813251058,morphological_dilation,3,2
0X1BA8C753E08FB53F.avi,77,2128,1716,412,24.00932400932401,morphological_dilation,3,2
0X1BA9676E9B1FAEA7.avi,0,2196,1768,428,24.20814479638009,morphological_dilation,3,2
0X1BA9676E9B1FAEA7.avi,18,1359,999,360,36.03603603603604,morphological_dilation,3,2
0X1BACE554294DDF8.avi,37,2684,2184,500,22.893772893772894,morphological_dilation,3,2
0X1BACE554294DDF8.avi,49,1799,1387,412,29.704397981254505,morphological_dilation,3,2
0X1BB19B668CF2A22E.avi,62,3325,2805,520,18.538324420677363,morphological_dilation,3,2
0X1BB19B668CF2A22E.avi,81,2096,1676,420,25.059665871121716,morphological_dilation,3,2
0X1BB47462D0C470D5.avi,34,764,501,263,52.49500998003992,morphological_dilation,3,2
0X1BB47462D0C470D5.avi,42,480,276,204,73.91304347826086,morphological_dilation,3,2
0X1BB609E66AC34DE.avi,99,1589,1233,356,28.872668288726683,morphological_dilation,3,2
0X1BB609E66AC34DE.avi,120,889,609,280,45.97701149425287,morphological_dilation,3,2
0X1BB91877C1F2F21E.avi,42,2795,2288,507,22.15909090909091,morphological_dilation,3,2
0X1BB91877C1F2F21E.avi,59,1623,1186,437,36.846543001686335,morphological_dilation,3,2
0X1BC515434037562D.avi,33,1181,867,314,36.21683967704729,morphological_dilation,3,2
0X1BC515434037562D.avi,51,753,483,270,55.90062111801242,morphological_dilation,3,2
0X1BCA2217072BCB55.avi,152,1888,1460,428,29.315068493150687,morphological_dilation,3,2
0X1BCA2217072BCB55.avi,170,1124,796,328,41.20603015075377,morphological_dilation,3,2
0X1BCA569AEE7FCFC6.avi,51,2124,1708,416,24.355971896955502,morphological_dilation,3,2
0X1BCA569AEE7FCFC6.avi,67,1343,1011,332,32.838773491592484,morphological_dilation,3,2
0X1BCAECCA681C2F1A.avi,52,3571,3058,513,16.775670372792675,morphological_dilation,3,2
0X1BCAECCA681C2F1A.avi,79,2103,1639,464,28.30994508846858,morphological_dilation,3,2
0X1BCC6B1BA8FEBC5.avi,38,1461,1117,344,30.796777081468218,morphological_dilation,3,2
0X1BCC6B1BA8FEBC5.avi,55,977,693,284,40.98124098124098,morphological_dilation,3,2
0X1BCC9803878310C8.avi,53,1604,1240,364,29.354838709677416,morphological_dilation,3,2
0X1BCC9803878310C8.avi,72,964,660,304,46.06060606060606,morphological_dilation,3,2
0X1BCD0AD72ECB908A.avi,209,1796,1412,384,27.19546742209632,morphological_dilation,3,2
0X1BCD0AD72ECB908A.avi,238,1175,843,332,39.383155397390276,morphological_dilation,3,2
0X1BD453F455D30DEA.avi,38,1490,1102,388,35.208711433756804,morphological_dilation,3,2
0X1BD453F455D30DEA.avi,53,841,541,300,55.45286506469501,morphological_dilation,3,2
0X1BD5EEAC641B0443.avi,66,1673,1301,372,28.593389700230592,morphological_dilation,3,2
0X1BD5EEAC641B0443.avi,76,1100,764,336,43.97905759162304,morphological_dilation,3,2
0X1BD7A625C9DA5292.avi,55,892,600,292,48.66666666666667,morphological_dilation,3,2
0X1BD7A625C9DA5292.avi,68,708,448,260,58.03571428571429,morphological_dilation,3,2
0X1BDA3760E526CD15.avi,95,4094,3534,560,15.846066779852858,morphological_dilation,3,2
0X1BDA3760E526CD15.avi,110,3512,2984,528,17.694369973190348,morphological_dilation,3,2
0X1BDE353AD84F913D.avi,26,1690,1326,364,27.450980392156865,morphological_dilation,3,2
0X1BDE353AD84F913D.avi,35,991,691,300,43.41534008683068,morphological_dilation,3,2
0X1BDEEC24D5FC570C.avi,93,2422,1938,484,24.974200206398347,morphological_dilation,3,2
0X1BDEEC24D5FC570C.avi,113,1417,1049,368,35.08102955195424,morphological_dilation,3,2
0X1BE3FBED90CBC6BB.avi,69,2309,1853,456,24.608742579600648,morphological_dilation,3,2
0X1BE3FBED90CBC6BB.avi,99,3232,2704,528,19.526627218934912,morphological_dilation,3,2
0X1BE64129E54E4042.avi,73,1726,1338,388,28.998505231689087,morphological_dilation,3,2
0X1BE64129E54E4042.avi,100,1005,700,305,43.57142857142857,morphological_dilation,3,2
0X1BEA6959BDF3CC69.avi,37,1432,1090,342,31.376146788990827,morphological_dilation,3,2
0X1BEA6959BDF3CC69.avi,48,827,551,276,50.09074410163339,morphological_dilation,3,2
0X1BED31FBCDA78011.avi,0,1826,1442,384,26.629680998613036,morphological_dilation,3,2
0X1BED31FBCDA78011.avi,19,1135,815,320,39.263803680981596,morphological_dilation,3,2
0X1BF00F2E669B915E.avi,132,2936,2452,484,19.73898858075041,morphological_dilation,3,2
0X1BF00F2E669B915E.avi,149,2499,2059,440,21.369596891694997,morphological_dilation,3,2
0X1BF56B66ECD93FED.avi,47,2385,1922,463,24.0894901144641,morphological_dilation,3,2
0X1BF56B66ECD93FED.avi,61,1514,1126,388,34.4582593250444,morphological_dilation,3,2
0X1BFF8D71CA0070FF.avi,45,1831,1439,392,27.241139680333564,morphological_dilation,3,2
0X1BFF8D71CA0070FF.avi,58,1087,760,327,43.026315789473685,morphological_dilation,3,2
0X1C0BDFA4E539B43B.avi,0,1581,1220,361,29.59016393442623,morphological_dilation,3,2
0X1C0BDFA4E539B43B.avi,24,1065,747,318,42.570281124497996,morphological_dilation,3,2
0X1C12CFE9B3EC7C95.avi,99,2266,1826,440,24.096385542168676,morphological_dilation,3,2
0X1C12CFE9B3EC7C95.avi,124,1197,877,320,36.488027366020525,morphological_dilation,3,2
0X1C15B7D4A1339799.avi,57,1807,1403,404,28.79543834640057,morphological_dilation,3,2
0X1C15B7D4A1339799.avi,76,1203,875,328,37.48571428571428,morphological_dilation,3,2
0X1C1A328EA29B6CC3.avi,43,1567,1203,364,30.25768911055694,morphological_dilation,3,2
0X1C1A328EA29B6CC3.avi,60,1111,803,308,38.35616438356164,morphological_dilation,3,2
0X1C1E4272FA7678DD.avi,49,1375,1035,340,32.850241545893724,morphological_dilation,3,2
0X1C1E4272FA7678DD.avi,62,843,555,288,51.891891891891895,morphological_dilation,3,2
0X1C1F4EA2045C5402.avi,59,2018,1610,408,25.341614906832298,morphological_dilation,3,2
0X1C1F4EA2045C5402.avi,72,1431,1083,348,32.13296398891966,morphological_dilation,3,2
0X1C32622E5515DFF5.avi,124,2177,1693,484,28.588304784406375,morphological_dilation,3,2
0X1C32622E5515DFF5.avi,145,1165,744,421,56.58602150537635,morphological_dilation,3,2
0X1C33DE87BFF16258.avi,63,1740,1344,396,29.464285714285715,morphological_dilation,3,2
0X1C33DE87BFF16258.avi,87,1134,810,324,40.0,morphological_dilation,3,2
0X1C3559AB35305292.avi,118,1708,1332,376,28.22822822822823,morphological_dilation,3,2
0X1C3559AB35305292.avi,135,1012,716,296,41.340782122905026,morphological_dilation,3,2
0X1C46CC78DD272DA9.avi,38,2580,2052,528,25.730994152046783,morphological_dilation,3,2
0X1C46CC78DD272DA9.avi,53,1453,999,454,45.44544544544545,morphological_dilation,3,2
0X1C48B213563D806E.avi,34,1277,969,308,31.785345717234264,morphological_dilation,3,2
0X1C48B213563D806E.avi,48,955,683,272,39.82430453879942,morphological_dilation,3,2
0X1C4BA7E6CC226887.avi,21,1611,1227,384,31.295843520782395,morphological_dilation,3,2
0X1C4BA7E6CC226887.avi,30,925,605,320,52.892561983471076,morphological_dilation,3,2
0X1C569B8A2AA3A56B.avi,56,1519,1171,348,29.718189581554228,morphological_dilation,3,2
0X1C569B8A2AA3A56B.avi,66,1031,735,296,40.27210884353741,morphological_dilation,3,2
0X1C5B6810C6224D33.avi,54,2822,2314,508,21.9533275713051,morphological_dilation,3,2
0X1C5B6810C6224D33.avi,70,1624,1224,400,32.6797385620915,morphological_dilation,3,2
0X1C5E88A031705A5E.avi,39,2501,2041,460,22.53797158255757,morphological_dilation,3,2
0X1C5E88A031705A5E.avi,58,1409,1041,368,35.350624399615754,morphological_dilation,3,2
0X1C60E6C39540CE11.avi,113,2504,2060,444,21.553398058252426,morphological_dilation,3,2
0X1C60E6C39540CE11.avi,129,1538,1174,364,31.005110732538334,morphological_dilation,3,2
0X1C635AEB198CFFC6.avi,86,2425,1981,444,22.412922766279657,morphological_dilation,3,2
0X1C635AEB198CFFC6.avi,100,1468,1112,356,32.014388489208635,morphological_dilation,3,2
0X1C646F03E10DDA20.avi,43,1458,1094,364,33.27239488117002,morphological_dilation,3,2
0X1C646F03E10DDA20.avi,56,935,635,300,47.24409448818898,morphological_dilation,3,2
0X1C64E294328A8F14.avi,37,1598,1218,380,31.198686371100166,morphological_dilation,3,2
0X1C64E294328A8F14.avi,55,985,685,300,43.79562043795621,morphological_dilation,3,2
0X1C65E2F2670EDE62.avi,42,1555,1195,360,30.125523012552303,morphological_dilation,3,2
0X1C65E2F2670EDE62.avi,61,1142,822,320,38.929440389294406,morphological_dilation,3,2
0X1C71836EDBA989E0.avi,109,1572,1212,360,29.7029702970297,morphological_dilation,3,2
0X1C71836EDBA989E0.avi,128,1131,827,304,36.75937122128174,morphological_dilation,3,2
0X1C7404B2998743AC.avi,63,1485,1113,372,33.42318059299191,morphological_dilation,3,2
0X1C7404B2998743AC.avi,87,932,624,308,49.358974358974365,morphological_dilation,3,2
0X1C7A7B6A9AF3D511.avi,149,1470,1134,336,29.629629629629626,morphological_dilation,3,2
0X1C7A7B6A9AF3D511.avi,162,953,669,284,42.45142002989537,morphological_dilation,3,2
0X1C7C2D50F32C91CF.avi,151,1664,1300,364,28.000000000000004,morphological_dilation,3,2
0X1C7C2D50F32C91CF.avi,164,1018,714,304,42.57703081232493,morphological_dilation,3,2
0X1C7C566D4F68F6D2.avi,78,1167,851,316,37.132784958871916,morphological_dilation,3,2
0X1C7C566D4F68F6D2.avi,92,813,541,272,50.27726432532348,morphological_dilation,3,2
0X1C7D028B07255C1B.avi,45,2555,2075,480,23.132530120481928,morphological_dilation,3,2
0X1C7D028B07255C1B.avi,61,1577,1185,392,33.08016877637131,morphological_dilation,3,2
0X1C8054277A139381.avi,15,1577,1213,364,30.008244023083265,morphological_dilation,3,2
0X1C8054277A139381.avi,26,1033,729,304,41.70096021947874,morphological_dilation,3,2
0X1C82AA09A1D277E8.avi,60,1340,984,356,36.17886178861789,morphological_dilation,3,2
0X1C82AA09A1D277E8.avi,76,1029,713,316,44.31977559607293,morphological_dilation,3,2
0X1C82B217189FDD84.avi,53,1877,1493,384,25.720026791694572,morphological_dilation,3,2
0X1C82B217189FDD84.avi,73,1139,827,312,37.726723095526,morphological_dilation,3,2
0X1C84462026E440E0.avi,95,2095,1675,420,25.07462686567164,morphological_dilation,3,2
0X1C84462026E440E0.avi,112,1197,861,336,39.02439024390244,morphological_dilation,3,2
0X1C85315EEDEFF010.avi,50,1983,1571,412,26.225334182049647,morphological_dilation,3,2
0X1C85315EEDEFF010.avi,65,1283,943,340,36.05514316012725,morphological_dilation,3,2
0X1C88C00C2ED813C3.avi,193,2400,1940,460,23.711340206185564,morphological_dilation,3,2
0X1C88C00C2ED813C3.avi,208,1394,1030,364,35.33980582524272,morphological_dilation,3,2
0X1C89EE0FA8900904.avi,51,1574,1210,364,30.082644628099175,morphological_dilation,3,2
0X1C89EE0FA8900904.avi,69,1077,749,328,43.79172229639519,morphological_dilation,3,2
0X1C8A2199662FE731.avi,141,1964,1552,412,26.54639175257732,morphological_dilation,3,2
0X1C8A2199662FE731.avi,158,1299,959,340,35.45359749739312,morphological_dilation,3,2
0X1C8C0CE25970C40.avi,21,1303,987,316,32.016210739615,morphological_dilation,3,2
0X1C8C0CE25970C40.avi,34,851,591,260,43.9932318104907,morphological_dilation,3,2
0X1C9CCA2A21942E09.avi,54,1086,764,322,42.14659685863874,morphological_dilation,3,2
0X1C9CCA2A21942E09.avi,71,697,413,284,68.76513317191282,morphological_dilation,3,2
0X1C9F9EC57DDAFE0B.avi,101,2035,1623,412,25.385089340727045,morphological_dilation,3,2
0X1C9F9EC57DDAFE0B.avi,121,1264,922,342,37.093275488069416,morphological_dilation,3,2
0X1CA16A648FE49910.avi,42,1536,1188,348,29.292929292929294,morphological_dilation,3,2
0X1CA16A648FE49910.avi,58,1134,830,304,36.626506024096386,morphological_dilation,3,2
0X1CA24B09EF768629.avi,116,1531,1147,384,33.47863993025283,morphological_dilation,3,2
0X1CA24B09EF768629.avi,137,999,669,330,49.327354260089685,morphological_dilation,3,2
0X1CAD9DE1F782AF55.avi,33,1180,864,316,36.574074074074076,morphological_dilation,3,2
0X1CAD9DE1F782AF55.avi,40,681,433,248,57.27482678983834,morphological_dilation,3,2
0X1CAF8DA4E12CFBA4.avi,99,1778,1406,372,26.458036984352773,morphological_dilation,3,2
0X1CAF8DA4E12CFBA4.avi,119,1396,1060,336,31.69811320754717,morphological_dilation,3,2
0X1CB1B34B202C4041.avi,19,819,551,268,48.63883847549909,morphological_dilation,3,2
0X1CB1B34B202C4041.avi,47,1406,1054,352,33.396584440227706,morphological_dilation,3,2
0X1CB4A8300D2A3A7E.avi,0,1470,1126,344,30.550621669627,morphological_dilation,3,2
0X1CB4A8300D2A3A7E.avi,21,907,635,272,42.83464566929134,morphological_dilation,3,2
0X1CB543E7827F3A19.avi,36,1931,1520,411,27.039473684210524,morphological_dilation,3,2
0X1CB543E7827F3A19.avi,50,1362,1006,356,35.387673956262425,morphological_dilation,3,2
0X1CB789DF05D5561C.avi,91,1863,1475,388,26.305084745762713,morphological_dilation,3,2
0X1CB789DF05D5561C.avi,106,1126,814,312,38.32923832923833,morphological_dilation,3,2
0X1CB9B564C2B0F615.avi,108,1295,963,332,34.47559709241953,morphological_dilation,3,2
0X1CB9B564C2B0F615.avi,125,882,610,272,44.59016393442623,morphological_dilation,3,2
0X1CBC3578B6638C3B.avi,44,2003,1591,412,25.895663104965433,morphological_dilation,3,2
0X1CBC3578B6638C3B.avi,57,1327,971,356,36.66323377960865,morphological_dilation,3,2
0X1CBE92E8D0B12C7.avi,40,1682,1322,360,27.23146747352496,morphological_dilation,3,2
0X1CBE92E8D0B12C7.avi,57,1008,712,296,41.57303370786517,morphological_dilation,3,2
0X1CC5A2587BAEBD73.avi,144,2537,2041,496,24.301812836844682,morphological_dilation,3,2
0X1CC5A2587BAEBD73.avi,172,1519,1115,404,36.233183856502244,morphological_dilation,3,2
0X1CC8CF03024E9245.avi,102,1473,1117,356,31.87108325872874,morphological_dilation,3,2
0X1CC8CF03024E9245.avi,118,987,689,298,43.2510885341074,morphological_dilation,3,2
0X1CD114B3DED2907A.avi,134,2536,2088,448,21.455938697318008,morphological_dilation,3,2
0X1CD114B3DED2907A.avi,163,1713,1313,400,30.464584920030465,morphological_dilation,3,2
0X1CD9761078D7F70F.avi,63,1769,1389,380,27.35781137508999,morphological_dilation,3,2
0X1CD9761078D7F70F.avi,82,1153,833,320,38.41536614645859,morphological_dilation,3,2
0X1CD9AB4AB31F2DB3.avi,54,2697,2206,491,22.257479601087944,morphological_dilation,3,2
0X1CD9AB4AB31F2DB3.avi,77,1546,1178,368,31.239388794567063,morphological_dilation,3,2
0X1CDCF35D2D2D80ED.avi,62,1799,1391,408,29.331416247304098,morphological_dilation,3,2
0X1CDCF35D2D2D80ED.avi,77,1172,832,340,40.86538461538461,morphological_dilation,3,2
0X1CDD9C054D8FB60D.avi,111,2245,1829,416,22.744669218151994,morphological_dilation,3,2
0X1CDD9C054D8FB60D.avi,130,1892,1508,384,25.46419098143236,morphological_dilation,3,2
0X1CDE7FECA3A1754B.avi,0,1514,1146,368,32.11169284467714,morphological_dilation,3,2
0X1CDE7FECA3A1754B.avi,21,1084,768,316,41.14583333333333,morphological_dilation,3,2
0X1CEBFD3654DFE9D3.avi,22,3958,3382,576,17.031342400946187,morphological_dilation,3,2
0X1CEBFD3654DFE9D3.avi,33,2674,2190,484,22.100456621004565,morphological_dilation,3,2
0X1CEDB27808EA7730.avi,61,1983,1543,440,28.51587815942968,morphological_dilation,3,2
0X1CEDB27808EA7730.avi,76,1089,753,336,44.6215139442231,morphological_dilation,3,2
0X1CF4B07994B62DBB.avi,31,1574,1210,364,30.082644628099175,morphological_dilation,3,2
0X1CF4B07994B62DBB.avi,39,1557,1056,501,47.44318181818182,morphological_dilation,3,2
0X1CF55D59270F6C7.avi,42,2439,1971,468,23.74429223744292,morphological_dilation,3,2
0X1CF55D59270F6C7.avi,60,1332,964,368,38.17427385892116,morphological_dilation,3,2
0X1CF81033C527E6A3.avi,37,1372,1036,336,32.432432432432435,morphological_dilation,3,2
0X1CF81033C527E6A3.avi,49,765,513,252,49.122807017543856,morphological_dilation,3,2
0X1CF9770B0D12C750.avi,208,2205,1789,416,23.253214086081613,morphological_dilation,3,2
0X1CF9770B0D12C750.avi,239,1450,1090,360,33.02752293577982,morphological_dilation,3,2
0X1D002C3879CAE6C1.avi,73,2205,1761,444,25.2129471890971,morphological_dilation,3,2
0X1D002C3879CAE6C1.avi,85,1750,1346,404,30.0148588410104,morphological_dilation,3,2
0X1D00424C7EBCCA52.avi,50,1506,1150,356,30.956521739130434,morphological_dilation,3,2
0X1D00424C7EBCCA52.avi,67,917,629,288,45.78696343402226,morphological_dilation,3,2
0X1D026A00CF69D6B.avi,47,1544,1176,368,31.292517006802722,morphological_dilation,3,2
0X1D026A00CF69D6B.avi,55,947,639,308,48.200312989045386,morphological_dilation,3,2
0X1D04C25FA7BF8956.avi,76,1628,1276,352,27.586206896551722,morphological_dilation,3,2
0X1D04C25FA7BF8956.avi,94,1090,806,284,35.235732009925556,morphological_dilation,3,2
0X1D07317451CD15C.avi,95,2112,1704,408,23.943661971830984,morphological_dilation,3,2
0X1D07317451CD15C.avi,108,1654,1294,360,27.820710973724882,morphological_dilation,3,2
0X1D0C24D004481BF1.avi,97,1736,1376,360,26.16279069767442,morphological_dilation,3,2
0X1D0C24D004481BF1.avi,111,1202,889,313,35.20809898762655,morphological_dilation,3,2
0X1D0EE9FA3D7BAB92.avi,44,1442,1090,352,32.29357798165138,morphological_dilation,3,2
0X1D0EE9FA3D7BAB92.avi,64,963,667,296,44.377811094452774,morphological_dilation,3,2
0X1D0F905BD24A0655.avi,96,2276,1844,432,23.427331887201735,morphological_dilation,3,2
0X1D0F905BD24A0655.avi,115,1680,1280,400,31.25,morphological_dilation,3,2
0X1D15ED3F501B5ED7.avi,46,1555,1191,364,30.56255247691016,morphological_dilation,3,2
0X1D15ED3F501B5ED7.avi,60,964,668,296,44.31137724550898,morphological_dilation,3,2
0X1D181F5019010E4B.avi,26,1761,1369,392,28.634039444850256,morphological_dilation,3,2
0X1D181F5019010E4B.avi,49,1222,890,332,37.30337078651685,morphological_dilation,3,2
0X1D1827F63E2BF135.avi,89,2042,1642,400,24.3605359317905,morphological_dilation,3,2
0X1D1827F63E2BF135.avi,107,1608,1248,360,28.846153846153843,morphological_dilation,3,2
0X1D1CFF6024EE3376.avi,136,2784,2251,533,23.678365171035097,morphological_dilation,3,2
0X1D1CFF6024EE3376.avi,152,1471,1047,424,40.49665711556829,morphological_dilation,3,2
0X1D1F9CC83450E37E.avi,46,2271,1804,467,25.88691796008869,morphological_dilation,3,2
0X1D1F9CC83450E37E.avi,60,1179,832,347,41.706730769230774,morphological_dilation,3,2
0X1D20B8AA6F51A9C9.avi,53,1847,1459,388,26.593557230980124,morphological_dilation,3,2
0X1D20B8AA6F51A9C9.avi,76,1189,861,328,38.095238095238095,morphological_dilation,3,2
0X1D21C27167358D98.avi,47,1070,782,288,36.828644501278774,morphological_dilation,3,2
0X1D21C27167358D98.avi,71,717,481,236,49.064449064449065,morphological_dilation,3,2
0X1D22C277EE981F30.avi,23,1709,1349,360,26.686434395848778,morphological_dilation,3,2
0X1D22C277EE981F30.avi,32,1477,1153,324,28.10060711188205,morphological_dilation,3,2
0X1D24CEA29A24560B.avi,40,1458,1087,371,34.130634774609014,morphological_dilation,3,2
0X1D24CEA29A24560B.avi,54,920,616,304,49.35064935064935,morphological_dilation,3,2
0X1D2517EEA27B805F.avi,94,3351,2807,544,19.380121125757036,morphological_dilation,3,2
0X1D2517EEA27B805F.avi,111,2091,1667,424,25.43491301739652,morphological_dilation,3,2
0X1D26D7A594FADAA2.avi,70,2261,1813,448,24.71042471042471,morphological_dilation,3,2
0X1D26D7A594FADAA2.avi,87,1283,939,344,36.63471778487753,morphological_dilation,3,2
0X1D3210B98E59078A.avi,54,1334,994,340,34.205231388329985,morphological_dilation,3,2
0X1D3210B98E59078A.avi,68,911,611,300,49.09983633387889,morphological_dilation,3,2
0X1D393AED88F9D056.avi,57,1939,1539,400,25.99090318388564,morphological_dilation,3,2
0X1D393AED88F9D056.avi,72,1382,1048,334,31.87022900763359,morphological_dilation,3,2
0X1D3B87F45396BF74.avi,60,3334,2806,528,18.8168210976479,morphological_dilation,3,2
0X1D3B87F45396BF74.avi,73,2014,1566,448,28.607918263090674,morphological_dilation,3,2
0X1D3D82FD91F61757.avi,67,1840,1464,376,25.683060109289617,morphological_dilation,3,2
0X1D3D82FD91F61757.avi,85,1017,729,288,39.50617283950617,morphological_dilation,3,2
0X1D435EAAB297493F.avi,48,1817,1411,406,28.77391920623671,morphological_dilation,3,2
0X1D435EAAB297493F.avi,66,1100,787,313,39.7712833545108,morphological_dilation,3,2
0X1D458DED386FFD57.avi,66,2315,1855,460,24.797843665768195,morphological_dilation,3,2
0X1D458DED386FFD57.avi,81,1676,1285,391,30.428015564202333,morphological_dilation,3,2
0X1D47DAD797C08240.avi,32,2114,1702,412,24.206815511163338,morphological_dilation,3,2
0X1D47DAD797C08240.avi,45,1365,1017,348,34.21828908554572,morphological_dilation,3,2
0X1D484F34365B129A.avi,102,2403,1963,440,22.41467142129394,morphological_dilation,3,2
0X1D484F34365B129A.avi,124,1483,1123,360,32.05699020480855,morphological_dilation,3,2
0X1D531494AA297EA7.avi,58,1496,1141,355,31.113058720420682,morphological_dilation,3,2
0X1D531494AA297EA7.avi,75,965,669,296,44.24514200298953,morphological_dilation,3,2
0X1D5340ABC7E874A0.avi,3,1533,1153,380,32.95750216825672,morphological_dilation,3,2
0X1D5340ABC7E874A0.avi,15,1173,841,332,39.47681331747919,morphological_dilation,3,2
0X1D56758A76508E6B.avi,80,2345,1925,420,21.818181818181817,morphological_dilation,3,2
0X1D56758A76508E6B.avi,97,2088,1696,392,23.11320754716981,morphological_dilation,3,2
0X1D56E0444C390AAB.avi,68,2761,2281,480,21.04340201665936,morphological_dilation,3,2
0X1D56E0444C390AAB.avi,95,2240,1804,436,24.168514412416854,morphological_dilation,3,2
0X1D5C7F82BC641385.avi,63,3609,3053,556,18.211595152309204,morphological_dilation,3,2
0X1D5C7F82BC641385.avi,75,2520,2048,472,23.046875,morphological_dilation,3,2
0X1D5D36D11FB698E6.avi,89,2549,2073,476,22.961890979257117,morphological_dilation,3,2
0X1D5D36D11FB698E6.avi,112,1340,1004,336,33.46613545816733,morphological_dilation,3,2
0X1D6C97E5EE466774.avi,60,1086,794,292,36.775818639798494,morphological_dilation,3,2
0X1D6C97E5EE466774.avi,78,613,389,224,57.58354755784062,morphological_dilation,3,2
0X1D72D240D0D428E7.avi,105,1572,1232,340,27.5974025974026,morphological_dilation,3,2
0X1D72D240D0D428E7.avi,124,966,690,276,40.0,morphological_dilation,3,2
0X1D79693A227013AF.avi,81,1286,966,320,33.126293995859214,morphological_dilation,3,2
0X1D79693A227013AF.avi,89,1008,723,285,39.41908713692946,morphological_dilation,3,2
0X1D7D9F50E7714DF3.avi,81,3013,2505,508,20.27944111776447,morphological_dilation,3,2
0X1D7D9F50E7714DF3.avi,96,1889,1469,420,28.59087814840027,morphological_dilation,3,2
0X1D82C79739A0FA64.avi,57,1899,1515,384,25.346534653465348,morphological_dilation,3,2
0X1D82C79739A0FA64.avi,76,1213,905,308,34.033149171270715,morphological_dilation,3,2
0X1D855297E0E75B59.avi,36,1233,925,308,33.2972972972973,morphological_dilation,3,2
0X1D855297E0E75B59.avi,56,840,576,264,45.83333333333333,morphological_dilation,3,2
0X1D865EBAD1A947E4.avi,0,1717,1349,368,27.27946627131208,morphological_dilation,3,2
0X1D865EBAD1A947E4.avi,8,1333,1021,312,30.558276199804112,morphological_dilation,3,2
0X1D89AB9610940667.avi,105,2547,2074,473,22.806171648987466,morphological_dilation,3,2
0X1D89AB9610940667.avi,128,2039,1623,416,25.63154651879236,morphological_dilation,3,2
0X1D8AB94351A8029D.avi,0,1928,1532,396,25.848563968668408,morphological_dilation,3,2
0X1D8AB94351A8029D.avi,19,1145,833,312,37.45498199279712,morphological_dilation,3,2
0X1D8B6731487F309.avi,40,1763,1368,395,28.874269005847953,morphological_dilation,3,2
0X1D8B6731487F309.avi,57,1185,845,340,40.23668639053255,morphological_dilation,3,2
0X1D8D28801D701B6.avi,19,1524,1164,360,30.927835051546392,morphological_dilation,3,2
0X1D8D28801D701B6.avi,33,1025,721,304,42.163661581137305,morphological_dilation,3,2
0X1D903A5F71B0415B.avi,45,2026,1634,392,23.990208078335375,morphological_dilation,3,2
0X1D903A5F71B0415B.avi,61,1301,985,316,32.08121827411167,morphological_dilation,3,2
0X1D964059BBD23752.avi,78,1308,982,326,33.19755600814664,morphological_dilation,3,2
0X1D964059BBD23752.avi,94,810,554,256,46.20938628158845,morphological_dilation,3,2
0X1D97238D22053D7F.avi,112,1575,1203,372,30.92269326683292,morphological_dilation,3,2
0X1D97238D22053D7F.avi,127,1034,722,312,43.21329639889196,morphological_dilation,3,2
0X1D9BD6464304E4C1.avi,153,1862,1454,408,28.060522696011002,morphological_dilation,3,2
0X1D9BD6464304E4C1.avi,170,1112,788,324,41.11675126903553,morphological_dilation,3,2
0X1DA42DFD1ADF56A2.avi,140,2323,1879,444,23.62959020755721,morphological_dilation,3,2
0X1DA42DFD1ADF56A2.avi,158,1487,1108,379,34.205776173285194,morphological_dilation,3,2
0X1DA5AC481B10C795.avi,37,1280,964,316,32.780082987551864,morphological_dilation,3,2
0X1DA5AC481B10C795.avi,54,749,505,244,48.31683168316832,morphological_dilation,3,2
0X1DAD3979E64B1EB0.avi,46,1266,914,352,38.51203501094092,morphological_dilation,3,2
0X1DAD3979E64B1EB0.avi,60,782,502,280,55.77689243027888,morphological_dilation,3,2
0X1DAD96580464A3AE.avi,82,1670,1314,356,27.09284627092846,morphological_dilation,3,2
0X1DAD96580464A3AE.avi,97,1149,853,296,34.7010550996483,morphological_dilation,3,2
0X1DAFA784FB6CD2DC.avi,57,1510,1160,350,30.17241379310345,morphological_dilation,3,2
0X1DAFA784FB6CD2DC.avi,73,979,697,282,40.45911047345768,morphological_dilation,3,2
0X1DB488AC3583E3D6.avi,76,1292,956,336,35.146443514644346,morphological_dilation,3,2
0X1DB488AC3583E3D6.avi,88,807,518,289,55.79150579150579,morphological_dilation,3,2
0X1DBA02F07308FF4.avi,42,2707,2247,460,20.471740097908324,morphological_dilation,3,2
0X1DBA02F07308FF4.avi,62,1685,1321,364,27.554882664647995,morphological_dilation,3,2
0X1DBA0F198086D94D.avi,84,1581,1205,376,31.203319502074688,morphological_dilation,3,2
0X1DBA0F198086D94D.avi,96,1029,713,316,44.31977559607293,morphological_dilation,3,2
0X1DBC6610903DEE15.avi,39,2533,2049,484,23.621278672523182,morphological_dilation,3,2
0X1DBC6610903DEE15.avi,53,1534,1158,376,32.469775474956826,morphological_dilation,3,2
0X1DBC96AF6E04AFAE.avi,53,2307,1867,440,23.567220139260847,morphological_dilation,3,2
0X1DBC96AF6E04AFAE.avi,73,1333,993,340,34.239677744209466,morphological_dilation,3,2
0X1DBFE6B5E123C051.avi,149,2495,2049,446,21.766715470961444,morphological_dilation,3,2
0X1DBFE6B5E123C051.avi,167,2023,1627,396,24.339274738783036,morphological_dilation,3,2
0X1DC2DFB2C2B235E0.avi,76,1633,1265,368,29.09090909090909,morphological_dilation,3,2
0X1DC2DFB2C2B235E0.avi,90,1209,881,328,37.230419977298524,morphological_dilation,3,2
0X1DC37C23058344DB.avi,1,2245,1821,424,23.28390993959363,morphological_dilation,3,2
0X1DC37C23058344DB.avi,14,1441,1077,364,33.79758588672237,morphological_dilation,3,2
0X1DCA0E401C075C0B.avi,114,2507,2051,456,22.233057045343735,morphological_dilation,3,2
0X1DCA0E401C075C0B.avi,137,1648,1239,409,33.01049233252623,morphological_dilation,3,2
0X1DCB42B624F74B6A.avi,45,1404,1052,352,33.460076045627375,morphological_dilation,3,2
0X1DCB42B624F74B6A.avi,64,889,601,288,47.920133111480865,morphological_dilation,3,2
0X1DCD463A9C38E795.avi,79,1681,1293,388,30.0077339520495,morphological_dilation,3,2
0X1DCD463A9C38E795.avi,94,1093,746,347,46.51474530831099,morphological_dilation,3,2
0X1DD34527824BAE2B.avi,67,3189,2661,528,19.84216459977452,morphological_dilation,3,2
0X1DD34527824BAE2B.avi,86,1972,1536,436,28.385416666666668,morphological_dilation,3,2
0X1DD541B1AA7D27F5.avi,38,1381,1049,332,31.649189704480456,morphological_dilation,3,2
0X1DD541B1AA7D27F5.avi,50,904,620,284,45.806451612903224,morphological_dilation,3,2
0X1DD7E4C84703951C.avi,54,1838,1474,364,24.694708276797826,morphological_dilation,3,2
0X1DD7E4C84703951C.avi,73,1471,1147,324,28.247602441150825,morphological_dilation,3,2
0X1DD94B6FED393031.avi,28,1664,1304,360,27.607361963190186,morphological_dilation,3,2
0X1DD94B6FED393031.avi,47,995,707,288,40.735502121640735,morphological_dilation,3,2
0X1DDB2D8370136DF6.avi,43,955,679,276,40.6480117820324,morphological_dilation,3,2
0X1DDB2D8370136DF6.avi,58,625,389,236,60.66838046272493,morphological_dilation,3,2
0X1DE0D259C9FFED67.avi,139,1475,1103,372,33.72620126926564,morphological_dilation,3,2
0X1DE0D259C9FFED67.avi,158,897,585,312,53.333333333333336,morphological_dilation,3,2
0X1DE1700F4DDEF5AB.avi,133,1951,1559,392,25.14432328415651,morphological_dilation,3,2
0X1DE1700F4DDEF5AB.avi,150,1364,1020,344,33.72549019607843,morphological_dilation,3,2
0X1DE841B07C0641E5.avi,58,2021,1618,403,24.907292954264523,morphological_dilation,3,2
0X1DE841B07C0641E5.avi,79,1316,972,344,35.390946502057616,morphological_dilation,3,2
0X1DE88A76BA76EB42.avi,46,1817,1437,380,26.443980514961723,morphological_dilation,3,2
0X1DE88A76BA76EB42.avi,63,1235,915,320,34.97267759562842,morphological_dilation,3,2
0X1DEBBA3CCE0C4044.avi,29,1711,1351,360,26.646928201332347,morphological_dilation,3,2
0X1DEBBA3CCE0C4044.avi,44,1453,1125,328,29.15555555555556,morphological_dilation,3,2
0X1DECC0FD3CEFBBF9.avi,109,2513,2057,456,22.168206125425378,morphological_dilation,3,2
0X1DECC0FD3CEFBBF9.avi,128,1506,1130,376,33.27433628318584,morphological_dilation,3,2
0X1DEE80021337DE93.avi,130,1669,1282,387,30.187207488299535,morphological_dilation,3,2
0X1DEE80021337DE93.avi,157,810,520,290,55.769230769230774,morphological_dilation,3,2
0X1DF7163A74801695.avi,187,1302,974,328,33.67556468172484,morphological_dilation,3,2
0X1DF7163A74801695.avi,203,778,518,260,50.19305019305019,morphological_dilation,3,2
0X1DF725E212D34FF2.avi,1,1341,997,344,34.503510531594785,morphological_dilation,3,2
0X1DF725E212D34FF2.avi,14,829,565,264,46.72566371681416,morphological_dilation,3,2
0X1DF846341FD06B89.avi,2,2120,1712,408,23.83177570093458,morphological_dilation,3,2
0X1DF846341FD06B89.avi,15,1213,841,372,44.23305588585018,morphological_dilation,3,2
0X1DF8F6CF6E254FA1.avi,50,968,672,296,44.047619047619044,morphological_dilation,3,2
0X1DF8F6CF6E254FA1.avi,61,555,327,228,69.72477064220183,morphological_dilation,3,2
0X1DFB35BA6E0A7B20.avi,90,2209,1785,424,23.75350140056022,morphological_dilation,3,2
0X1DFB35BA6E0A7B20.avi,109,1433,1069,364,34.05051449953228,morphological_dilation,3,2
0X1E0132313BE50536.avi,41,1566,1214,352,28.995057660626028,morphological_dilation,3,2
0X1E0132313BE50536.avi,59,1070,778,292,37.53213367609254,morphological_dilation,3,2
0X1E042B3994B076CF.avi,43,1841,1461,380,26.00958247775496,morphological_dilation,3,2
0X1E042B3994B076CF.avi,53,1515,1160,355,30.603448275862068,morphological_dilation,3,2
0X1E0D4D57EA9C0D47.avi,42,1431,1095,336,30.684931506849317,morphological_dilation,3,2
0X1E0D4D57EA9C0D47.avi,55,934,646,288,44.58204334365325,morphological_dilation,3,2
0X1E125FF0DBDEDD8E.avi,96,2826,2330,496,21.28755364806867,morphological_dilation,3,2
0X1E125FF0DBDEDD8E.avi,113,1602,1198,404,33.7228714524207,morphological_dilation,3,2
0X1E12C1907286203F.avi,34,1562,1218,344,28.24302134646962,morphological_dilation,3,2
0X1E12C1907286203F.avi,41,1056,764,292,38.21989528795812,morphological_dilation,3,2
0X1E12EEE43FD913E5.avi,29,1320,976,344,35.24590163934426,morphological_dilation,3,2
0X1E12EEE43FD913E5.avi,42,1154,787,367,46.632782719186785,morphological_dilation,3,2
0X1E1603F30AB541CC.avi,43,1116,808,308,38.11881188118812,morphological_dilation,3,2
0X1E1603F30AB541CC.avi,58,695,431,264,61.25290023201856,morphological_dilation,3,2
0X1E19B51380EDA781.avi,94,3345,2765,580,20.976491862567812,morphological_dilation,3,2
0X1E19B51380EDA781.avi,128,1934,1483,451,30.411328388401888,morphological_dilation,3,2
0X1E1CEE4FB1052A3A.avi,99,1852,1464,388,26.50273224043716,morphological_dilation,3,2
0X1E1CEE4FB1052A3A.avi,114,1136,828,308,37.19806763285024,morphological_dilation,3,2
0X1E24B73EF1088C16.avi,40,1692,1300,392,30.153846153846153,morphological_dilation,3,2
0X1E24B73EF1088C16.avi,54,1079,747,332,44.44444444444444,morphological_dilation,3,2
0X1E254C7288E039E1.avi,85,3478,2931,547,18.66257250085295,morphological_dilation,3,2
0X1E254C7288E039E1.avi,104,2167,1688,479,28.37677725118483,morphological_dilation,3,2
0X1E2A3EA85194639F.avi,95,1559,1191,368,30.89840470193115,morphological_dilation,3,2
0X1E2A3EA85194639F.avi,104,922,630,292,46.34920634920635,morphological_dilation,3,2
0X1E319F331B8638F7.avi,79,3100,2600,500,19.230769230769234,morphological_dilation,3,2
0X1E319F331B8638F7.avi,94,1673,1285,388,30.19455252918288,morphological_dilation,3,2
0X1E3950AF8323C7C3.avi,25,995,707,288,40.735502121640735,morphological_dilation,3,2
0X1E3950AF8323C7C3.avi,34,634,410,224,54.63414634146342,morphological_dilation,3,2
0X1E3989E1CA499ADC.avi,1,2690,2234,456,20.411817367949865,morphological_dilation,3,2
0X1E3989E1CA499ADC.avi,20,1728,1344,384,28.57142857142857,morphological_dilation,3,2
0X1E41619BEA0A4042.avi,0,1202,890,312,35.056179775280896,morphological_dilation,3,2
0X1E41619BEA0A4042.avi,19,741,477,264,55.34591194968554,morphological_dilation,3,2
0X1E4214A580D40B2B.avi,46,1955,1531,424,27.694317439581972,morphological_dilation,3,2
0X1E4214A580D40B2B.avi,62,1561,1185,376,31.729957805907173,morphological_dilation,3,2
0X1E4319B75C24DB18.avi,121,1495,1139,356,31.255487269534683,morphological_dilation,3,2
0X1E4319B75C24DB18.avi,136,926,634,292,46.05678233438486,morphological_dilation,3,2
0X1E433E7966FD7332.avi,71,1396,1040,356,34.23076923076923,morphological_dilation,3,2
0X1E433E7966FD7332.avi,94,1133,813,320,39.36039360393604,morphological_dilation,3,2
0X1E4717D992CFA5F4.avi,51,1968,1592,376,23.618090452261306,morphological_dilation,3,2
0X1E4717D992CFA5F4.avi,68,1470,1142,328,28.7215411558669,morphological_dilation,3,2
0X1E4C615D9F0C3287.avi,51,1455,1099,356,32.39308462238398,morphological_dilation,3,2
0X1E4C615D9F0C3287.avi,70,916,628,288,45.85987261146497,morphological_dilation,3,2
0X1E4FB78F8BCBB9B2.avi,77,1215,887,328,36.97857948139797,morphological_dilation,3,2
0X1E4FB78F8BCBB9B2.avi,86,813,529,284,53.68620037807184,morphological_dilation,3,2
0X1E4FC262266FC8D6.avi,39,1878,1462,416,28.454172366621066,morphological_dilation,3,2
0X1E4FC262266FC8D6.avi,58,1398,1046,352,33.652007648183556,morphological_dilation,3,2
0X1E4FEF1411B063A7.avi,114,1480,1140,340,29.82456140350877,morphological_dilation,3,2
0X1E4FEF1411B063A7.avi,131,1108,808,300,37.12871287128713,morphological_dilation,3,2
0X1E50146E7EAFF53E.avi,118,1584,1240,344,27.741935483870968,morphological_dilation,3,2
0X1E50146E7EAFF53E.avi,143,1303,979,324,33.09499489274771,morphological_dilation,3,2
0X1E5364575AD6FAD4.avi,52,2362,1898,464,24.446786090621707,morphological_dilation,3,2
0X1E5364575AD6FAD4.avi,74,1671,1271,400,31.47128245476003,morphological_dilation,3,2
0X1E544C386296BE42.avi,105,1538,1170,368,31.45299145299145,morphological_dilation,3,2
0X1E544C386296BE42.avi,124,1126,814,312,38.32923832923833,morphological_dilation,3,2
0X1E5936D90E75B1A7.avi,131,1955,1527,428,28.028814669286184,morphological_dilation,3,2
0X1E5936D90E75B1A7.avi,146,1157,829,328,39.56574185765983,morphological_dilation,3,2
0X1E611525E31DDA7B.avi,61,2652,2164,488,22.55083179297597,morphological_dilation,3,2
0X1E611525E31DDA7B.avi,81,1627,1247,380,30.473135525260624,morphological_dilation,3,2
0X1E61DC4342BD6300.avi,36,1490,1138,352,30.931458699472756,morphological_dilation,3,2
0X1E61DC4342BD6300.avi,56,963,659,304,46.13050075872534,morphological_dilation,3,2
0X1E62CC48E5EF3624.avi,114,2180,1765,415,23.512747875354105,morphological_dilation,3,2
0X1E62CC48E5EF3624.avi,133,1423,1079,344,31.881371640407785,morphological_dilation,3,2
0X1E6321147D13B4BC.avi,83,3113,2593,520,20.053991515618975,morphological_dilation,3,2
0X1E6321147D13B4BC.avi,104,1740,1340,400,29.850746268656714,morphological_dilation,3,2
0X1E635D1244D8F305.avi,59,1870,1478,392,26.522327469553453,morphological_dilation,3,2
0X1E635D1244D8F305.avi,75,1110,798,312,39.097744360902254,morphological_dilation,3,2
0X1E6679C7134CBE5D.avi,90,1455,1111,344,30.96309630963096,morphological_dilation,3,2
0X1E6679C7134CBE5D.avi,111,929,641,288,44.92979719188768,morphological_dilation,3,2
0X1E67F4F64EDDA6ED.avi,30,1646,1266,380,30.01579778830964,morphological_dilation,3,2
0X1E67F4F64EDDA6ED.avi,61,1165,833,332,39.85594237695078,morphological_dilation,3,2
0X1E6815E1D578374.avi,0,2779,2303,476,20.66869300911854,morphological_dilation,3,2
0X1E6815E1D578374.avi,21,1804,1400,404,28.857142857142858,morphological_dilation,3,2
0X1E6CBE38BF082CC.avi,56,2793,2317,476,20.54380664652568,morphological_dilation,3,2
0X1E6CBE38BF082CC.avi,77,1973,1569,404,25.748884639898023,morphological_dilation,3,2
0X1E72A706170A99CF.avi,85,1511,1163,348,29.92261392949269,morphological_dilation,3,2
0X1E72A706170A99CF.avi,104,962,666,296,44.44444444444444,morphological_dilation,3,2
0X1E737062D3FC72DB.avi,56,2975,2415,560,23.18840579710145,morphological_dilation,3,2
0X1E737062D3FC72DB.avi,73,1663,1215,448,36.8724279835391,morphological_dilation,3,2
0X1E749B73E6D4B963.avi,60,1321,993,328,33.03121852970796,morphological_dilation,3,2
0X1E749B73E6D4B963.avi,79,991,711,280,39.38115330520394,morphological_dilation,3,2
0X1E761ED7D7755949.avi,99,1549,1201,348,28.975853455453787,morphological_dilation,3,2
0X1E761ED7D7755949.avi,116,951,659,292,44.30955993930198,morphological_dilation,3,2
0X1E7DD9435BBDEFC1.avi,41,2069,1620,449,27.71604938271605,morphological_dilation,3,2
0X1E7DD9435BBDEFC1.avi,60,1118,755,363,48.079470198675494,morphological_dilation,3,2
0X1E8097AF20639AFD.avi,138,1578,1222,356,29.132569558101473,morphological_dilation,3,2
0X1E8097AF20639AFD.avi,156,1132,824,308,37.37864077669903,morphological_dilation,3,2
0X1E840F388269AE5D.avi,30,2512,2060,452,21.941747572815533,morphological_dilation,3,2
0X1E840F388269AE5D.avi,46,1601,1205,396,32.863070539419084,morphological_dilation,3,2
0X1E8826D9BE12BF0D.avi,42,1477,1127,350,31.05590062111801,morphological_dilation,3,2
0X1E8826D9BE12BF0D.avi,56,1008,708,300,42.3728813559322,morphological_dilation,3,2
0X1E890CFC7E9C3E14.avi,67,1316,980,336,34.285714285714285,morphological_dilation,3,2
0X1E890CFC7E9C3E14.avi,80,894,614,280,45.60260586319218,morphological_dilation,3,2
0X1E89470188B772FB.avi,0,1902,1510,392,25.96026490066225,morphological_dilation,3,2
0X1E89470188B772FB.avi,16,1376,1034,342,33.07543520309478,morphological_dilation,3,2
0X1E8B7A7B0312AD0B.avi,38,1128,800,328,41.0,morphological_dilation,3,2
0X1E8B7A7B0312AD0B.avi,52,726,441,285,64.62585034013605,morphological_dilation,3,2
0X1E9465782E2D5B16.avi,115,2485,2013,472,23.447590660705416,morphological_dilation,3,2
0X1E9465782E2D5B16.avi,129,1567,1187,380,32.01347935973041,morphological_dilation,3,2
0X1E9C4F25D31278C7.avi,34,2293,1861,432,23.213326168726493,morphological_dilation,3,2
0X1E9C4F25D31278C7.avi,44,1335,995,340,34.17085427135678,morphological_dilation,3,2
0X1EA0FB82B5B28F2F.avi,36,2470,2026,444,21.915103652517274,morphological_dilation,3,2
0X1EA0FB82B5B28F2F.avi,51,1626,1266,360,28.436018957345972,morphological_dilation,3,2
0X1EA2B431C3A155AA.avi,53,1789,1413,376,26.610049539985848,morphological_dilation,3,2
0X1EA2B431C3A155AA.avi,71,1019,723,296,40.94052558782849,morphological_dilation,3,2
0X1EA3EC569C1E2C60.avi,55,1499,1119,380,33.958891867739055,morphological_dilation,3,2
0X1EA3EC569C1E2C60.avi,79,937,633,304,48.02527646129542,morphological_dilation,3,2
0X1EA50DD28B65A0EC.avi,52,3685,3149,536,17.02127659574468,morphological_dilation,3,2
0X1EA50DD28B65A0EC.avi,63,2372,1908,464,24.31865828092243,morphological_dilation,3,2
0X1EA6F8F85D1A8178.avi,3,1996,1581,415,26.24920936116382,morphological_dilation,3,2
0X1EA6F8F85D1A8178.avi,23,1231,877,354,40.364880273660205,morphological_dilation,3,2
0X1EA7A5960D8A5576.avi,2,3043,2543,500,19.66181675186787,morphological_dilation,3,2
0X1EA7A5960D8A5576.avi,12,1693,1297,396,30.53199691595991,morphological_dilation,3,2
0X1EA7A71E2DBC4AC0.avi,49,1921,1525,396,25.967213114754102,morphological_dilation,3,2
0X1EA7A71E2DBC4AC0.avi,72,1036,732,304,41.53005464480874,morphological_dilation,3,2
0X1EA7B071C64DA43E.avi,91,2230,1786,444,24.86002239641657,morphological_dilation,3,2
0X1EA7B071C64DA43E.avi,120,1259,911,348,38.199780461031835,morphological_dilation,3,2
0X1EAA8A2138A834E0.avi,76,1897,1465,432,29.488054607508534,morphological_dilation,3,2
0X1EAA8A2138A834E0.avi,89,1156,791,365,46.144121365360306,morphological_dilation,3,2
0X1EB543E46AF39064.avi,80,1905,1510,395,26.158940397350992,morphological_dilation,3,2
0X1EB543E46AF39064.avi,92,1118,808,310,38.366336633663366,morphological_dilation,3,2
0X1EB9E86F4FA26B5B.avi,2,2911,2419,492,20.33898305084746,morphological_dilation,3,2
0X1EB9E86F4FA26B5B.avi,20,1706,1306,400,30.627871362940272,morphological_dilation,3,2
0X1EBDE8F8E5BA979D.avi,112,2534,2074,460,22.179363548698166,morphological_dilation,3,2
0X1EBDE8F8E5BA979D.avi,134,1355,1003,352,35.09471585244267,morphological_dilation,3,2
0X1EC139D3F3A2D516.avi,42,1077,773,304,39.32729624838293,morphological_dilation,3,2
0X1EC139D3F3A2D516.avi,55,662,418,244,58.3732057416268,morphological_dilation,3,2
0X1EC55C31E1027A7D.avi,29,1577,1209,368,30.4383788254756,morphological_dilation,3,2
0X1EC55C31E1027A7D.avi,44,1078,754,324,42.97082228116711,morphological_dilation,3,2
0X1ECA00B8BAB9E432.avi,64,3205,2681,524,19.544945915703096,morphological_dilation,3,2
0X1ECA00B8BAB9E432.avi,84,2467,2015,452,22.431761786600497,morphological_dilation,3,2
0X1ECE22D7A0081047.avi,45,2597,2129,468,21.982151244715826,morphological_dilation,3,2
0X1ECE22D7A0081047.avi,64,1494,1126,368,32.682060390763766,morphological_dilation,3,2
0X1ECE8E201253DCBB.avi,49,1725,1337,388,29.020194465220644,morphological_dilation,3,2
0X1ECE8E201253DCBB.avi,68,1115,792,323,40.782828282828284,morphological_dilation,3,2
0X1ED03199B5CD723F.avi,138,1646,1266,380,30.01579778830964,morphological_dilation,3,2
0X1ED03199B5CD723F.avi,155,1000,686,314,45.77259475218659,morphological_dilation,3,2
0X1ED182EA95B3349E.avi,47,2369,1933,436,22.55561303673047,morphological_dilation,3,2
0X1ED182EA95B3349E.avi,56,1448,1096,352,32.11678832116788,morphological_dilation,3,2
0X1ED8BDD5ABC0E688.avi,109,2060,1644,416,25.304136253041364,morphological_dilation,3,2
0X1ED8BDD5ABC0E688.avi,127,1220,900,320,35.55555555555556,morphological_dilation,3,2
0X1EDA0F3F33F97A9D.avi,114,1797,1413,384,27.176220806794056,morphological_dilation,3,2
0X1EDA0F3F33F97A9D.avi,126,1430,1082,348,32.16266173752311,morphological_dilation,3,2
0X1EDC550222BB3CB7.avi,49,1516,1140,376,32.98245614035088,morphological_dilation,3,2
0X1EDC550222BB3CB7.avi,69,1015,691,324,46.888567293777136,morphological_dilation,3,2
0X1EDE39935530AE94.avi,104,1813,1418,395,27.856135401974612,morphological_dilation,3,2
0X1EDE39935530AE94.avi,124,1151,813,338,41.57441574415744,morphological_dilation,3,2
0X1EDF77660FB2302C.avi,47,2215,1779,436,24.50815064643058,morphological_dilation,3,2
0X1EDF77660FB2302C.avi,65,1847,1459,388,26.593557230980124,morphological_dilation,3,2
0X1EE30D34D1CBF56A.avi,36,1822,1442,380,26.352288488210817,morphological_dilation,3,2
0X1EE30D34D1CBF56A.avi,50,1092,788,304,38.578680203045685,morphological_dilation,3,2
0X1EE5D4C563C42FFC.avi,34,2304,1868,436,23.340471092077088,morphological_dilation,3,2
0X1EE5D4C563C42FFC.avi,47,1458,1110,348,31.351351351351354,morphological_dilation,3,2
0X1EF35FFC92F4F554.avi,246,2613,2137,476,22.27421619092185,morphological_dilation,3,2
0X1EF35FFC92F4F554.avi,287,1621,1221,400,32.76003276003276,morphological_dilation,3,2
0X1EF97820A1259D69.avi,111,1673,1305,368,28.199233716475096,morphological_dilation,3,2
0X1EF97820A1259D69.avi,129,946,666,280,42.04204204204204,morphological_dilation,3,2
0X1EFB6CCF125DF19C.avi,80,2660,2212,448,20.253164556962027,morphological_dilation,3,2
0X1EFB6CCF125DF19C.avi,101,2300,1873,427,22.797650827549386,morphological_dilation,3,2
0X1EFC35B469AE1CEC.avi,0,1746,1366,380,27.81844802342606,morphological_dilation,3,2
0X1EFC35B469AE1CEC.avi,20,1045,737,308,41.7910447761194,morphological_dilation,3,2
0X1EFF5D4EF0A8CAF8.avi,1,2109,1705,404,23.6950146627566,morphological_dilation,3,2
0X1EFF5D4EF0A8CAF8.avi,21,1807,1431,376,26.275331935709296,morphological_dilation,3,2
0X1F00CAA7AC31402B.avi,0,1489,1145,344,30.043668122270745,morphological_dilation,3,2
0X1F00CAA7AC31402B.avi,16,944,672,272,40.476190476190474,morphological_dilation,3,2
0X1F016C2C0B4EC219.avi,103,1169,851,318,37.367802585193886,morphological_dilation,3,2
0X1F016C2C0B4EC219.avi,119,807,519,288,55.49132947976878,morphological_dilation,3,2
0X1F042F557F67EF0C.avi,60,1946,1570,376,23.949044585987263,morphological_dilation,3,2
0X1F042F557F67EF0C.avi,77,1819,1323,496,37.49055177626606,morphological_dilation,3,2
0X1F0B89ADC5D08D7B.avi,32,1106,810,296,36.54320987654321,morphological_dilation,3,2
0X1F0B89ADC5D08D7B.avi,47,750,478,272,56.903765690376574,morphological_dilation,3,2
0X1F0E003D44A08AC1.avi,105,2204,1792,412,22.991071428571427,morphological_dilation,3,2
0X1F0E003D44A08AC1.avi,127,1497,1149,348,30.287206266318538,morphological_dilation,3,2
0X1F110BEB95539840.avi,45,2126,1690,436,25.79881656804734,morphological_dilation,3,2
0X1F110BEB95539840.avi,61,1318,963,355,36.863966770508824,morphological_dilation,3,2
0X1F129E3C07702D2D.avi,98,1942,1506,436,28.950863213811424,morphological_dilation,3,2
0X1F129E3C07702D2D.avi,115,1170,816,354,43.38235294117647,morphological_dilation,3,2
0X1F147D6EB6F7A33E.avi,59,1774,1374,400,29.112081513828237,morphological_dilation,3,2
0X1F147D6EB6F7A33E.avi,80,1068,749,319,42.590120160213615,morphological_dilation,3,2
0X1F16283D4711432A.avi,119,958,666,292,43.84384384384384,morphological_dilation,3,2
0X1F16283D4711432A.avi,145,1535,1179,356,30.195080576759963,morphological_dilation,3,2
0X1F167F8B80CBF9E1.avi,43,1548,1192,356,29.86577181208054,morphological_dilation,3,2
0X1F167F8B80CBF9E1.avi,59,944,664,280,42.168674698795186,morphological_dilation,3,2
0X1F19C2EE177D0051.avi,57,1244,908,336,37.00440528634361,morphological_dilation,3,2
0X1F19C2EE177D0051.avi,67,793,513,280,54.58089668615984,morphological_dilation,3,2
0X1F1B83FF55E4E8.avi,3,1515,1155,360,31.16883116883117,morphological_dilation,3,2
0X1F1B83FF55E4E8.avi,20,886,612,274,44.771241830065364,morphological_dilation,3,2
0X1F1EBF404A2CBB95.avi,96,2154,1738,416,23.935558112773304,morphological_dilation,3,2
0X1F1EBF404A2CBB95.avi,113,1883,1495,388,25.953177257525084,morphological_dilation,3,2
0X1F1FD906BE4B4E5C.avi,130,1878,1494,384,25.702811244979916,morphological_dilation,3,2
0X1F1FD906BE4B4E5C.avi,148,1542,1178,364,30.89983022071307,morphological_dilation,3,2
0X1F21C6B7573013C2.avi,102,1816,1428,388,27.170868347338935,morphological_dilation,3,2
0X1F21C6B7573013C2.avi,122,1139,823,316,38.39611178614824,morphological_dilation,3,2
0X1F22C0D0D9D6CEA7.avi,36,1653,1281,372,29.039812646370024,morphological_dilation,3,2
0X1F22C0D0D9D6CEA7.avi,53,1027,709,318,44.851904090267986,morphological_dilation,3,2
0X1F24BEDFA7735AC2.avi,43,1494,1134,360,31.746031746031743,morphological_dilation,3,2
0X1F24BEDFA7735AC2.avi,57,998,698,300,42.97994269340974,morphological_dilation,3,2
0X1F2549CEA36F670D.avi,73,1654,1296,358,27.623456790123456,morphological_dilation,3,2
0X1F2549CEA36F670D.avi,90,1026,730,296,40.54794520547945,morphological_dilation,3,2
0X1F28DD950C91E736.avi,143,1466,1118,348,31.12701252236136,morphological_dilation,3,2
0X1F28DD950C91E736.avi,158,984,700,284,40.57142857142857,morphological_dilation,3,2
0X1F295B3610D3C821.avi,73,1539,1172,367,31.313993174061434,morphological_dilation,3,2
0X1F295B3610D3C821.avi,90,1217,885,332,37.514124293785315,morphological_dilation,3,2
0X1F296AC6184AEEA2.avi,54,1662,1302,360,27.64976958525346,morphological_dilation,3,2
0X1F296AC6184AEEA2.avi,71,1075,763,312,40.89121887287025,morphological_dilation,3,2
0X1F2DF5CA165B89C1.avi,103,2555,2099,456,21.724630776560268,morphological_dilation,3,2
0X1F2DF5CA165B89C1.avi,121,1668,1280,388,30.312499999999996,morphological_dilation,3,2
0X1F30E6AC3FE50EE3.avi,52,1393,1057,336,31.788079470198678,morphological_dilation,3,2
0X1F30E6AC3FE50EE3.avi,66,945,665,280,42.10526315789473,morphological_dilation,3,2
0X1F32D3B154B596AC.avi,32,1192,819,373,45.543345543345545,morphological_dilation,3,2
0X1F32D3B154B596AC.avi,51,794,468,326,69.65811965811966,morphological_dilation,3,2
0X1F341EB2BB60BC7E.avi,39,2172,1760,412,23.40909090909091,morphological_dilation,3,2
0X1F341EB2BB60BC7E.avi,61,1272,948,324,34.177215189873415,morphological_dilation,3,2
0X1F38A18115D35B80.avi,5,1503,1147,356,31.03748910200523,morphological_dilation,3,2
0X1F38A18115D35B80.avi,29,913,617,296,47.9740680713128,morphological_dilation,3,2
0X1F3A4CF3F7A776F2.avi,44,2075,1679,396,23.5854675402025,morphological_dilation,3,2
0X1F3A4CF3F7A776F2.avi,57,1279,947,332,35.05807814149947,morphological_dilation,3,2
0X1F3FC0C8E6884E5E.avi,72,1672,1304,368,28.22085889570552,morphological_dilation,3,2
0X1F3FC0C8E6884E5E.avi,88,1002,690,312,45.21739130434783,morphological_dilation,3,2
0X1F4145A50D7D74A1.avi,38,2530,2102,428,20.361560418648907,morphological_dilation,3,2
0X1F4145A50D7D74A1.avi,47,2367,1943,424,21.82192485846629,morphological_dilation,3,2
0X1F415D2BD4F791F1.avi,58,1621,1245,376,30.200803212851408,morphological_dilation,3,2
0X1F415D2BD4F791F1.avi,75,1069,733,336,45.839017735334245,morphological_dilation,3,2
0X1F41F0CD400CE121.avi,80,2043,1603,440,27.44853399875234,morphological_dilation,3,2
0X1F41F0CD400CE121.avi,97,1198,848,350,41.27358490566038,morphological_dilation,3,2
0X1F4449F6E867C79D.avi,124,2428,1984,444,22.379032258064516,morphological_dilation,3,2
0X1F4449F6E867C79D.avi,138,1483,1123,360,32.05699020480855,morphological_dilation,3,2
0X1F5282DEF12F1522.avi,135,1931,1543,388,25.145819831497086,morphological_dilation,3,2
0X1F5282DEF12F1522.avi,151,1361,1021,340,33.30068560235064,morphological_dilation,3,2
0X1F5743D01B9FF8A7.avi,149,1417,1069,348,32.55378858746492,morphological_dilation,3,2
0X1F5743D01B9FF8A7.avi,167,1006,698,308,44.126074498567334,morphological_dilation,3,2
0X1F636F27771CFA8A.avi,0,1933,1497,436,29.124916499666,morphological_dilation,3,2
0X1F636F27771CFA8A.avi,20,1352,980,372,37.95918367346939,morphological_dilation,3,2
0X1F6E5F98F771906C.avi,63,1189,877,312,35.57582668187001,morphological_dilation,3,2
0X1F6E5F98F771906C.avi,73,746,482,264,54.77178423236515,morphological_dilation,3,2
0X1F7368994CBAFA05.avi,37,1661,1301,360,27.671022290545732,morphological_dilation,3,2
0X1F7368994CBAFA05.avi,52,1049,749,300,40.053404539385845,morphological_dilation,3,2
0X1F73F80777A9A18E.avi,119,1416,1084,332,30.627306273062732,morphological_dilation,3,2
0X1F73F80777A9A18E.avi,141,907,631,276,43.74009508716323,morphological_dilation,3,2
0X1F7426166F480035.avi,43,1239,903,336,37.2093023255814,morphological_dilation,3,2
0X1F7426166F480035.avi,62,820,544,276,50.73529411764706,morphological_dilation,3,2
0X1F76CC06470CA08E.avi,32,1481,1137,344,30.255057167985928,morphological_dilation,3,2
0X1F76CC06470CA08E.avi,49,941,657,284,43.22678843226788,morphological_dilation,3,2
0X1F7896620951FFD.avi,38,1519,1175,344,29.27659574468085,morphological_dilation,3,2
0X1F7896620951FFD.avi,60,1049,745,304,40.80536912751678,morphological_dilation,3,2
0X1F7984F85C024A44.avi,38,3573,3025,548,18.115702479338843,morphological_dilation,3,2
0X1F7984F85C024A44.avi,59,2386,1934,452,23.371251292657703,morphological_dilation,3,2
0X1F7B281D395F60DF.avi,66,1762,1374,388,28.238719068413392,morphological_dilation,3,2
0X1F7B281D395F60DF.avi,79,1285,945,340,35.978835978835974,morphological_dilation,3,2
0X1F7C341DFC185B04.avi,44,2361,1889,472,24.986765484383273,morphological_dilation,3,2
0X1F7C341DFC185B04.avi,63,1380,1016,364,35.826771653543304,morphological_dilation,3,2
0X1F89A004D9EC9D11.avi,160,3096,2572,524,20.37325038880249,morphological_dilation,3,2
0X1F89A004D9EC9D11.avi,184,2657,2181,476,21.824850985786338,morphological_dilation,3,2
0X1F8C3C7F157F3494.avi,55,2051,1635,416,25.4434250764526,morphological_dilation,3,2
0X1F8C3C7F157F3494.avi,76,1173,843,330,39.14590747330961,morphological_dilation,3,2
0X1F8D2F8CEE622FC2.avi,106,1835,1431,404,28.232005590496158,morphological_dilation,3,2
0X1F8D2F8CEE622FC2.avi,127,1190,854,336,39.34426229508197,morphological_dilation,3,2
0X1F8FD3228136CADC.avi,48,1254,934,320,34.26124197002141,morphological_dilation,3,2
0X1F8FD3228136CADC.avi,64,777,513,264,51.461988304093566,morphological_dilation,3,2
0X1F96B3B6851A691F.avi,78,2076,1676,400,23.86634844868735,morphological_dilation,3,2
0X1F96B3B6851A691F.avi,85,1845,1473,372,25.254582484725052,morphological_dilation,3,2
0X1F9747E8DFC8C33F.avi,34,2570,2102,468,22.26450999048525,morphological_dilation,3,2
0X1F9747E8DFC8C33F.avi,53,1549,1151,398,34.57862728062555,morphological_dilation,3,2
0X1F97A5C0DC538F71.avi,41,1480,1130,350,30.973451327433626,morphological_dilation,3,2
0X1F97A5C0DC538F71.avi,55,1081,753,328,43.559096945551126,morphological_dilation,3,2
0X1F97C88FCA1837FC.avi,81,3007,2507,500,19.94415636218588,morphological_dilation,3,2
0X1F97C88FCA1837FC.avi,100,2421,1970,451,22.893401015228427,morphological_dilation,3,2
0X1F984B05E47C44E8.avi,54,1841,1449,392,27.053140096618357,morphological_dilation,3,2
0X1F984B05E47C44E8.avi,75,1060,764,296,38.7434554973822,morphological_dilation,3,2
0X1F9860EB836A4AD5.avi,129,1904,1502,402,26.764314247669773,morphological_dilation,3,2
0X1F9860EB836A4AD5.avi,145,1280,922,358,38.82863340563991,morphological_dilation,3,2
0X1F9A2F0F949DA53C.avi,97,2519,2071,448,21.632061805890874,morphological_dilation,3,2
0X1F9A2F0F949DA53C.avi,114,1769,1382,387,28.002894356005786,morphological_dilation,3,2
0X1F9B2F6750598383.avi,0,1666,1306,360,27.565084226646245,morphological_dilation,3,2
0X1F9B2F6750598383.avi,16,1048,751,297,39.54727030625832,morphological_dilation,3,2
0X1F9EC90B561B66F0.avi,45,1392,1024,368,35.9375,morphological_dilation,3,2
0X1F9EC90B561B66F0.avi,60,876,560,316,56.42857142857143,morphological_dilation,3,2
0X1F9F3763AB755914.avi,35,1182,866,316,36.489607390300236,morphological_dilation,3,2
0X1F9F3763AB755914.avi,53,519,257,262,101.94552529182879,morphological_dilation,3,2
0X1F9F7D8AA7E0AD33.avi,49,1651,1263,388,30.72050673000792,morphological_dilation,3,2
0X1F9F7D8AA7E0AD33.avi,72,1032,732,300,40.98360655737705,morphological_dilation,3,2
0X1FA2FD1613FF2ABA.avi,51,2007,1607,400,24.891101431238333,morphological_dilation,3,2
0X1FA2FD1613FF2ABA.avi,74,1582,1210,372,30.74380165289256,morphological_dilation,3,2
0X1FA393110F28F205.avi,43,1277,961,316,32.882414151925076,morphological_dilation,3,2
0X1FA393110F28F205.avi,54,945,669,276,41.25560538116592,morphological_dilation,3,2
0X1FA69C9259AB1323.avi,59,1684,1304,380,29.141104294478527,morphological_dilation,3,2
0X1FA69C9259AB1323.avi,73,1184,836,348,41.62679425837321,morphological_dilation,3,2
0X1FAB4A096967CE44.avi,51,1701,1321,380,28.766086298258898,morphological_dilation,3,2
0X1FAB4A096967CE44.avi,65,1023,711,312,43.88185654008439,morphological_dilation,3,2
0X1FB746B9CC0A2C34.avi,143,1807,1424,383,26.896067415730336,morphological_dilation,3,2
0X1FB746B9CC0A2C34.avi,158,1138,824,314,38.10679611650485,morphological_dilation,3,2
0X1FB77879F86A9295.avi,108,991,699,292,41.77396280400572,morphological_dilation,3,2
0X1FB77879F86A9295.avi,129,662,410,252,61.46341463414634,morphological_dilation,3,2
0X1FB83321A4C5E14A.avi,91,1176,852,324,38.028169014084504,morphological_dilation,3,2
0X1FB83321A4C5E14A.avi,105,735,465,270,58.06451612903226,morphological_dilation,3,2
0X1FBB4B04FD21CFFD.avi,103,2785,2305,480,20.824295010845987,morphological_dilation,3,2
0X1FBB4B04FD21CFFD.avi,118,1762,1362,400,29.368575624082233,morphological_dilation,3,2
0X1FBF4879584835DC.avi,71,980,681,299,43.906020558002936,morphological_dilation,3,2
0X1FBF4879584835DC.avi,83,918,630,288,45.714285714285715,morphological_dilation,3,2
0X1FC0DB9513AAE7AE.avi,0,1906,1534,372,24.2503259452412,morphological_dilation,3,2
0X1FC0DB9513AAE7AE.avi,17,1149,857,292,34.072345390898484,morphological_dilation,3,2
0X1FC4816F238B726E.avi,49,1453,1104,349,31.61231884057971,morphological_dilation,3,2
0X1FC4816F238B726E.avi,65,1162,853,309,36.22508792497069,morphological_dilation,3,2
0X1FC8B6CD248E1EBF.avi,54,1829,1442,387,26.8377253814147,morphological_dilation,3,2
0X1FC8B6CD248E1EBF.avi,70,1142,834,308,36.930455635491604,morphological_dilation,3,2
0X1FCFC35D87A5825E.avi,29,2026,1630,396,24.294478527607364,morphological_dilation,3,2
0X1FCFC35D87A5825E.avi,43,1441,1087,354,32.56669733210671,morphological_dilation,3,2
0X1FD1C12446296002.avi,56,2489,2029,460,22.671266633809758,morphological_dilation,3,2
0X1FD1C12446296002.avi,74,2011,1580,431,27.27848101265823,morphological_dilation,3,2
0X1FD5C7765ED980E9.avi,103,1950,1542,408,26.459143968871597,morphological_dilation,3,2
0X1FD5C7765ED980E9.avi,119,1117,793,324,40.85750315258512,morphological_dilation,3,2
0X1FED7F19EE7790BC.avi,65,1294,954,340,35.63941299790356,morphological_dilation,3,2
0X1FED7F19EE7790BC.avi,76,966,665,301,45.26315789473684,morphological_dilation,3,2
0X1FEF660F1B027D9A.avi,42,1734,1343,391,29.11392405063291,morphological_dilation,3,2
0X1FEF660F1B027D9A.avi,59,1412,1039,373,35.899903753609244,morphological_dilation,3,2
0X1FF11ED3741D6CF1.avi,47,1661,1297,364,28.064764841942946,morphological_dilation,3,2
0X1FF11ED3741D6CF1.avi,68,1101,785,316,40.254777070063696,morphological_dilation,3,2
0X1FF210ABA6FAF49B.avi,58,2714,2226,488,21.92273135669362,morphological_dilation,3,2
0X1FF210ABA6FAF49B.avi,78,2035,1600,435,27.187499999999996,morphological_dilation,3,2
0X1FF2C044D2369B68.avi,59,2441,1989,452,22.724987430869785,morphological_dilation,3,2
0X1FF2C044D2369B68.avi,76,1612,1220,392,32.131147540983605,morphological_dilation,3,2
0X1FF493CD3E1F9556.avi,104,1573,1217,356,29.252259654889073,morphological_dilation,3,2
0X1FF493CD3E1F9556.avi,121,972,680,292,42.94117647058823,morphological_dilation,3,2
0X1FF49A3B7CCE0940.avi,93,2307,1871,436,23.30304649919829,morphological_dilation,3,2
0X1FF49A3B7CCE0940.avi,111,1440,1076,364,33.82899628252788,morphological_dilation,3,2
0X1FF884B7C72A46E4.avi,39,1501,1142,359,31.436077057793344,morphological_dilation,3,2
0X1FF884B7C72A46E4.avi,56,1032,740,292,39.45945945945946,morphological_dilation,3,2
0X1FF8C2A15819C013.avi,91,1494,1142,352,30.823117338003502,morphological_dilation,3,2
0X1FF8C2A15819C013.avi,106,914,626,288,46.00638977635783,morphological_dilation,3,2
0X1FF8F1B69E8A6228.avi,55,1445,1091,354,32.44729605866178,morphological_dilation,3,2
0X1FF8F1B69E8A6228.avi,73,990,678,312,46.017699115044245,morphological_dilation,3,2
0X1FFB0CA3E357AA3B.avi,135,2293,1837,456,24.82308111050626,morphological_dilation,3,2
0X1FFB0CA3E357AA3B.avi,152,1451,1099,352,32.02911737943585,morphological_dilation,3,2
0X1FFD70185CCC2352.avi,150,1730,1338,392,29.297458893871447,morphological_dilation,3,2
0X1FFD70185CCC2352.avi,171,1026,706,320,45.3257790368272,morphological_dilation,3,2
0X20044D5F4DB57EBF.avi,64,2267,1831,436,23.81212452211906,morphological_dilation,3,2
0X20044D5F4DB57EBF.avi,91,1853,1453,400,27.529249827942188,morphological_dilation,3,2
0X2006B85D0AC90B99.avi,97,3602,3038,564,18.56484529295589,morphological_dilation,3,2
0X2006B85D0AC90B99.avi,113,2206,1742,464,26.63605051664753,morphological_dilation,3,2
0X2006F373AD037FB0.avi,43,1409,1069,340,31.805425631431245,morphological_dilation,3,2
0X2006F373AD037FB0.avi,56,863,583,280,48.02744425385935,morphological_dilation,3,2
0X2007AA7BEEA8CDE9.avi,57,1713,1329,384,28.893905191873586,morphological_dilation,3,2
0X2007AA7BEEA8CDE9.avi,74,1105,773,332,42.94954721862872,morphological_dilation,3,2
0X2007E059C9C83B68.avi,59,1937,1537,400,26.024723487312944,morphological_dilation,3,2
0X2007E059C9C83B68.avi,74,1630,1254,376,29.98405103668261,morphological_dilation,3,2
0X200A81BEC98DEB6D.avi,67,1486,1126,360,31.97158081705151,morphological_dilation,3,2
0X200A81BEC98DEB6D.avi,81,1530,1032,498,48.25581395348838,morphological_dilation,3,2
0X200BAB1CBCC59B75.avi,0,2074,1670,404,24.191616766467067,morphological_dilation,3,2
0X200BAB1CBCC59B75.avi,16,1319,1003,316,31.505483549351943,morphological_dilation,3,2
0X200D2ADC0AAA7F69.avi,62,1584,1224,360,29.411764705882355,morphological_dilation,3,2
0X200D2ADC0AAA7F69.avi,78,994,702,292,41.5954415954416,morphological_dilation,3,2
0X2012F90A3894AE6C.avi,4,1655,1243,412,33.1456154465004,morphological_dilation,3,2
0X2012F90A3894AE6C.avi,16,972,656,316,48.170731707317074,morphological_dilation,3,2
0X2013A055C2ED13B1.avi,0,3577,3021,556,18.404501820589207,morphological_dilation,3,2
0X2013A055C2ED13B1.avi,18,1979,1527,452,29.60052390307793,morphological_dilation,3,2
0X2018476243B2BF60.avi,46,1909,1517,392,25.84047462096243,morphological_dilation,3,2
0X2018476243B2BF60.avi,62,1448,1112,336,30.215827338129497,morphological_dilation,3,2
0X201E550F4D45FA11.avi,42,1525,1161,364,31.352282515073217,morphological_dilation,3,2
0X201E550F4D45FA11.avi,56,995,707,288,40.735502121640735,morphological_dilation,3,2
0X20206186C27410.avi,60,1571,1199,372,31.02585487906589,morphological_dilation,3,2
0X20206186C27410.avi,79,982,658,324,49.24012158054711,morphological_dilation,3,2
0X202CB635A3F07205.avi,33,2460,2001,459,22.938530734632685,morphological_dilation,3,2
0X202CB635A3F07205.avi,49,1472,1077,395,36.67595171773444,morphological_dilation,3,2
0X20385C07ACB78AD7.avi,1,2913,2445,468,19.141104294478527,morphological_dilation,3,2
0X20385C07ACB78AD7.avi,14,1774,1398,376,26.895565092989987,morphological_dilation,3,2
0X20398152C6AC9E74.avi,95,1669,1297,372,28.681572860447186,morphological_dilation,3,2
0X20398152C6AC9E74.avi,118,1009,709,300,42.31311706629055,morphological_dilation,3,2
0X203B9F42F7B63F18.avi,52,1686,1318,368,27.921092564491655,morphological_dilation,3,2
0X203B9F42F7B63F18.avi,72,1059,755,304,40.264900662251655,morphological_dilation,3,2
0X203DEFC1AD6C4FE7.avi,50,1461,1121,340,30.33006244424621,morphological_dilation,3,2
0X203DEFC1AD6C4FE7.avi,66,962,658,304,46.20060790273556,morphological_dilation,3,2
0X2040D80BE038FF72.avi,62,1592,1224,368,30.065359477124183,morphological_dilation,3,2
0X2040D80BE038FF72.avi,71,980,668,312,46.706586826347305,morphological_dilation,3,2
0X204572836CA7223E.avi,79,2747,2243,504,22.469906375390103,morphological_dilation,3,2
0X204572836CA7223E.avi,95,1722,1310,412,31.45038167938931,morphological_dilation,3,2
0X20466440F503CA47.avi,47,1377,1021,356,34.86777668952008,morphological_dilation,3,2
0X20466440F503CA47.avi,71,941,649,292,44.99229583975347,morphological_dilation,3,2
0X2046744420463941.avi,170,1648,1288,360,27.95031055900621,morphological_dilation,3,2
0X2046744420463941.avi,186,984,682,302,44.28152492668622,morphological_dilation,3,2
0X20498F7A9EEC40.avi,147,1616,1248,368,29.48717948717949,morphological_dilation,3,2
0X20498F7A9EEC40.avi,170,1054,744,310,41.66666666666667,morphological_dilation,3,2
0X2049B43FE38C7E52.avi,41,1653,1265,388,30.67193675889328,morphological_dilation,3,2
0X2049B43FE38C7E52.avi,56,1102,778,324,41.645244215938305,morphological_dilation,3,2
0X204AE811B3916921.avi,133,1455,1107,348,31.43631436314363,morphological_dilation,3,2
0X204AE811B3916921.avi,155,1064,760,304,40.0,morphological_dilation,3,2
0X204B7002B426FB64.avi,119,1690,1306,384,29.402756508422666,morphological_dilation,3,2
0X204B7002B426FB64.avi,132,1060,738,322,43.63143631436314,morphological_dilation,3,2
0X204EABEBB4C346A7.avi,117,2109,1681,428,25.46103509815586,morphological_dilation,3,2
0X204EABEBB4C346A7.avi,133,1379,1027,352,34.27458617332035,morphological_dilation,3,2
0X20527C7266CB3D06.avi,36,1451,1119,332,29.66934763181412,morphological_dilation,3,2
0X20527C7266CB3D06.avi,51,888,616,272,44.15584415584416,morphological_dilation,3,2
0X20552C24AF1C72AA.avi,79,2088,1684,404,23.990498812351543,morphological_dilation,3,2
0X20552C24AF1C72AA.avi,99,1319,987,332,33.63728470111449,morphological_dilation,3,2
0X20586B1BD35F38C9.avi,73,819,541,278,51.386321626617374,morphological_dilation,3,2
0X20586B1BD35F38C9.avi,86,462,236,226,95.76271186440678,morphological_dilation,3,2
0X205D332D95319E52.avi,42,1858,1474,384,26.051560379918588,morphological_dilation,3,2
0X205D332D95319E52.avi,57,1303,967,336,34.74663908996898,morphological_dilation,3,2
0X205D43DE6AFEF1E3.avi,70,1690,1322,368,27.83661119515885,morphological_dilation,3,2
0X205D43DE6AFEF1E3.avi,83,1138,830,308,37.10843373493976,morphological_dilation,3,2
0X2061466F4B6FF0D6.avi,116,2091,1695,396,23.36283185840708,morphological_dilation,3,2
0X2061466F4B6FF0D6.avi,133,1227,915,312,34.0983606557377,morphological_dilation,3,2
0X2064D5C200087993.avi,71,2167,1727,440,25.477707006369428,morphological_dilation,3,2
0X2064D5C200087993.avi,81,1215,886,329,37.1331828442438,morphological_dilation,3,2
0X2067611AEB6EAC1C.avi,27,1442,1110,332,29.90990990990991,morphological_dilation,3,2
0X2067611AEB6EAC1C.avi,38,968,692,276,39.884393063583815,morphological_dilation,3,2
0X206AE6EE14B44F6D.avi,80,1089,806,283,35.111662531017366,morphological_dilation,3,2
0X206AE6EE14B44F6D.avi,93,755,503,252,50.09940357852882,morphological_dilation,3,2
0X206B9304876FB434.avi,169,1469,1093,376,34.400731930466605,morphological_dilation,3,2
0X206B9304876FB434.avi,184,956,652,304,46.62576687116564,morphological_dilation,3,2
0X206BF720DCA80EDB.avi,73,1691,1311,380,28.985507246376812,morphological_dilation,3,2
0X206BF720DCA80EDB.avi,89,973,681,292,42.87812041116006,morphological_dilation,3,2
0X20705C8B7253C987.avi,111,1377,1047,330,31.51862464183381,morphological_dilation,3,2
0X20705C8B7253C987.avi,128,939,654,285,43.57798165137615,morphological_dilation,3,2
0X2072849DEB59E522.avi,135,1626,1278,348,27.230046948356808,morphological_dilation,3,2
0X2072849DEB59E522.avi,153,1097,809,288,35.59950556242274,morphological_dilation,3,2
0X2077ABE141A56534.avi,135,2095,1699,396,23.307828134196587,morphological_dilation,3,2
0X2077ABE141A56534.avi,152,1222,906,316,34.87858719646799,morphological_dilation,3,2
0X2078B65A7DEB1F45.avi,0,2666,2218,448,20.198376916140667,morphological_dilation,3,2
0X2078B65A7DEB1F45.avi,14,1588,1228,360,29.31596091205212,morphological_dilation,3,2
0X207D62797D7ADFE5.avi,32,2640,2184,456,20.87912087912088,morphological_dilation,3,2
0X207D62797D7ADFE5.avi,46,1911,1499,412,27.484989993328885,morphological_dilation,3,2
0X208160FB0725991.avi,77,2108,1668,440,26.378896882494008,morphological_dilation,3,2
0X208160FB0725991.avi,93,1246,890,356,40.0,morphological_dilation,3,2
0X20826845F90FE6D.avi,40,3313,2741,572,20.868296242247357,morphological_dilation,3,2
0X20826845F90FE6D.avi,56,2142,1654,488,29.504232164449817,morphological_dilation,3,2
0X208440694FA7807C.avi,75,1382,1046,336,32.122370936902485,morphological_dilation,3,2
0X208440694FA7807C.avi,106,803,539,264,48.97959183673469,morphological_dilation,3,2
0X2086CBAC9AC36095.avi,46,1471,1127,344,30.523513753327418,morphological_dilation,3,2
0X2086CBAC9AC36095.avi,64,921,653,268,41.04134762633997,morphological_dilation,3,2
0X208AC63E1BFEB97F.avi,94,1980,1568,412,26.27551020408163,morphological_dilation,3,2
0X208AC63E1BFEB97F.avi,110,1204,860,344,40.0,morphological_dilation,3,2
0X208ADDBD7BDAEC00.avi,87,2014,1590,424,26.666666666666668,morphological_dilation,3,2
0X208ADDBD7BDAEC00.avi,103,1240,884,356,40.27149321266968,morphological_dilation,3,2
0X208AEA64245AEE45.avi,54,1717,1345,372,27.65799256505576,morphological_dilation,3,2
0X208AEA64245AEE45.avi,75,1110,798,312,39.097744360902254,morphological_dilation,3,2
0X208BA5FCD6556200.avi,44,2738,2226,512,23.00089847259659,morphological_dilation,3,2
0X208BA5FCD6556200.avi,66,1660,1237,423,34.19563459983832,morphological_dilation,3,2
0X208DD67A7E91CA9B.avi,45,1927,1523,404,26.526592252133945,morphological_dilation,3,2
0X208DD67A7E91CA9B.avi,63,1126,814,312,38.32923832923833,morphological_dilation,3,2
0X208F3DC503692577.avi,52,1633,1265,368,29.09090909090909,morphological_dilation,3,2
0X208F3DC503692577.avi,67,1018,714,304,42.57703081232493,morphological_dilation,3,2
0X208FBB50F39AAF69.avi,67,1045,680,365,53.67647058823529,morphological_dilation,3,2
0X208FBB50F39AAF69.avi,71,730,482,248,51.45228215767634,morphological_dilation,3,2
0X209C2DD9B266CEE0.avi,139,1391,1063,328,30.85606773283161,morphological_dilation,3,2
0X209C2DD9B266CEE0.avi,156,864,604,260,43.04635761589404,morphological_dilation,3,2
0X209D282CEC579EA7.avi,52,1685,1309,376,28.72421695951108,morphological_dilation,3,2
0X209D282CEC579EA7.avi,61,1084,757,327,43.196829590488775,morphological_dilation,3,2
0X209F758FA6ECB6BF.avi,62,1358,1022,336,32.87671232876712,morphological_dilation,3,2
0X209F758FA6ECB6BF.avi,73,887,592,295,49.83108108108108,morphological_dilation,3,2
0X20A77232EFCBBA15.avi,32,2230,1778,452,25.421822272215973,morphological_dilation,3,2
0X20A77232EFCBBA15.avi,46,1867,1455,412,28.31615120274914,morphological_dilation,3,2
0X20A9585822B9B71D.avi,107,1690,1326,364,27.450980392156865,morphological_dilation,3,2
0X20A9585822B9B71D.avi,120,948,676,272,40.23668639053255,morphological_dilation,3,2
0X20AB680B9A6201C2.avi,142,1694,1307,387,29.609793420045904,morphological_dilation,3,2
0X20AB680B9A6201C2.avi,158,1060,724,336,46.408839779005525,morphological_dilation,3,2
0X20AEF825025712FA.avi,32,1776,1376,400,29.069767441860467,morphological_dilation,3,2
0X20AEF825025712FA.avi,47,1042,718,324,45.12534818941504,morphological_dilation,3,2
0X20B431A11992F8C1.avi,121,2621,2153,468,21.737111007895958,morphological_dilation,3,2
0X20B431A11992F8C1.avi,139,1464,1108,356,32.12996389891697,morphological_dilation,3,2
0X20BA6E6EAB935FF.avi,46,1592,1212,380,31.353135313531354,morphological_dilation,3,2
0X20BA6E6EAB935FF.avi,62,920,620,300,48.38709677419355,morphological_dilation,3,2
0X20BF40D7DF972197.avi,55,1730,1346,384,28.52897473997028,morphological_dilation,3,2
0X20BF40D7DF972197.avi,72,1418,1086,332,30.570902394106813,morphological_dilation,3,2
0X20C138B0C280E0E8.avi,44,2046,1634,412,25.21419828641371,morphological_dilation,3,2
0X20C138B0C280E0E8.avi,59,1175,875,300,34.285714285714285,morphological_dilation,3,2
0X20C397F012441121.avi,49,2720,2232,488,21.863799283154123,morphological_dilation,3,2
0X20C397F012441121.avi,66,2001,1569,432,27.533460803059274,morphological_dilation,3,2
0X20C66395A83A2333.avi,0,1240,936,304,32.47863247863248,morphological_dilation,3,2
0X20C66395A83A2333.avi,14,860,596,264,44.29530201342282,morphological_dilation,3,2
0X20C709BA520B3393.avi,50,1112,828,284,34.29951690821256,morphological_dilation,3,2
0X20C709BA520B3393.avi,65,903,643,260,40.43545878693624,morphological_dilation,3,2
0X20C87FB09C5485FA.avi,89,2815,2315,500,21.598272138228943,morphological_dilation,3,2
0X20C87FB09C5485FA.avi,109,1864,1472,392,26.6304347826087,morphological_dilation,3,2
0X20DC0F2BB24C0B14.avi,167,1542,1182,360,30.456852791878177,morphological_dilation,3,2
0X20DC0F2BB24C0B14.avi,187,969,657,312,47.48858447488584,morphological_dilation,3,2
0X20E2EEBED55F4D49.avi,42,1589,1237,352,28.455941794664515,morphological_dilation,3,2
0X20E2EEBED55F4D49.avi,57,1050,758,292,38.522427440633244,morphological_dilation,3,2
0X20E888D4879745B8.avi,58,2494,2054,440,21.421616358325217,morphological_dilation,3,2
0X20E888D4879745B8.avi,73,1380,1032,348,33.72093023255814,morphological_dilation,3,2
0X20EF6DD108D6DBEF.avi,62,759,511,248,48.53228962818004,morphological_dilation,3,2
0X20EF6DD108D6DBEF.avi,81,1169,865,304,35.14450867052023,morphological_dilation,3,2
0X20F0ECA9A407E292.avi,128,2820,2312,508,21.972318339100347,morphological_dilation,3,2
0X20F0ECA9A407E292.avi,143,1584,1184,400,33.78378378378378,morphological_dilation,3,2
0X20F33082C8E339A5.avi,65,1743,1351,392,29.015544041450774,morphological_dilation,3,2
0X20F33082C8E339A5.avi,81,1096,748,348,46.524064171122994,morphological_dilation,3,2
0X20F3D05837705ED2.avi,60,1960,1564,396,25.31969309462916,morphological_dilation,3,2
0X20F3D05837705ED2.avi,72,1640,1284,356,27.725856697819314,morphological_dilation,3,2
0X20F915FF0D48F7B1.avi,111,1722,1334,388,29.08545727136432,morphological_dilation,3,2
0X20F915FF0D48F7B1.avi,127,952,652,300,46.012269938650306,morphological_dilation,3,2
0X20FA1B615696ED4E.avi,48,1366,1000,366,36.6,morphological_dilation,3,2
0X20FA1B615696ED4E.avi,66,850,547,303,55.393053016453386,morphological_dilation,3,2
0X20FAB502219482F3.avi,51,1777,1405,372,26.476868327402137,morphological_dilation,3,2
0X20FAB502219482F3.avi,72,1078,782,296,37.851662404092075,morphological_dilation,3,2
0X20FB855B93C178FB.avi,69,1635,1260,375,29.761904761904763,morphological_dilation,3,2
0X20FB855B93C178FB.avi,86,1244,928,316,34.05172413793103,morphological_dilation,3,2
0X20FC953931845AED.avi,71,1401,1049,352,33.55576739752145,morphological_dilation,3,2
0X20FC953931845AED.avi,92,1186,846,340,40.189125295508276,morphological_dilation,3,2
0X20FDE60EA17CDF97.avi,138,1843,1443,400,27.72002772002772,morphological_dilation,3,2
0X20FDE60EA17CDF97.avi,154,1158,826,332,40.19370460048426,morphological_dilation,3,2
0X210265FBDA5360AE.avi,78,2039,1627,412,25.322679778733864,morphological_dilation,3,2
0X210265FBDA5360AE.avi,94,1392,1025,367,35.80487804878049,morphological_dilation,3,2
0X210582D0841E845.avi,31,1725,1357,368,27.11864406779661,morphological_dilation,3,2
0X210582D0841E845.avi,47,1342,998,344,34.46893787575151,morphological_dilation,3,2
0X2109CB4DF22133B8.avi,48,1479,1103,376,34.08884859474162,morphological_dilation,3,2
0X2109CB4DF22133B8.avi,64,973,661,312,47.20121028744327,morphological_dilation,3,2
0X210C7A32E968D801.avi,136,2168,1748,420,24.02745995423341,morphological_dilation,3,2
0X210C7A32E968D801.avi,152,1483,1139,344,30.201931518876208,morphological_dilation,3,2
0X210DAE04842ABFCE.avi,57,1590,1224,366,29.901960784313726,morphological_dilation,3,2
0X210DAE04842ABFCE.avi,77,1037,731,306,41.86046511627907,morphological_dilation,3,2
0X210F9921E31032AF.avi,40,1404,1068,336,31.46067415730337,morphological_dilation,3,2
0X210F9921E31032AF.avi,55,985,704,281,39.91477272727273,morphological_dilation,3,2
0X210FD939B1583C4.avi,44,3296,2716,580,21.354933726067745,morphological_dilation,3,2
0X210FD939B1583C4.avi,61,2016,1528,488,31.93717277486911,morphological_dilation,3,2
0X2119E364C4EB41A5.avi,136,2320,1816,504,27.75330396475771,morphological_dilation,3,2
0X2119E364C4EB41A5.avi,165,1176,804,372,46.26865671641791,morphological_dilation,3,2
0X211D307253ACBEE7.avi,86,1123,831,292,35.13838748495788,morphological_dilation,3,2
0X211D307253ACBEE7.avi,94,1104,808,296,36.633663366336634,morphological_dilation,3,2
0X211D82BA9236CDCB.avi,75,3061,2545,516,20.275049115913557,morphological_dilation,3,2
0X211D82BA9236CDCB.avi,94,1854,1422,432,30.37974683544304,morphological_dilation,3,2
0X212800138BB39A54.avi,44,1798,1398,400,28.612303290414882,morphological_dilation,3,2
0X212800138BB39A54.avi,58,1214,870,344,39.54022988505747,morphological_dilation,3,2
0X2128420519D139AC.avi,49,1803,1427,376,26.3489838822705,morphological_dilation,3,2
0X2128420519D139AC.avi,65,1154,846,308,36.40661938534279,morphological_dilation,3,2
0X212CA9670262F815.avi,46,1564,1200,364,30.333333333333336,morphological_dilation,3,2
0X212CA9670262F815.avi,60,928,613,315,51.386623164763456,morphological_dilation,3,2
0X21308CC313DC6218.avi,48,1750,1371,379,27.644055433989788,morphological_dilation,3,2
0X21308CC313DC6218.avi,63,1487,1132,355,31.360424028268554,morphological_dilation,3,2
0X21335091E8EAB9E7.avi,122,2608,2156,452,20.964749536178108,morphological_dilation,3,2
0X21335091E8EAB9E7.avi,143,1511,1147,364,31.734960767218833,morphological_dilation,3,2
0X21335E5666FE334.avi,55,1996,1592,404,25.376884422110553,morphological_dilation,3,2
0X21335E5666FE334.avi,68,1059,722,337,46.67590027700831,morphological_dilation,3,2
0X2137CC12E6EBD1F9.avi,66,2097,1697,400,23.57100766057749,morphological_dilation,3,2
0X2137CC12E6EBD1F9.avi,80,1849,1469,380,25.86793737236215,morphological_dilation,3,2
0X2138256B8ACBC286.avi,49,1132,836,296,35.406698564593306,morphological_dilation,3,2
0X2138256B8ACBC286.avi,66,728,480,248,51.66666666666667,morphological_dilation,3,2
0X213B9075196791A5.avi,37,1446,1090,356,32.6605504587156,morphological_dilation,3,2
0X213B9075196791A5.avi,56,964,648,316,48.76543209876543,morphological_dilation,3,2
0X2142A8069D0CEE3E.avi,99,1741,1365,376,27.545787545787547,morphological_dilation,3,2
0X2142A8069D0CEE3E.avi,111,1275,955,320,33.50785340314136,morphological_dilation,3,2
0X2149046928524ECA.avi,36,1461,1121,340,30.33006244424621,morphological_dilation,3,2
0X2149046928524ECA.avi,50,955,663,292,44.042232277526395,morphological_dilation,3,2
0X21494E0B4F352AA.avi,50,1397,1025,372,36.292682926829265,morphological_dilation,3,2
0X21494E0B4F352AA.avi,63,795,518,277,53.47490347490348,morphological_dilation,3,2
0X214C1C219A70B853.avi,2,2487,2043,444,21.73274596182085,morphological_dilation,3,2
0X214C1C219A70B853.avi,18,1518,1158,360,31.088082901554404,morphological_dilation,3,2
0X21586B809CFC96DF.avi,113,1776,1388,388,27.953890489913547,morphological_dilation,3,2
0X21586B809CFC96DF.avi,135,1207,875,332,37.94285714285714,morphological_dilation,3,2
0X215A85593D22E6F0.avi,156,1304,964,340,35.26970954356847,morphological_dilation,3,2
0X215A85593D22E6F0.avi,181,799,519,280,53.94990366088632,morphological_dilation,3,2
0X215CFDA8D8E99821.avi,93,1513,1157,356,30.76923076923077,morphological_dilation,3,2
0X215CFDA8D8E99821.avi,107,1197,873,324,37.11340206185567,morphological_dilation,3,2
0X215F0AEFF802A568.avi,36,948,669,279,41.70403587443946,morphological_dilation,3,2
0X215F0AEFF802A568.avi,50,584,356,228,64.04494382022472,morphological_dilation,3,2
0X215F900F6CB6C95A.avi,97,3867,3305,562,17.004538577912253,morphological_dilation,3,2
0X215F900F6CB6C95A.avi,113,3560,3000,560,18.666666666666668,morphological_dilation,3,2
0X216C953D364C7BE5.avi,58,1597,1221,376,30.794430794430795,morphological_dilation,3,2
0X216C953D364C7BE5.avi,77,1027,691,336,48.62518089725037,morphological_dilation,3,2
0X216DCC8A21950E6E.avi,105,2646,2170,476,21.935483870967744,morphological_dilation,3,2
0X216DCC8A21950E6E.avi,120,1413,1025,388,37.853658536585364,morphological_dilation,3,2
0X216E6AFF3D3589CD.avi,58,1677,1313,364,27.722772277227726,morphological_dilation,3,2
0X216E6AFF3D3589CD.avi,69,1187,865,322,37.22543352601156,morphological_dilation,3,2
0X21753A275A66C4B5.avi,60,2409,1929,480,24.883359253499222,morphological_dilation,3,2
0X21753A275A66C4B5.avi,79,1686,1282,404,31.513260530421217,morphological_dilation,3,2
0X21764955637F610E.avi,2,1904,1500,404,26.93333333333333,morphological_dilation,3,2
0X21764955637F610E.avi,25,1168,821,347,42.265529841656516,morphological_dilation,3,2
0X217799C2838B5023.avi,58,3752,3180,572,17.9874213836478,morphological_dilation,3,2
0X217799C2838B5023.avi,67,2272,1808,464,25.663716814159294,morphological_dilation,3,2
0X21780197024E9D79.avi,61,2489,2049,440,21.473889702293803,morphological_dilation,3,2
0X21780197024E9D79.avi,76,1804,1412,392,27.762039660056658,morphological_dilation,3,2
0X2178C7825C058A65.avi,37,1633,1269,364,28.684003152088263,morphological_dilation,3,2
0X2178C7825C058A65.avi,49,1384,1050,334,31.80952380952381,morphological_dilation,3,2
0X21797862231FE398.avi,129,2560,2096,464,22.137404580152673,morphological_dilation,3,2
0X21797862231FE398.avi,147,1870,1482,388,26.180836707152494,morphological_dilation,3,2
0X217B4E9C7EA72B72.avi,4,1161,869,292,33.601841196777904,morphological_dilation,3,2
0X217B4E9C7EA72B72.avi,14,962,693,269,38.81673881673882,morphological_dilation,3,2
0X217DA0FD15274A38.avi,32,1340,909,431,47.41474147414741,morphological_dilation,3,2
0X217DA0FD15274A38.avi,49,900,600,300,50.0,morphological_dilation,3,2
0X217EB21B6C3068DF.avi,48,1361,1035,326,31.4975845410628,morphological_dilation,3,2
0X217EB21B6C3068DF.avi,66,822,558,264,47.31182795698925,morphological_dilation,3,2
0X218383A7F84BD283.avi,68,1942,1546,396,25.614489003880987,morphological_dilation,3,2
0X218383A7F84BD283.avi,81,1227,915,312,34.0983606557377,morphological_dilation,3,2
0X2183CED6963429F7.avi,3,2234,1810,424,23.425414364640883,morphological_dilation,3,2
0X2183CED6963429F7.avi,17,1619,1251,368,29.416466826538766,morphological_dilation,3,2
0X21861CDBBA5F5D9D.avi,53,1676,1296,380,29.32098765432099,morphological_dilation,3,2
0X21861CDBBA5F5D9D.avi,75,963,663,300,45.248868778280546,morphological_dilation,3,2
0X218BD0C4F2E153B7.avi,6,1326,998,328,32.86573146292585,morphological_dilation,3,2
0X218BD0C4F2E153B7.avi,21,1069,757,312,41.21532364597093,morphological_dilation,3,2
0X218C389768E6BEEF.avi,46,1598,1246,352,28.25040128410915,morphological_dilation,3,2
0X218C389768E6BEEF.avi,61,1186,862,324,37.58700696055685,morphological_dilation,3,2
0X218E4B013739DD05.avi,56,1777,1389,388,27.9337652987761,morphological_dilation,3,2
0X218E4B013739DD05.avi,75,1139,823,316,38.39611178614824,morphological_dilation,3,2
0X2190CC524D8A3203.avi,124,1927,1531,396,25.865447419986936,morphological_dilation,3,2
0X2190CC524D8A3203.avi,141,1266,910,356,39.120879120879124,morphological_dilation,3,2
0X21911F001AA82BCD.avi,63,1175,863,312,36.152954808806484,morphological_dilation,3,2
0X21911F001AA82BCD.avi,74,857,593,264,44.51939291736931,morphological_dilation,3,2
0X2193B0208A4BD2C5.avi,73,1618,1250,368,29.439999999999998,morphological_dilation,3,2
0X2193B0208A4BD2C5.avi,89,863,579,284,49.05008635578584,morphological_dilation,3,2
0X21957D70CCDCA50C.avi,106,1678,1318,360,27.31411229135053,morphological_dilation,3,2
0X21957D70CCDCA50C.avi,125,1162,850,312,36.705882352941174,morphological_dilation,3,2
0X219A42DE14521E3.avi,72,2883,2403,480,19.975031210986266,morphological_dilation,3,2
0X219A42DE14521E3.avi,93,1752,1376,376,27.325581395348834,morphological_dilation,3,2
0X219B35DD01D6562B.avi,49,1322,1006,316,31.411530815109344,morphological_dilation,3,2
0X219B35DD01D6562B.avi,67,869,597,272,45.56113902847571,morphological_dilation,3,2
0X219CD2BA2C006453.avi,40,2265,1821,444,24.382207578253706,morphological_dilation,3,2
0X219CD2BA2C006453.avi,54,1356,993,363,36.5558912386707,morphological_dilation,3,2
0X21A13B095CACF0EB.avi,44,1582,1238,344,27.78675282714055,morphological_dilation,3,2
0X21A13B095CACF0EB.avi,59,1060,756,304,40.21164021164021,morphological_dilation,3,2
0X21A4FF7D4640E7FC.avi,27,1838,1438,400,27.816411682892905,morphological_dilation,3,2
0X21A4FF7D4640E7FC.avi,40,1104,756,348,46.03174603174603,morphological_dilation,3,2
0X21ADDDA989F95D59.avi,91,1614,1250,364,29.12,morphological_dilation,3,2
0X21ADDDA989F95D59.avi,109,1039,739,300,40.59539918809202,morphological_dilation,3,2
0X21B24F2764DE564E.avi,72,2184,1764,420,23.809523809523807,morphological_dilation,3,2
0X21B24F2764DE564E.avi,90,1584,1232,352,28.57142857142857,morphological_dilation,3,2
0X21B497B1AE639C14.avi,59,1805,1405,400,28.46975088967972,morphological_dilation,3,2
0X21B497B1AE639C14.avi,70,1074,758,316,41.68865435356201,morphological_dilation,3,2
0X21C7B32102269C4F.avi,100,1186,862,324,37.58700696055685,morphological_dilation,3,2
0X21C7B32102269C4F.avi,113,737,481,256,53.222453222453225,morphological_dilation,3,2
0X21C7FD7003B44572.avi,0,1911,1523,388,25.47603414313854,morphological_dilation,3,2
0X21C7FD7003B44572.avi,16,1061,745,316,42.41610738255034,morphological_dilation,3,2
0X21D68178D7E68FF6.avi,96,1556,1192,364,30.536912751677853,morphological_dilation,3,2
0X21D68178D7E68FF6.avi,108,959,659,300,45.52352048558422,morphological_dilation,3,2
0X21D75884E9572691.avi,33,880,612,268,43.790849673202615,morphological_dilation,3,2
0X21D75884E9572691.avi,46,634,398,236,59.2964824120603,morphological_dilation,3,2
0X21D7E54015D4F60.avi,58,2196,1780,416,23.370786516853933,morphological_dilation,3,2
0X21D7E54015D4F60.avi,74,1402,1043,359,34.419942473633746,morphological_dilation,3,2
0X21D8A9341F567E31.avi,84,1623,1236,387,31.31067961165049,morphological_dilation,3,2
0X21D8A9341F567E31.avi,99,1082,756,326,43.12169312169312,morphological_dilation,3,2
0X21DB11780A6A35EE.avi,38,2318,1863,455,24.42297369833602,morphological_dilation,3,2
0X21DB11780A6A35EE.avi,53,1407,1047,360,34.38395415472779,morphological_dilation,3,2
0X21E16CBE16849CF8.avi,37,2030,1618,412,25.46353522867738,morphological_dilation,3,2
0X21E16CBE16849CF8.avi,50,1300,976,324,33.19672131147541,morphological_dilation,3,2
0X21E519C28BC94C65.avi,35,1381,1041,340,32.660902977905856,morphological_dilation,3,2
0X21E519C28BC94C65.avi,50,835,567,268,47.266313932980594,morphological_dilation,3,2
0X21EB8F540A5C436D.avi,57,2086,1678,408,24.31466030989273,morphological_dilation,3,2
0X21EB8F540A5C436D.avi,76,1136,836,300,35.88516746411483,morphological_dilation,3,2
0X21ECA17BDAB1F437.avi,45,1720,1323,397,30.007558578987148,morphological_dilation,3,2
0X21ECA17BDAB1F437.avi,59,1096,756,340,44.97354497354497,morphological_dilation,3,2
0X21F0FCA4D0ED4E27.avi,38,1545,1173,372,31.713554987212277,morphological_dilation,3,2
0X21F0FCA4D0ED4E27.avi,52,963,671,292,43.51713859910581,morphological_dilation,3,2
0X21F20E41517158AB.avi,89,1756,1388,368,26.512968299711815,morphological_dilation,3,2
0X21F20E41517158AB.avi,101,1037,749,288,38.45126835781041,morphological_dilation,3,2
0X21F489F4F5523D94.avi,49,1802,1418,384,27.080394922425953,morphological_dilation,3,2
0X21F489F4F5523D94.avi,66,1158,838,320,38.18615751789976,morphological_dilation,3,2
0X21FF36E89AF42A54.avi,89,1779,1374,405,29.475982532751093,morphological_dilation,3,2
0X21FF36E89AF42A54.avi,107,1093,765,328,42.87581699346405,morphological_dilation,3,2
0X2205F4A252993508.avi,53,1346,1010,336,33.26732673267327,morphological_dilation,3,2
0X2205F4A252993508.avi,72,808,548,260,47.44525547445255,morphological_dilation,3,2
0X220A95C40078BCFC.avi,51,1585,1229,356,28.966639544344996,morphological_dilation,3,2
0X220A95C40078BCFC.avi,70,910,626,284,45.367412140575084,morphological_dilation,3,2
0X22152A575B5662D1.avi,52,1508,1160,348,30.0,morphological_dilation,3,2
0X22152A575B5662D1.avi,70,980,688,292,42.44186046511628,morphological_dilation,3,2
0X2216131AF6AC3FC7.avi,104,1541,1193,348,29.170159262363786,morphological_dilation,3,2
0X2216131AF6AC3FC7.avi,120,962,678,284,41.88790560471977,morphological_dilation,3,2
0X22164FE4DE644483.avi,55,1448,1112,336,30.215827338129497,morphological_dilation,3,2
0X22164FE4DE644483.avi,72,919,651,268,41.16743471582181,morphological_dilation,3,2
0X2217DF2C04B344B9.avi,44,1369,1037,332,32.01542912246866,morphological_dilation,3,2
0X2217DF2C04B344B9.avi,62,849,569,280,49.209138840070295,morphological_dilation,3,2
0X221A17B6FD89EDA9.avi,56,1974,1574,400,25.412960609911057,morphological_dilation,3,2
0X221A17B6FD89EDA9.avi,70,1554,1187,367,30.918281381634372,morphological_dilation,3,2
0X221C260D3C7960DD.avi,90,1605,1249,356,28.502802241793436,morphological_dilation,3,2
0X221C260D3C7960DD.avi,105,1096,772,324,41.968911917098445,morphological_dilation,3,2
0X221D4FD030661C63.avi,76,3007,2499,508,20.328131252501,morphological_dilation,3,2
0X221D4FD030661C63.avi,94,1835,1439,396,27.51911049339819,morphological_dilation,3,2
0X2223897D4CA9FE1.avi,60,1724,1340,384,28.65671641791045,morphological_dilation,3,2
0X2223897D4CA9FE1.avi,86,1240,936,304,32.47863247863248,morphological_dilation,3,2
0X22241B85FF21816D.avi,152,1785,1390,395,28.41726618705036,morphological_dilation,3,2
0X22241B85FF21816D.avi,169,1333,962,371,38.565488565488565,morphological_dilation,3,2
0X22273DBF5B7AA460.avi,3,3125,2609,516,19.777692602529704,morphological_dilation,3,2
0X22273DBF5B7AA460.avi,18,1892,1480,412,27.837837837837835,morphological_dilation,3,2
0X222A58FCB3875364.avi,66,3128,2616,512,19.571865443425075,morphological_dilation,3,2
0X222A58FCB3875364.avi,86,2475,2004,471,23.502994011976046,morphological_dilation,3,2
0X222D850B21C1CBBF.avi,77,1735,1317,418,31.738800303720577,morphological_dilation,3,2
0X222D850B21C1CBBF.avi,85,1032,688,344,50.0,morphological_dilation,3,2
0X2230D32DA2165960.avi,47,2841,2341,500,21.358393848782573,morphological_dilation,3,2
0X2230D32DA2165960.avi,64,1765,1361,404,29.684055841293166,morphological_dilation,3,2
0X223201B0F37DA3E1.avi,77,2099,1679,420,25.01488981536629,morphological_dilation,3,2
0X223201B0F37DA3E1.avi,89,1361,1005,356,35.4228855721393,morphological_dilation,3,2
0X22390EC6147E56F5.avi,106,1883,1488,395,26.54569892473118,morphological_dilation,3,2
0X22390EC6147E56F5.avi,121,1143,819,324,39.56043956043956,morphological_dilation,3,2
0X223C255E3659DD3A.avi,53,1173,852,321,37.67605633802817,morphological_dilation,3,2
0X223C255E3659DD3A.avi,69,847,551,296,53.72050816696915,morphological_dilation,3,2
0X223CC1A7091C8635.avi,150,1879,1507,372,24.684804246848042,morphological_dilation,3,2
0X223CC1A7091C8635.avi,165,1238,922,316,34.273318872017356,morphological_dilation,3,2
0X22449C227AD0E5AF.avi,136,1998,1574,424,26.937738246505717,morphological_dilation,3,2
0X22449C227AD0E5AF.avi,159,1185,845,340,40.23668639053255,morphological_dilation,3,2
0X2245EF882F5AED68.avi,43,1513,1169,344,29.426860564585116,morphological_dilation,3,2
0X2245EF882F5AED68.avi,59,1014,718,296,41.22562674094708,morphological_dilation,3,2
0X2246E1E4611257EA.avi,56,1485,1153,332,28.794449262792714,morphological_dilation,3,2
0X2246E1E4611257EA.avi,77,882,614,268,43.648208469055376,morphological_dilation,3,2
0X224BAB7B84F593AE.avi,39,1809,1429,380,26.592022393282015,morphological_dilation,3,2
0X224BAB7B84F593AE.avi,56,1137,829,308,37.15319662243667,morphological_dilation,3,2
0X224BF576A2C34B1D.avi,63,2782,2298,484,21.061792863359443,morphological_dilation,3,2
0X224BF576A2C34B1D.avi,90,1921,1505,416,27.641196013289036,morphological_dilation,3,2
0X224D087937470C14.avi,40,1282,930,352,37.8494623655914,morphological_dilation,3,2
0X224D087937470C14.avi,50,969,661,308,46.59606656580938,morphological_dilation,3,2
0X224D7364FF5B803.avi,57,1829,1441,388,26.925746009715475,morphological_dilation,3,2
0X224D7364FF5B803.avi,74,1192,864,328,37.96296296296296,morphological_dilation,3,2
0X22516F1CC1E029EB.avi,58,1637,1273,364,28.59387274155538,morphological_dilation,3,2
0X22516F1CC1E029EB.avi,71,1077,781,296,37.900128040973115,morphological_dilation,3,2
0X2256C847305993D3.avi,6,1897,1501,396,26.382411725516324,morphological_dilation,3,2
0X2256C847305993D3.avi,24,1352,1012,340,33.59683794466403,morphological_dilation,3,2
0X225D461E61753EF7.avi,144,1391,1075,316,29.3953488372093,morphological_dilation,3,2
0X225D461E61753EF7.avi,164,921,641,280,43.6817472698908,morphological_dilation,3,2
0X2265B34908346F7E.avi,116,1445,1097,348,31.722880583409296,morphological_dilation,3,2
0X2265B34908346F7E.avi,136,907,608,299,49.17763157894737,morphological_dilation,3,2
0X2267236AA0B2C189.avi,51,1505,1173,332,28.303495311167946,morphological_dilation,3,2
0X2267236AA0B2C189.avi,68,1031,729,302,41.426611796982165,morphological_dilation,3,2
0X226BDFC5918616F2.avi,60,1384,1024,360,35.15625,morphological_dilation,3,2
0X226BDFC5918616F2.avi,76,876,591,285,48.223350253807105,morphological_dilation,3,2
0X226CCBEB90960018.avi,105,2309,1853,456,24.608742579600648,morphological_dilation,3,2
0X226CCBEB90960018.avi,122,1281,925,356,38.486486486486484,morphological_dilation,3,2
0X226F346724BCAD71.avi,133,1799,1415,384,27.13780918727915,morphological_dilation,3,2
0X226F346724BCAD71.avi,148,1165,829,336,40.5307599517491,morphological_dilation,3,2
0X226FC5A7CCB38B74.avi,49,1345,1009,336,33.30029732408325,morphological_dilation,3,2
0X226FC5A7CCB38B74.avi,65,881,605,276,45.6198347107438,morphological_dilation,3,2
0X22720172531FD8E2.avi,118,1163,847,316,37.308146399055495,morphological_dilation,3,2
0X22720172531FD8E2.avi,130,775,499,276,55.31062124248497,morphological_dilation,3,2
0X227A9B835F6F73F7.avi,125,1947,1532,415,27.088772845953002,morphological_dilation,3,2
0X227A9B835F6F73F7.avi,143,1250,906,344,37.969094922737305,morphological_dilation,3,2
0X227BA4CE78376983.avi,79,1842,1462,380,25.99179206566348,morphological_dilation,3,2
0X227BA4CE78376983.avi,91,1184,848,336,39.62264150943396,morphological_dilation,3,2
0X228402F6221FD034.avi,42,1353,1017,336,33.03834808259587,morphological_dilation,3,2
0X228402F6221FD034.avi,58,895,619,276,44.58804523424879,morphological_dilation,3,2
0X228D178D820A29A2.avi,41,1999,1587,412,25.960932577189666,morphological_dilation,3,2
0X228D178D820A29A2.avi,57,1332,972,360,37.03703703703704,morphological_dilation,3,2
0X229107A87184B05E.avi,117,2527,2036,491,24.11591355599214,morphological_dilation,3,2
0X229107A87184B05E.avi,139,1574,1170,404,34.52991452991453,morphological_dilation,3,2
0X2293D93BECAE2E77.avi,45,1597,1229,368,29.94304312449146,morphological_dilation,3,2
0X2293D93BECAE2E77.avi,59,931,627,304,48.484848484848484,morphological_dilation,3,2
0X2295D5A3C8F9AF68.avi,71,2575,2103,472,22.44412743699477,morphological_dilation,3,2
0X2295D5A3C8F9AF68.avi,89,1501,1109,392,35.34715960324617,morphological_dilation,3,2
0X229B538A0319227C.avi,40,1692,1320,372,28.18181818181818,morphological_dilation,3,2
0X229B538A0319227C.avi,55,1106,794,312,39.29471032745592,morphological_dilation,3,2
0X229F4D6D9E97CF7.avi,80,2190,1758,432,24.573378839590443,morphological_dilation,3,2
0X229F4D6D9E97CF7.avi,97,1343,987,356,36.06889564336373,morphological_dilation,3,2
0X229FA19806028FBF.avi,41,1611,1232,379,30.762987012987015,morphological_dilation,3,2
0X229FA19806028FBF.avi,58,936,636,300,47.16981132075472,morphological_dilation,3,2
0X22A1A8A656653343.avi,78,1928,1532,396,25.848563968668408,morphological_dilation,3,2
0X22A1A8A656653343.avi,90,1082,774,308,39.79328165374677,morphological_dilation,3,2
0X22A224A7045E469A.avi,41,3427,2868,559,19.490934449093444,morphological_dilation,3,2
0X22A224A7045E469A.avi,60,2117,1649,468,28.380836870830805,morphological_dilation,3,2
0X22A4930668E3B1F4.avi,116,3195,2663,532,19.977469019902365,morphological_dilation,3,2
0X22A4930668E3B1F4.avi,136,1796,1380,416,30.144927536231886,morphological_dilation,3,2
0X22A5FF0B68B27499.avi,75,1876,1480,396,26.756756756756754,morphological_dilation,3,2
0X22A5FF0B68B27499.avi,93,1462,1118,344,30.76923076923077,morphological_dilation,3,2
0X22A6C58CDE4CB622.avi,55,1190,875,315,36.0,morphological_dilation,3,2
0X22A6C58CDE4CB622.avi,71,800,532,268,50.37593984962406,morphological_dilation,3,2
0X22A6E3420279C25.avi,71,2108,1676,432,25.775656324582343,morphological_dilation,3,2
0X22A6E3420279C25.avi,90,1254,910,344,37.8021978021978,morphological_dilation,3,2
0X22A8C16F3DEDC047.avi,50,1096,793,303,38.20933165195461,morphological_dilation,3,2
0X22A8C16F3DEDC047.avi,65,741,477,264,55.34591194968554,morphological_dilation,3,2
0X22A9B6ECBD591065.avi,140,1727,1351,376,27.831236121391562,morphological_dilation,3,2
0X22A9B6ECBD591065.avi,153,1021,709,312,44.00564174894217,morphological_dilation,3,2
0X22ABDF6856E47639.avi,37,2400,1935,465,24.031007751937985,morphological_dilation,3,2
0X22ABDF6856E47639.avi,53,1315,949,366,38.56691253951528,morphological_dilation,3,2
0X22AE2280530D5513.avi,0,961,677,284,41.94977843426883,morphological_dilation,3,2
0X22AE2280530D5513.avi,9,615,394,221,56.09137055837563,morphological_dilation,3,2
0X22AEF55BDD1858B1.avi,76,2570,2102,468,22.26450999048525,morphological_dilation,3,2
0X22AEF55BDD1858B1.avi,95,1511,1140,371,32.54385964912281,morphological_dilation,3,2
0X22B5C22119402EFA.avi,105,1644,1278,366,28.638497652582164,morphological_dilation,3,2
0X22B5C22119402EFA.avi,123,1014,712,302,42.41573033707865,morphological_dilation,3,2
0X22B62786C6D09449.avi,40,2264,1812,452,24.944812362030905,morphological_dilation,3,2
0X22B62786C6D09449.avi,56,1365,1005,360,35.82089552238806,morphological_dilation,3,2
0X22BD7BADB8F9E8E8.avi,42,1225,917,308,33.587786259541986,morphological_dilation,3,2
0X22BD7BADB8F9E8E8.avi,57,779,515,264,51.262135922330096,morphological_dilation,3,2
0X22BD87DACA8C3D21.avi,40,2025,1611,414,25.69832402234637,morphological_dilation,3,2
0X22BD87DACA8C3D21.avi,56,1241,896,345,38.504464285714285,morphological_dilation,3,2
0X22BDBD4B2C8D42AC.avi,46,2243,1811,432,23.854224185532853,morphological_dilation,3,2
0X22BDBD4B2C8D42AC.avi,62,1656,1268,388,30.5993690851735,morphological_dilation,3,2
0X22BDBF9811758CD2.avi,32,1414,1090,324,29.724770642201836,morphological_dilation,3,2
0X22BDBF9811758CD2.avi,48,1013,729,284,38.95747599451303,morphological_dilation,3,2
0X22BEF985FFBEE221.avi,112,2039,1631,408,25.015328019619865,morphological_dilation,3,2
0X22BEF985FFBEE221.avi,133,1172,868,304,35.02304147465438,morphological_dilation,3,2
0X22C104757C7FC3AA.avi,74,1838,1454,384,26.409903713892707,morphological_dilation,3,2
0X22C104757C7FC3AA.avi,81,1060,732,328,44.80874316939891,morphological_dilation,3,2
0X22C1D803B10F7071.avi,81,2328,1908,420,22.0125786163522,morphological_dilation,3,2
0X22C1D803B10F7071.avi,97,1962,1574,388,24.650571791613725,morphological_dilation,3,2
0X22CA1F004555C1BA.avi,135,1117,817,300,36.71970624235006,morphological_dilation,3,2
0X22CA1F004555C1BA.avi,151,739,499,240,48.09619238476954,morphological_dilation,3,2
0X22CC169C12A93C2A.avi,53,3132,2625,507,19.314285714285713,morphological_dilation,3,2
0X22CC169C12A93C2A.avi,75,1783,1387,396,28.550829127613554,morphological_dilation,3,2
0X22D0F8CEA2D21C2D.avi,100,2406,1982,424,21.39253279515641,morphological_dilation,3,2
0X22D0F8CEA2D21C2D.avi,114,2161,1757,404,22.993739328400682,morphological_dilation,3,2
0X22D1F7E6B6953628.avi,39,2168,1736,432,24.88479262672811,morphological_dilation,3,2
0X22D1F7E6B6953628.avi,54,1548,1176,372,31.63265306122449,morphological_dilation,3,2
0X22D2668EC8BB8C20.avi,67,2072,1664,408,24.519230769230766,morphological_dilation,3,2
0X22D2668EC8BB8C20.avi,85,1365,1021,344,33.692458374142994,morphological_dilation,3,2
0X22D7FDCF2827269E.avi,97,1143,821,322,39.2204628501827,morphological_dilation,3,2
0X22D7FDCF2827269E.avi,112,762,498,264,53.01204819277109,morphological_dilation,3,2
0X22DB24EB0B914163.avi,132,1921,1541,380,24.659312134977288,morphological_dilation,3,2
0X22DB24EB0B914163.avi,151,1244,924,320,34.63203463203463,morphological_dilation,3,2
0X22DC2377CAE4D754.avi,0,1721,1357,364,26.823876197494474,morphological_dilation,3,2
0X22DC2377CAE4D754.avi,18,1350,1030,320,31.06796116504854,morphological_dilation,3,2
0X22DD6BCF1DE33B89.avi,51,1943,1555,388,24.95176848874598,morphological_dilation,3,2
0X22DD6BCF1DE33B89.avi,60,1663,1307,356,27.23794950267789,morphological_dilation,3,2
0X22E82C3D081C819C.avi,88,1479,1139,340,29.850746268656714,morphological_dilation,3,2
0X22E82C3D081C819C.avi,105,1170,870,300,34.48275862068966,morphological_dilation,3,2
0X22E91BA7334F8292.avi,68,2612,2168,444,20.479704797047972,morphological_dilation,3,2
0X22E91BA7334F8292.avi,98,1662,1298,364,28.043143297380585,morphological_dilation,3,2
0X22E9ABEF19984B09.avi,69,1626,1247,379,30.392943063352046,morphological_dilation,3,2
0X22E9ABEF19984B09.avi,84,973,669,304,45.440956651718984,morphological_dilation,3,2
0X22EEBC2819EE606D.avi,35,1675,1291,384,29.744384198295894,morphological_dilation,3,2
0X22EEBC2819EE606D.avi,53,1094,778,316,40.616966580976865,morphological_dilation,3,2
0X22F116501001DB14.avi,132,2441,1993,448,22.478675363773206,morphological_dilation,3,2
0X22F116501001DB14.avi,152,1818,1426,392,27.489481065918653,morphological_dilation,3,2
0X22F64BF092575F44.avi,50,2694,2202,492,22.3433242506812,morphological_dilation,3,2
0X22F64BF092575F44.avi,65,1527,1151,376,32.667245873153774,morphological_dilation,3,2
0X22F81F24E8B0741C.avi,33,2777,2261,516,22.821760283060595,morphological_dilation,3,2
0X22F81F24E8B0741C.avi,48,1593,1189,404,33.978132884777125,morphological_dilation,3,2
0X22FA972EE22D2F30.avi,0,1453,1093,360,32.93687099725526,morphological_dilation,3,2
0X22FA972EE22D2F30.avi,20,987,679,308,45.36082474226804,morphological_dilation,3,2
0X22FAC36B13D3526C.avi,2,1833,1457,376,25.806451612903224,morphological_dilation,3,2
0X22FAC36B13D3526C.avi,19,1363,1027,336,32.716650438169424,morphological_dilation,3,2
0X22FE585B9B3A0ECB.avi,39,1792,1412,380,26.912181303116146,morphological_dilation,3,2
0X22FE585B9B3A0ECB.avi,50,1504,1148,356,31.010452961672474,morphological_dilation,3,2
0X2307097BE78FA04F.avi,32,3016,2493,523,20.97874047332531,morphological_dilation,3,2
0X2307097BE78FA04F.avi,45,1670,1254,416,33.17384370015949,morphological_dilation,3,2
0X2307127FC335FF07.avi,52,1627,1251,376,30.05595523581135,morphological_dilation,3,2
0X2307127FC335FF07.avi,70,981,673,308,45.76523031203566,morphological_dilation,3,2
0X2308E2752F913346.avi,28,1431,1067,364,34.11433926897844,morphological_dilation,3,2
0X2308E2752F913346.avi,41,917,609,308,50.57471264367817,morphological_dilation,3,2
0X230ECEDF5353B79D.avi,44,1511,1111,400,36.003600360036,morphological_dilation,3,2
0X230ECEDF5353B79D.avi,61,854,496,358,72.17741935483872,morphological_dilation,3,2
0X230F00FD0DF5D71C.avi,82,1599,1239,360,29.055690072639223,morphological_dilation,3,2
0X230F00FD0DF5D71C.avi,96,917,627,290,46.25199362041467,morphological_dilation,3,2
0X23109C0554A16C8F.avi,1,1307,973,334,34.326824254881814,morphological_dilation,3,2
0X23109C0554A16C8F.avi,15,778,514,264,51.36186770428015,morphological_dilation,3,2
0X2311252C422D2782.avi,94,3008,2516,492,19.554848966613672,morphological_dilation,3,2
0X2311252C422D2782.avi,110,1684,1313,371,28.25590251332826,morphological_dilation,3,2
0X23138B9CCE9AA1D0.avi,110,1301,977,324,33.16274309109519,morphological_dilation,3,2
0X23138B9CCE9AA1D0.avi,121,846,568,278,48.943661971830984,morphological_dilation,3,2
0X23178A65C1003DE7.avi,2,1929,1528,401,26.2434554973822,morphological_dilation,3,2
0X23178A65C1003DE7.avi,14,1144,820,324,39.51219512195122,morphological_dilation,3,2
0X231C7BD210366D86.avi,116,2332,1880,452,24.04255319148936,morphological_dilation,3,2
0X231C7BD210366D86.avi,135,1672,1283,389,30.319563522992986,morphological_dilation,3,2
0X232094B1E30C45E1.avi,59,2687,2199,488,22.191905411550707,morphological_dilation,3,2
0X232094B1E30C45E1.avi,74,1730,1326,404,30.46757164404223,morphological_dilation,3,2
0X232232E2699FD6BB.avi,114,2137,1721,416,24.171993027309703,morphological_dilation,3,2
0X232232E2699FD6BB.avi,134,1456,1100,356,32.36363636363636,morphological_dilation,3,2
0X23229F0B64DC9FAE.avi,41,1670,1278,392,30.672926447574334,morphological_dilation,3,2
0X23229F0B64DC9FAE.avi,53,1127,819,308,37.60683760683761,morphological_dilation,3,2
0X2324CDAF976E078E.avi,164,2658,2146,512,23.85834109972041,morphological_dilation,3,2
0X2324CDAF976E078E.avi,187,1742,1294,448,34.62132921174652,morphological_dilation,3,2
0X2324EE43744E214C.avi,33,2300,1865,435,23.324396782841823,morphological_dilation,3,2
0X2324EE43744E214C.avi,46,1313,966,347,35.92132505175984,morphological_dilation,3,2
0X232567AC545F3F3D.avi,56,2129,1713,416,24.28488032691185,morphological_dilation,3,2
0X232567AC545F3F3D.avi,72,1249,921,328,35.613463626492944,morphological_dilation,3,2
0X23261A4B1EEB9DE9.avi,79,1520,1164,356,30.584192439862544,morphological_dilation,3,2
0X23261A4B1EEB9DE9.avi,95,925,641,284,44.30577223088923,morphological_dilation,3,2
0X2326F92D1F6B4980.avi,39,1216,900,316,35.11111111111111,morphological_dilation,3,2
0X2326F92D1F6B4980.avi,55,804,540,264,48.888888888888886,morphological_dilation,3,2
0X232B95105F8D700C.avi,58,1283,979,304,31.05209397344229,morphological_dilation,3,2
0X232B95105F8D700C.avi,72,764,524,240,45.80152671755725,morphological_dilation,3,2
0X232D295076A40924.avi,83,1357,1033,324,31.364956437560505,morphological_dilation,3,2
0X232D295076A40924.avi,97,802,546,256,46.88644688644688,morphological_dilation,3,2
0X232DAB0AE399625D.avi,63,1339,994,345,34.70824949698189,morphological_dilation,3,2
0X232DAB0AE399625D.avi,81,824,548,276,50.36496350364964,morphological_dilation,3,2
0X232E3FFDB1D666B0.avi,85,1401,1052,349,33.174904942965775,morphological_dilation,3,2
0X232E3FFDB1D666B0.avi,100,857,577,280,48.52686308492201,morphological_dilation,3,2
0X23316DEB7389A3CF.avi,26,2111,1699,412,24.249558563861097,morphological_dilation,3,2
0X23316DEB7389A3CF.avi,52,1666,1314,352,26.78843226788432,morphological_dilation,3,2
0X233503BE5DE4C30F.avi,44,1272,924,348,37.66233766233766,morphological_dilation,3,2
0X233503BE5DE4C30F.avi,67,908,600,308,51.33333333333333,morphological_dilation,3,2
0X2335AA783BB18BF9.avi,43,1194,894,300,33.557046979865774,morphological_dilation,3,2
0X2335AA783BB18BF9.avi,59,772,520,252,48.46153846153846,morphological_dilation,3,2
0X233DCAFBF90253C7.avi,54,2423,1967,456,23.182511438739198,morphological_dilation,3,2
0X233DCAFBF90253C7.avi,67,2020,1604,416,25.935162094763093,morphological_dilation,3,2
0X233E8DAD9CD641F2.avi,103,2142,1718,424,24.679860302677533,morphological_dilation,3,2
0X233E8DAD9CD641F2.avi,122,1393,1041,352,33.81364073006724,morphological_dilation,3,2
0X233F896CE9F42E51.avi,100,1719,1355,364,26.86346863468635,morphological_dilation,3,2
0X233F896CE9F42E51.avi,120,1325,997,328,32.89869608826479,morphological_dilation,3,2
0X233FA49D8921EEF4.avi,102,1654,1302,352,27.035330261136714,morphological_dilation,3,2
0X233FA49D8921EEF4.avi,115,1055,759,296,38.998682476943344,morphological_dilation,3,2
0X23404EE09A063C6B.avi,35,1368,1036,332,32.04633204633205,morphological_dilation,3,2
0X23404EE09A063C6B.avi,52,935,651,284,43.625192012288785,morphological_dilation,3,2
0X23419AB4EA378B47.avi,4,2403,1947,456,23.42064714946071,morphological_dilation,3,2
0X23419AB4EA378B47.avi,14,1587,1204,383,31.81063122923588,morphological_dilation,3,2
0X234453BC01C1F830.avi,55,1588,1236,352,28.478964401294498,morphological_dilation,3,2
0X234453BC01C1F830.avi,69,998,698,300,42.97994269340974,morphological_dilation,3,2
0X2349279AD743CF2B.avi,53,2462,1975,487,24.658227848101266,morphological_dilation,3,2
0X2349279AD743CF2B.avi,62,1713,1304,409,31.36503067484663,morphological_dilation,3,2
0X234D7576D2E85005.avi,123,2467,2011,456,22.675285927399305,morphological_dilation,3,2
0X234D7576D2E85005.avi,137,1830,1426,404,28.330995792426368,morphological_dilation,3,2
0X234DDA5BD6618265.avi,50,1383,1031,352,34.14161008729389,morphological_dilation,3,2
0X234DDA5BD6618265.avi,65,930,633,297,46.91943127962085,morphological_dilation,3,2
0X234F388F6AF6AC9C.avi,52,1936,1541,395,25.63270603504218,morphological_dilation,3,2
0X234F388F6AF6AC9C.avi,69,1279,935,344,36.79144385026738,morphological_dilation,3,2
0X235318E55D1F73EC.avi,47,4705,4081,624,15.29037000735114,morphological_dilation,3,2
0X235318E55D1F73EC.avi,62,2917,2381,536,22.51154976900462,morphological_dilation,3,2
0X23562CFC0E7E956B.avi,107,1783,1403,380,27.084818246614397,morphological_dilation,3,2
0X23562CFC0E7E956B.avi,117,1101,789,312,39.543726235741445,morphological_dilation,3,2
0X2359BC3D3CC007E.avi,77,1867,1467,400,27.266530334015,morphological_dilation,3,2
0X2359BC3D3CC007E.avi,93,1240,904,336,37.16814159292036,morphological_dilation,3,2
0X235CC08DFD8EFC4E.avi,45,1908,1501,407,27.115256495669556,morphological_dilation,3,2
0X235CC08DFD8EFC4E.avi,61,1411,1049,362,34.50905624404194,morphological_dilation,3,2
0X23646D0D797339F6.avi,89,1177,860,317,36.860465116279066,morphological_dilation,3,2
0X23646D0D797339F6.avi,111,840,551,289,52.45009074410163,morphological_dilation,3,2
0X236567224F84C1A3.avi,3,1027,715,312,43.63636363636363,morphological_dilation,3,2
0X236567224F84C1A3.avi,18,643,391,252,64.45012787723785,morphological_dilation,3,2
0X2366DB553504817A.avi,85,2513,2065,448,21.694915254237287,morphological_dilation,3,2
0X2366DB553504817A.avi,103,1639,1259,380,30.182684670373312,morphological_dilation,3,2
0X2367EA1E168596C6.avi,133,2754,2274,480,21.108179419525065,morphological_dilation,3,2
0X2367EA1E168596C6.avi,147,2302,1858,444,23.896663078579117,morphological_dilation,3,2
0X236A602C00A2312.avi,0,2045,1649,396,24.014554275318375,morphological_dilation,3,2
0X236A602C00A2312.avi,15,1731,1375,356,25.89090909090909,morphological_dilation,3,2
0X237A158C025A28E5.avi,91,2339,1869,470,25.14713750668807,morphological_dilation,3,2
0X237A158C025A28E5.avi,104,1395,1027,368,35.83252190847128,morphological_dilation,3,2
0X237C76B2D575785D.avi,103,2194,1782,412,23.120089786756452,morphological_dilation,3,2
0X237C76B2D575785D.avi,114,1994,1594,400,25.094102885821833,morphological_dilation,3,2
0X237F8C7FF6BB577F.avi,121,2921,2406,515,21.404821280133003,morphological_dilation,3,2
0X237F8C7FF6BB577F.avi,132,1873,1445,428,29.619377162629757,morphological_dilation,3,2
0X2382898F68207D7F.avi,71,1438,1082,356,32.90203327171904,morphological_dilation,3,2
0X2382898F68207D7F.avi,86,973,651,322,49.46236559139785,morphological_dilation,3,2
0X23835D19C3DBFE2E.avi,149,2326,1882,444,23.59192348565356,morphological_dilation,3,2
0X23835D19C3DBFE2E.avi,163,1346,994,352,35.412474849094565,morphological_dilation,3,2
0X2387300342812F85.avi,68,1779,1391,388,27.893601725377426,morphological_dilation,3,2
0X2387300342812F85.avi,84,1104,788,316,40.10152284263959,morphological_dilation,3,2
0X238824F40F11736F.avi,3,1705,1337,368,27.524308152580403,morphological_dilation,3,2
0X238824F40F11736F.avi,18,1117,815,302,37.05521472392638,morphological_dilation,3,2
0X238ADF5CF8E3E97.avi,83,1664,1292,372,28.792569659442723,morphological_dilation,3,2
0X238ADF5CF8E3E97.avi,95,1427,1051,376,35.77545195052331,morphological_dilation,3,2
0X238CEE1A57B1D64E.avi,63,1906,1504,402,26.728723404255316,morphological_dilation,3,2
0X238CEE1A57B1D64E.avi,87,1299,963,336,34.890965732087224,morphological_dilation,3,2
0X238D16678F01A823.avi,103,2834,2354,480,20.390824129141887,morphological_dilation,3,2
0X238D16678F01A823.avi,118,2463,2007,456,22.720478325859492,morphological_dilation,3,2
0X2392EF0E06DB21B5.avi,42,1280,960,320,33.33333333333333,morphological_dilation,3,2
0X2392EF0E06DB21B5.avi,57,1018,711,307,43.17862165963432,morphological_dilation,3,2
0X239CB1C46AEDDF00.avi,116,1601,1241,360,29.0088638195004,morphological_dilation,3,2
0X239CB1C46AEDDF00.avi,143,992,692,300,43.35260115606936,morphological_dilation,3,2
0X239D1851C8D6BE09.avi,34,988,699,289,41.3447782546495,morphological_dilation,3,2
0X239D1851C8D6BE09.avi,41,644,417,227,54.43645083932853,morphological_dilation,3,2
0X239FC841AB0C17DD.avi,55,1796,1428,368,25.770308123249297,morphological_dilation,3,2
0X239FC841AB0C17DD.avi,75,1139,839,300,35.75685339690107,morphological_dilation,3,2
0X23A08B6B1959FCC5.avi,0,2952,2448,504,20.588235294117645,morphological_dilation,3,2
0X23A08B6B1959FCC5.avi,17,1939,1495,444,29.698996655518396,morphological_dilation,3,2
0X23A2F3EB82C3709B.avi,57,1931,1547,384,24.82223658694247,morphological_dilation,3,2
0X23A2F3EB82C3709B.avi,76,1383,1043,340,32.59827420901246,morphological_dilation,3,2
0X23AA500225C0E94E.avi,66,1426,1078,348,32.28200371057514,morphological_dilation,3,2
0X23AA500225C0E94E.avi,82,1085,759,326,42.95125164690382,morphological_dilation,3,2
0X23AC249A5A6612D9.avi,85,2694,2226,468,21.024258760107816,morphological_dilation,3,2
0X23AC249A5A6612D9.avi,100,2016,1608,408,25.37313432835821,morphological_dilation,3,2
0X23B1641319A2AFA2.avi,50,1908,1496,412,27.540106951871657,morphological_dilation,3,2
0X23B1641319A2AFA2.avi,66,1145,813,332,40.836408364083645,morphological_dilation,3,2
0X23B883A39F37F8D9.avi,160,5711,5063,648,12.798735927315821,morphological_dilation,3,2
0X23B883A39F37F8D9.avi,176,3020,2460,560,22.76422764227642,morphological_dilation,3,2
0X23BA55335A3F3F42.avi,47,1281,949,332,34.98419388830348,morphological_dilation,3,2
0X23BA55335A3F3F42.avi,66,759,499,260,52.104208416833664,morphological_dilation,3,2
0X23BC106BDEB75F2B.avi,41,1945,1525,420,27.54098360655738,morphological_dilation,3,2
0X23BC106BDEB75F2B.avi,61,1281,925,356,38.486486486486484,morphological_dilation,3,2
0X23C1AA2F97BCD568.avi,78,1677,1317,360,27.33485193621868,morphological_dilation,3,2
0X23C1AA2F97BCD568.avi,92,1067,779,288,36.97047496790758,morphological_dilation,3,2
0X23CA5B856231EF59.avi,53,1674,1298,376,28.96764252696456,morphological_dilation,3,2
0X23CA5B856231EF59.avi,77,968,676,292,43.19526627218935,morphological_dilation,3,2
0X23CC21A0B9FBE97.avi,124,1606,1250,356,28.48,morphological_dilation,3,2
0X23CC21A0B9FBE97.avi,139,960,680,280,41.17647058823529,morphological_dilation,3,2
0X23CC74B76656533F.avi,53,1472,1104,368,33.33333333333333,morphological_dilation,3,2
0X23CC74B76656533F.avi,72,900,544,356,65.44117647058823,morphological_dilation,3,2
0X23CF63A0B3106979.avi,4,1477,1129,348,30.823737821080606,morphological_dilation,3,2
0X23CF63A0B3106979.avi,17,986,678,308,45.42772861356932,morphological_dilation,3,2
0X23D1957D8639581F.avi,48,1725,1361,364,26.745040411462163,morphological_dilation,3,2
0X23D1957D8639581F.avi,68,1376,1056,320,30.303030303030305,morphological_dilation,3,2
0X23D40A4C6D379CF7.avi,88,1674,1290,384,29.767441860465116,morphological_dilation,3,2
0X23D40A4C6D379CF7.avi,107,1008,700,308,44.0,morphological_dilation,3,2
0X23D6C6323D56B730.avi,99,1410,1074,336,31.28491620111732,morphological_dilation,3,2
0X23D6C6323D56B730.avi,111,878,590,288,48.8135593220339,morphological_dilation,3,2
0X23D7360CB2EF9A53.avi,43,1596,1224,372,30.392156862745097,morphological_dilation,3,2
0X23D7360CB2EF9A53.avi,61,1217,865,352,40.69364161849711,morphological_dilation,3,2
0X23DF57D03E5E2F9B.avi,31,1336,997,339,34.00200601805417,morphological_dilation,3,2
0X23DF57D03E5E2F9B.avi,44,806,518,288,55.5984555984556,morphological_dilation,3,2
0X23DFED26C5A53775.avi,69,1784,1376,408,29.651162790697676,morphological_dilation,3,2
0X23DFED26C5A53775.avi,80,1132,792,340,42.92929292929293,morphological_dilation,3,2
0X23E4915490598D1F.avi,95,1588,1220,368,30.16393442622951,morphological_dilation,3,2
0X23E4915490598D1F.avi,114,1041,724,317,43.784530386740336,morphological_dilation,3,2
0X23E619A8A8C3736C.avi,29,2255,1815,440,24.242424242424242,morphological_dilation,3,2
0X23E619A8A8C3736C.avi,59,1599,1217,382,31.388660640920296,morphological_dilation,3,2
0X23E63ABC87C2E515.avi,37,2605,2145,460,21.445221445221446,morphological_dilation,3,2
0X23E63ABC87C2E515.avi,53,1514,1146,368,32.11169284467714,morphological_dilation,3,2
0X23E98D02C1B728A0.avi,41,1600,1252,348,27.79552715654952,morphological_dilation,3,2
0X23E98D02C1B728A0.avi,59,1150,854,296,34.66042154566745,morphological_dilation,3,2
0X23EB7A832C5D533D.avi,85,2477,2021,456,22.56308758040574,morphological_dilation,3,2
0X23EB7A832C5D533D.avi,104,1511,1139,372,32.660228270412645,morphological_dilation,3,2
0X23EBAF193699CC69.avi,132,3372,2844,528,18.565400843881857,morphological_dilation,3,2
0X23EBAF193699CC69.avi,151,2117,1673,444,26.539151225343694,morphological_dilation,3,2
0X23F29235EC216628.avi,85,2057,1653,404,24.440411373260737,morphological_dilation,3,2
0X23F29235EC216628.avi,106,1522,1166,356,30.53173241852487,morphological_dilation,3,2
0X23F4B52E8588E2AD.avi,191,1859,1479,380,25.693035835023665,morphological_dilation,3,2
0X23F4B52E8588E2AD.avi,212,1215,899,316,35.15016685205784,morphological_dilation,3,2
0X23F7E889AEC65CC6.avi,55,2372,1892,480,25.36997885835095,morphological_dilation,3,2
0X23F7E889AEC65CC6.avi,71,1444,1052,392,37.26235741444867,morphological_dilation,3,2
0X23F8FB36ACE98145.avi,3,1411,1063,348,32.73753527751646,morphological_dilation,3,2
0X23F8FB36ACE98145.avi,18,945,665,280,42.10526315789473,morphological_dilation,3,2
0X23FAB252614B31A.avi,110,1414,1062,352,33.14500941619586,morphological_dilation,3,2
0X23FAB252614B31A.avi,128,850,574,276,48.08362369337979,morphological_dilation,3,2
0X23FCF45E798060D0.avi,148,3085,2578,507,19.666408068269977,morphological_dilation,3,2
0X23FCF45E798060D0.avi,187,2015,1559,456,29.249518922386148,morphological_dilation,3,2
0X240DC6905435E17B.avi,38,1611,1239,372,30.024213075060537,morphological_dilation,3,2
0X240DC6905435E17B.avi,55,1131,811,320,39.457459926017265,morphological_dilation,3,2
0X240E0BC8345AB153.avi,54,2648,2164,484,22.36598890942699,morphological_dilation,3,2
0X240E0BC8345AB153.avi,73,1559,1168,391,33.476027397260275,morphological_dilation,3,2
0X241057582EE5420E.avi,55,2153,1725,428,24.81159420289855,morphological_dilation,3,2
0X241057582EE5420E.avi,64,1169,829,340,41.01326899879373,morphological_dilation,3,2
0X2411B3C3F8748A26.avi,91,1517,1153,364,31.569817866435386,morphological_dilation,3,2
0X2411B3C3F8748A26.avi,110,897,609,288,47.29064039408867,morphological_dilation,3,2
0X2414B3661FDBF9C3.avi,43,1664,1302,362,27.80337941628264,morphological_dilation,3,2
0X2414B3661FDBF9C3.avi,61,977,689,288,41.79970972423803,morphological_dilation,3,2
0X241E08BD87DD9251.avi,99,1709,1341,368,27.44220730797912,morphological_dilation,3,2
0X241E08BD87DD9251.avi,113,990,701,289,41.226818830242514,morphological_dilation,3,2
0X241F39470B521282.avi,53,1739,1351,388,28.71946706143597,morphological_dilation,3,2
0X241F39470B521282.avi,68,1106,786,320,40.71246819338422,morphological_dilation,3,2
0X2427A56346ED7F61.avi,116,1909,1529,380,24.85284499672989,morphological_dilation,3,2
0X2427A56346ED7F61.avi,134,1460,1116,344,30.824372759856633,morphological_dilation,3,2
0X242B658934E3E2AE.avi,93,1609,1249,360,28.823058446757404,morphological_dilation,3,2
0X242B658934E3E2AE.avi,110,1081,777,304,39.12483912483912,morphological_dilation,3,2
0X242CB7F150E2C5AA.avi,60,1123,819,304,37.11843711843712,morphological_dilation,3,2
0X242CB7F150E2C5AA.avi,76,742,498,244,48.99598393574297,morphological_dilation,3,2
0X2430FD0356057728.avi,104,3163,2651,512,19.31346661637118,morphological_dilation,3,2
0X2430FD0356057728.avi,125,2217,1773,444,25.042301184433164,morphological_dilation,3,2
0X2432016D32614048.avi,72,1132,799,333,41.677096370463076,morphological_dilation,3,2
0X2432016D32614048.avi,85,611,314,297,94.5859872611465,morphological_dilation,3,2
0X24337F79C53AD299.avi,77,1352,1028,324,31.517509727626457,morphological_dilation,3,2
0X24337F79C53AD299.avi,96,968,664,304,45.78313253012048,morphological_dilation,3,2
0X24346E6B95219B70.avi,118,2294,1846,448,24.26868905742145,morphological_dilation,3,2
0X24346E6B95219B70.avi,132,1379,1007,372,36.941410129096326,morphological_dilation,3,2
0X24362254069DD61B.avi,63,805,533,272,51.031894934333955,morphological_dilation,3,2
0X24362254069DD61B.avi,79,502,277,225,81.2274368231047,morphological_dilation,3,2
0X2439B4EB7F068E2A.avi,75,1628,1268,360,28.391167192429023,morphological_dilation,3,2
0X2439B4EB7F068E2A.avi,90,1114,801,313,39.076154806491886,morphological_dilation,3,2
0X2439D556A91476D3.avi,52,1771,1387,384,27.68565248738284,morphological_dilation,3,2
0X2439D556A91476D3.avi,69,1126,802,324,40.399002493765586,morphological_dilation,3,2
0X243C32CAE420170B.avi,91,2995,2491,504,20.2328382175833,morphological_dilation,3,2
0X243C32CAE420170B.avi,107,2439,1975,464,23.49367088607595,morphological_dilation,3,2
0X243FDE8AE0A05B6F.avi,98,2572,2140,432,20.186915887850468,morphological_dilation,3,2
0X243FDE8AE0A05B6F.avi,113,2129,1729,400,23.13475997686524,morphological_dilation,3,2
0X24429BE93EA20EA0.avi,4,1434,1098,336,30.601092896174865,morphological_dilation,3,2
0X24429BE93EA20EA0.avi,16,899,618,281,45.46925566343042,morphological_dilation,3,2
0X2445E24972D9082C.avi,2,2129,1701,428,25.16166960611405,morphological_dilation,3,2
0X2445E24972D9082C.avi,18,1145,825,320,38.78787878787879,morphological_dilation,3,2
0X244B43804C53EDB1.avi,80,2341,1885,456,24.190981432360743,morphological_dilation,3,2
0X244B43804C53EDB1.avi,99,1406,1054,352,33.396584440227706,morphological_dilation,3,2
0X244C21A1DE9C2E9B.avi,2,1577,1225,352,28.73469387755102,morphological_dilation,3,2
0X244C21A1DE9C2E9B.avi,18,925,642,283,44.0809968847352,morphological_dilation,3,2
0X244C8BF642C90DA7.avi,185,2289,1809,480,26.533996683250415,morphological_dilation,3,2
0X244C8BF642C90DA7.avi,205,1343,987,356,36.06889564336373,morphological_dilation,3,2
0X244CAB3550320216.avi,191,2423,1932,491,25.414078674948243,morphological_dilation,3,2
0X244CAB3550320216.avi,209,1414,1033,381,36.88286544046467,morphological_dilation,3,2
0X244FC0ACE784DDF8.avi,84,1374,1010,364,36.039603960396036,morphological_dilation,3,2
0X244FC0ACE784DDF8.avi,101,853,488,365,74.79508196721312,morphological_dilation,3,2
0X245274A42C2D825.avi,131,1516,1148,368,32.05574912891986,morphological_dilation,3,2
0X245274A42C2D825.avi,144,874,594,280,47.13804713804714,morphological_dilation,3,2
0X24543F8B04D98E65.avi,123,1522,1153,369,32.00346921075455,morphological_dilation,3,2
0X24543F8B04D98E65.avi,135,1168,823,345,41.919805589307416,morphological_dilation,3,2
0X245BB0CA4EA502B6.avi,46,1254,930,324,34.83870967741935,morphological_dilation,3,2
0X245BB0CA4EA502B6.avi,63,812,536,276,51.49253731343284,morphological_dilation,3,2
0X24609A701DBC258E.avi,48,2462,2002,460,22.977022977022976,morphological_dilation,3,2
0X24609A701DBC258E.avi,63,1664,1248,416,33.33333333333333,morphological_dilation,3,2
0X2461DF4B5870DBC4.avi,38,1749,1381,368,26.64735698769008,morphological_dilation,3,2
0X2461DF4B5870DBC4.avi,50,1521,1185,336,28.354430379746837,morphological_dilation,3,2
0X24669F82F91D85C9.avi,33,1354,1030,324,31.456310679611647,morphological_dilation,3,2
0X24669F82F91D85C9.avi,48,850,586,264,45.051194539249146,morphological_dilation,3,2
0X246B8C7FCA4D818D.avi,37,1463,1079,384,35.588507877664505,morphological_dilation,3,2
0X246B8C7FCA4D818D.avi,50,975,667,308,46.17691154422789,morphological_dilation,3,2
0X246D33ADC0084497.avi,55,1683,1303,380,29.16346891788181,morphological_dilation,3,2
0X246D33ADC0084497.avi,70,1027,703,324,46.088193456614505,morphological_dilation,3,2
0X246D58B781EFA3A2.avi,55,1239,911,328,36.00439077936334,morphological_dilation,3,2
0X246D58B781EFA3A2.avi,71,776,520,256,49.23076923076923,morphological_dilation,3,2
0X24708E2D3F05391F.avi,133,1656,1245,411,33.01204819277108,morphological_dilation,3,2
0X24708E2D3F05391F.avi,149,1042,702,340,48.433048433048434,morphological_dilation,3,2
0X2478857A75A6F4E7.avi,56,1393,1025,368,35.90243902439024,morphological_dilation,3,2
0X2478857A75A6F4E7.avi,73,867,545,322,59.082568807339456,morphological_dilation,3,2
0X247B5634CCC3377C.avi,60,1294,974,320,32.85420944558521,morphological_dilation,3,2
0X247B5634CCC3377C.avi,79,860,592,268,45.27027027027027,morphological_dilation,3,2
0X247FC8D31B4E44B7.avi,61,1845,1453,392,26.97866483138334,morphological_dilation,3,2
0X247FC8D31B4E44B7.avi,81,1120,808,312,38.613861386138616,morphological_dilation,3,2
0X248229014E7A20A9.avi,35,2821,2349,472,20.09365687526607,morphological_dilation,3,2
0X248229014E7A20A9.avi,53,1732,1344,388,28.869047619047617,morphological_dilation,3,2
0X2485A9135A333814.avi,57,2085,1697,388,22.863877430760166,morphological_dilation,3,2
0X2485A9135A333814.avi,78,1319,999,320,32.032032032032035,morphological_dilation,3,2
0X24889AD4250280C9.avi,146,3256,2760,496,17.971014492753625,morphological_dilation,3,2
0X24889AD4250280C9.avi,162,2871,2408,463,19.227574750830563,morphological_dilation,3,2
0X2489A40319D6990E.avi,92,1248,928,320,34.48275862068966,morphological_dilation,3,2
0X2489A40319D6990E.avi,110,877,597,280,46.901172529313236,morphological_dilation,3,2
0X2490B0F4C6B72FD2.avi,73,3167,2647,520,19.644880997355497,morphological_dilation,3,2
0X2490B0F4C6B72FD2.avi,82,1702,1302,400,30.721966205837177,morphological_dilation,3,2
0X2492BC93BE9264ED.avi,40,2100,1692,408,24.113475177304963,morphological_dilation,3,2
0X2492BC93BE9264ED.avi,51,1217,885,332,37.514124293785315,morphological_dilation,3,2
0X249901C1E8BF28AA.avi,106,1915,1531,384,25.081645983017637,morphological_dilation,3,2
0X249901C1E8BF28AA.avi,120,1110,802,308,38.403990024937656,morphological_dilation,3,2
0X2499AD2830EAF683.avi,45,1827,1439,388,26.963168867268937,morphological_dilation,3,2
0X2499AD2830EAF683.avi,57,1079,762,317,41.6010498687664,morphological_dilation,3,2
0X249FE2498B57B632.avi,106,1513,1165,348,29.871244635193133,morphological_dilation,3,2
0X249FE2498B57B632.avi,117,1015,723,292,40.387275242047025,morphological_dilation,3,2
0X24A8A07492EDC214.avi,53,1960,1536,424,27.604166666666668,morphological_dilation,3,2
0X24A8A07492EDC214.avi,72,1227,883,344,38.95809739524349,morphological_dilation,3,2
0X24ADF09C5E5972E0.avi,32,1351,1035,316,30.531400966183575,morphological_dilation,3,2
0X24ADF09C5E5972E0.avi,41,989,709,280,39.492242595204516,morphological_dilation,3,2
0X24B3D97148F6484B.avi,83,1742,1374,368,26.78311499272198,morphological_dilation,3,2
0X24B3D97148F6484B.avi,99,1097,785,312,39.74522292993631,morphological_dilation,3,2
0X24B3DECAE59D63C9.avi,54,1625,1233,392,31.792376317923765,morphological_dilation,3,2
0X24B3DECAE59D63C9.avi,69,1097,765,332,43.39869281045752,morphological_dilation,3,2
0X24BC1D83B332BEB6.avi,67,1293,953,340,35.67681007345226,morphological_dilation,3,2
0X24BC1D83B332BEB6.avi,82,818,546,272,49.81684981684982,morphological_dilation,3,2
0X24BE53A4193FF10D.avi,154,1259,943,316,33.51007423117709,morphological_dilation,3,2
0X24BE53A4193FF10D.avi,172,769,505,264,52.27722772277228,morphological_dilation,3,2
0X24C05ADF764D0216.avi,101,1414,1086,328,30.20257826887661,morphological_dilation,3,2
0X24C05ADF764D0216.avi,116,976,688,288,41.86046511627907,morphological_dilation,3,2
0X24C20970C045D12E.avi,49,1594,1234,360,29.17341977309562,morphological_dilation,3,2
0X24C20970C045D12E.avi,66,980,692,288,41.61849710982659,morphological_dilation,3,2
0X24C59DA367132337.avi,25,1488,1160,328,28.27586206896552,morphological_dilation,3,2
0X24C59DA367132337.avi,39,1395,1067,328,30.740393626991562,morphological_dilation,3,2
0X24C8EA32354AEA68.avi,76,3455,2935,520,17.717206132879046,morphological_dilation,3,2
0X24C8EA32354AEA68.avi,88,2077,1633,444,27.18922229026332,morphological_dilation,3,2
0X24C9CCB070DF24A2.avi,48,1431,1103,328,29.73708068902992,morphological_dilation,3,2
0X24C9CCB070DF24A2.avi,66,1028,736,292,39.67391304347826,morphological_dilation,3,2
0X24D4438DC51DFA0E.avi,71,1204,892,312,34.97757847533632,morphological_dilation,3,2
0X24D4438DC51DFA0E.avi,85,913,629,284,45.151033386327505,morphological_dilation,3,2
0X24DB1B4036794813.avi,73,2376,1948,428,21.971252566735114,morphological_dilation,3,2
0X24DB1B4036794813.avi,88,1352,1004,348,34.66135458167331,morphological_dilation,3,2
0X24DB845BE8C32224.avi,44,1993,1585,408,25.741324921135643,morphological_dilation,3,2
0X24DB845BE8C32224.avi,57,1363,1003,360,35.89232303090728,morphological_dilation,3,2
0X24DBD52BC75C4180.avi,4,1578,1226,352,28.711256117455136,morphological_dilation,3,2
0X24DBD52BC75C4180.avi,19,1104,788,316,40.10152284263959,morphological_dilation,3,2
0X24DCAB4C07F1AD8D.avi,55,1288,968,320,33.057851239669425,morphological_dilation,3,2
0X24DCAB4C07F1AD8D.avi,68,936,656,280,42.68292682926829,morphological_dilation,3,2
0X24DDDEF00414EBC9.avi,28,1713,1345,368,27.360594795539033,morphological_dilation,3,2
0X24DDDEF00414EBC9.avi,47,1084,780,304,38.97435897435898,morphological_dilation,3,2
0X24DEA0FED8614873.avi,107,2479,2015,464,23.027295285359802,morphological_dilation,3,2
0X24DEA0FED8614873.avi,140,2147,1715,432,25.18950437317784,morphological_dilation,3,2
0X24DFAB969E9BD3E0.avi,107,3066,2554,512,20.04698512137823,morphological_dilation,3,2
0X24DFAB969E9BD3E0.avi,128,1782,1358,424,31.22238586156112,morphological_dilation,3,2
0X24DFC8851585B0DD.avi,77,2484,2036,448,22.00392927308448,morphological_dilation,3,2
0X24DFC8851585B0DD.avi,91,1704,1316,388,29.48328267477204,morphological_dilation,3,2
0X24E187AB50EC7783.avi,19,3013,2533,480,18.9498618239242,morphological_dilation,3,2
0X24E187AB50EC7783.avi,31,1514,1146,368,32.11169284467714,morphological_dilation,3,2
0X24E87BD3601FCACD.avi,2,2719,2251,468,20.79075966237228,morphological_dilation,3,2
0X24E87BD3601FCACD.avi,17,1872,1464,408,27.86885245901639,morphological_dilation,3,2
0X24EA617BDDDE90F7.avi,73,2002,1603,399,24.890829694323145,morphological_dilation,3,2
0X24EA617BDDDE90F7.avi,90,1636,1282,354,27.613104524180965,morphological_dilation,3,2
0X24EE7C86ABF22F86.avi,90,2527,2039,488,23.933300637567434,morphological_dilation,3,2
0X24EE7C86ABF22F86.avi,106,1730,1309,421,32.16195569136745,morphological_dilation,3,2
0X24EFBC61D076595F.avi,90,2513,2057,456,22.168206125425378,morphological_dilation,3,2
0X24EFBC61D076595F.avi,104,1870,1450,420,28.965517241379313,morphological_dilation,3,2
0X24F61C272DE6EE2C.avi,90,1546,1166,380,32.59005145797599,morphological_dilation,3,2
0X24F61C272DE6EE2C.avi,101,1098,778,320,41.131105398457585,morphological_dilation,3,2
0X24FD10BD50809882.avi,75,2256,1784,472,26.45739910313901,morphological_dilation,3,2
0X24FD10BD50809882.avi,93,1432,1008,424,42.06349206349206,morphological_dilation,3,2
0X24FE367014EDA4DD.avi,57,1745,1361,384,28.214548126377665,morphological_dilation,3,2
0X24FE367014EDA4DD.avi,79,1154,830,324,39.036144578313255,morphological_dilation,3,2
0X24FEF7D294B35A5B.avi,45,2793,2282,511,22.392638036809817,morphological_dilation,3,2
0X24FEF7D294B35A5B.avi,59,1696,1285,411,31.984435797665366,morphological_dilation,3,2
0X250244FCEBCBC052.avi,108,1183,883,300,33.975084937712346,morphological_dilation,3,2
0X250244FCEBCBC052.avi,115,820,560,260,46.42857142857143,morphological_dilation,3,2
0X2505AECEA36CF52.avi,78,1271,947,324,34.21330517423443,morphological_dilation,3,2
0X2505AECEA36CF52.avi,93,825,541,284,52.495378927911275,morphological_dilation,3,2
0X25067F9AEA265A46.avi,49,1514,1170,344,29.401709401709404,morphological_dilation,3,2
0X25067F9AEA265A46.avi,60,990,690,300,43.47826086956522,morphological_dilation,3,2
0X2507255D8DC30B4E.avi,0,2885,2218,667,30.07213706041479,morphological_dilation,3,2
0X2507255D8DC30B4E.avi,100,1689,1313,376,28.63670982482864,morphological_dilation,3,2
0X250C2239FCD3BC30.avi,138,3237,2648,589,22.24320241691843,morphological_dilation,3,2
0X250C2239FCD3BC30.avi,157,1872,1369,503,36.742147552958365,morphological_dilation,3,2
0X250C34BB262848FB.avi,50,1420,1080,340,31.48148148148148,morphological_dilation,3,2
0X250C34BB262848FB.avi,66,831,544,287,52.75735294117647,morphological_dilation,3,2
0X25153E9120D31CC8.avi,70,4516,3916,600,15.321756894790603,morphological_dilation,3,2
0X25153E9120D31CC8.avi,84,2822,2316,506,21.848013816925736,morphological_dilation,3,2
0X25167816F5C51BF9.avi,105,1632,1253,379,30.24740622505986,morphological_dilation,3,2
0X25167816F5C51BF9.avi,119,1145,809,336,41.5327564894932,morphological_dilation,3,2
0X2516D09AA3CCE8BD.avi,80,1827,1451,376,25.9131633356306,morphological_dilation,3,2
0X2516D09AA3CCE8BD.avi,100,1535,1195,340,28.451882845188287,morphological_dilation,3,2
0X25189F2E27A7255B.avi,112,1836,1437,399,27.766179540709814,morphological_dilation,3,2
0X25189F2E27A7255B.avi,134,1127,803,324,40.34869240348692,morphological_dilation,3,2
0X251EDDF07FB24ACF.avi,43,1634,1282,352,27.45709828393136,morphological_dilation,3,2
0X251EDDF07FB24ACF.avi,62,1097,777,320,41.184041184041185,morphological_dilation,3,2
0X251F4272F05D83ED.avi,37,1543,1195,348,29.121338912133893,morphological_dilation,3,2
0X251F4272F05D83ED.avi,50,948,664,284,42.77108433734939,morphological_dilation,3,2
0X252021CE18C83D44.avi,42,1636,1276,360,28.213166144200624,morphological_dilation,3,2
0X252021CE18C83D44.avi,57,1242,918,324,35.294117647058826,morphological_dilation,3,2
0X25207D09933DFD43.avi,51,1350,1008,342,33.92857142857143,morphological_dilation,3,2
0X25207D09933DFD43.avi,68,841,556,285,51.2589928057554,morphological_dilation,3,2
0X2520973CB1749031.avi,40,3738,3186,552,17.325800376647834,morphological_dilation,3,2
0X2520973CB1749031.avi,57,2098,1654,444,26.844014510278114,morphological_dilation,3,2
0X252C6960C9AF4343.avi,52,1471,1123,348,30.98842386464826,morphological_dilation,3,2
0X252C6960C9AF4343.avi,71,851,591,260,43.9932318104907,morphological_dilation,3,2
0X252E1DC0C5961D6C.avi,42,1894,1510,384,25.43046357615894,morphological_dilation,3,2
0X252E1DC0C5961D6C.avi,53,1312,984,328,33.33333333333333,morphological_dilation,3,2
0X25300D8E61A12BC1.avi,50,1568,1193,375,31.43336127409891,morphological_dilation,3,2
0X25300D8E61A12BC1.avi,68,1155,835,320,38.32335329341318,morphological_dilation,3,2
0X2532193930C4999E.avi,53,2684,2196,488,22.22222222222222,morphological_dilation,3,2
0X2532193930C4999E.avi,71,1684,1280,404,31.5625,morphological_dilation,3,2
0X253BCEAF26478E57.avi,0,1605,1261,344,27.279936558287073,morphological_dilation,3,2
0X253BCEAF26478E57.avi,15,1383,1067,316,29.615745079662602,morphological_dilation,3,2
0X253C4E380393A2D2.avi,52,1999,1607,392,24.393279402613565,morphological_dilation,3,2
0X253C4E380393A2D2.avi,63,1371,1011,360,35.60830860534125,morphological_dilation,3,2
0X253C90A225AEF537.avi,99,2007,1603,404,25.202744853399878,morphological_dilation,3,2
0X253C90A225AEF537.avi,116,1200,864,336,38.88888888888889,morphological_dilation,3,2
0X2540790A197DB384.avi,75,2088,1668,420,25.179856115107913,morphological_dilation,3,2
0X2540790A197DB384.avi,100,1177,865,312,36.06936416184971,morphological_dilation,3,2
0X2542AA1A14E87A14.avi,97,2507,2031,476,23.43673067454456,morphological_dilation,3,2
0X2542AA1A14E87A14.avi,116,1493,1105,388,35.1131221719457,morphological_dilation,3,2
0X2544717E45506688.avi,101,1983,1555,428,27.524115755627008,morphological_dilation,3,2
0X2544717E45506688.avi,117,1310,966,344,35.61076604554865,morphological_dilation,3,2
0X2546A823617AE567.avi,42,1303,975,328,33.64102564102564,morphological_dilation,3,2
0X2546A823617AE567.avi,57,826,558,268,48.028673835125446,morphological_dilation,3,2
0X2549CEDB5C42998D.avi,81,2563,2099,464,22.105764649833255,morphological_dilation,3,2
0X2549CEDB5C42998D.avi,98,1905,1489,416,27.93821356615178,morphological_dilation,3,2
0X254ABDAB4EA3EDF1.avi,2,2120,1697,423,24.926340601060694,morphological_dilation,3,2
0X254ABDAB4EA3EDF1.avi,15,1127,783,344,43.93358876117497,morphological_dilation,3,2
0X254E038B4BBEA091.avi,64,2629,2169,460,21.207929921622867,morphological_dilation,3,2
0X254E038B4BBEA091.avi,77,1478,1106,372,33.634719710669074,morphological_dilation,3,2
0X254E359564F8F57B.avi,84,1550,1210,340,28.09917355371901,morphological_dilation,3,2
0X254E359564F8F57B.avi,96,971,695,276,39.71223021582734,morphological_dilation,3,2
0X254EAC7CF9705B92.avi,49,1268,948,320,33.755274261603375,morphological_dilation,3,2
0X254EAC7CF9705B92.avi,64,846,563,283,50.26642984014209,morphological_dilation,3,2
0X25522AD7521D4273.avi,112,1755,1363,392,28.76008804108584,morphological_dilation,3,2
0X25522AD7521D4273.avi,127,1311,963,348,36.13707165109034,morphological_dilation,3,2
0X2553AFE4965ECA1E.avi,51,1634,1266,368,29.067930489731435,morphological_dilation,3,2
0X2553AFE4965ECA1E.avi,70,972,676,296,43.786982248520715,morphological_dilation,3,2
0X25553AEB1C8D0B7D.avi,61,1952,1560,392,25.128205128205128,morphological_dilation,3,2
0X25553AEB1C8D0B7D.avi,84,1258,938,320,34.11513859275053,morphological_dilation,3,2
0X2558A02B9C207AB7.avi,36,1558,1198,360,30.05008347245409,morphological_dilation,3,2
0X2558A02B9C207AB7.avi,53,1036,732,304,41.53005464480874,morphological_dilation,3,2
0X255B6F7F23189FC3.avi,86,1971,1583,388,24.51042324699937,morphological_dilation,3,2
0X255B6F7F23189FC3.avi,105,1199,879,320,36.40500568828214,morphological_dilation,3,2
0X255CF282AD77EF.avi,57,1514,1146,368,32.11169284467714,morphological_dilation,3,2
0X255CF282AD77EF.avi,66,1000,673,327,48.588410104011885,morphological_dilation,3,2
0X255D1BAE852D2D09.avi,37,1561,1206,355,29.436152570480928,morphological_dilation,3,2
0X255D1BAE852D2D09.avi,53,976,684,292,42.69005847953216,morphological_dilation,3,2
0X256237754531D2A2.avi,3,1532,1184,348,29.39189189189189,morphological_dilation,3,2
0X256237754531D2A2.avi,16,1002,714,288,40.33613445378151,morphological_dilation,3,2
0X25624BE57690EB19.avi,53,1583,1223,360,29.435813573180702,morphological_dilation,3,2
0X25624BE57690EB19.avi,69,998,698,300,42.97994269340974,morphological_dilation,3,2
0X2564F370E5D14459.avi,53,1775,1395,380,27.24014336917563,morphological_dilation,3,2
0X2564F370E5D14459.avi,69,1067,763,304,39.84272608125819,morphological_dilation,3,2
0X25651736878239CE.avi,61,1518,1162,356,30.6368330464716,morphological_dilation,3,2
0X25651736878239CE.avi,78,942,642,300,46.728971962616825,morphological_dilation,3,2
0X2566A541FE945277.avi,45,1233,909,324,35.64356435643564,morphological_dilation,3,2
0X2566A541FE945277.avi,63,858,562,296,52.66903914590747,morphological_dilation,3,2
0X25698E5F54BE0698.avi,3,2126,1726,400,23.174971031286212,morphological_dilation,3,2
0X25698E5F54BE0698.avi,16,1188,892,296,33.18385650224215,morphological_dilation,3,2
0X256A9030D9AB77FD.avi,5,1658,1306,352,26.952526799387442,morphological_dilation,3,2
0X256A9030D9AB77FD.avi,17,1112,812,300,36.94581280788177,morphological_dilation,3,2
0X256B5ADEF784F5FA.avi,104,2105,1681,424,25.223081499107675,morphological_dilation,3,2
0X256B5ADEF784F5FA.avi,119,1161,853,308,36.107854630715124,morphological_dilation,3,2
0X256B964D43ED2F4C.avi,49,2702,2218,484,21.8214607754734,morphological_dilation,3,2
0X256B964D43ED2F4C.avi,66,2103,1679,424,25.25312686122692,morphological_dilation,3,2
0X257DBA22CD382E13.avi,49,1735,1351,384,28.423390081421168,morphological_dilation,3,2
0X257DBA22CD382E13.avi,65,1018,704,314,44.60227272727273,morphological_dilation,3,2
0X257E206A79A1586C.avi,81,1421,1073,348,32.432432432432435,morphological_dilation,3,2
0X257E206A79A1586C.avi,100,820,564,256,45.39007092198582,morphological_dilation,3,2
0X257EF0B5775B242F.avi,44,1822,1434,388,27.05718270571827,morphological_dilation,3,2
0X257EF0B5775B242F.avi,60,1547,1184,363,30.658783783783782,morphological_dilation,3,2
0X2584F54C17C798FF.avi,78,818,562,256,45.55160142348754,morphological_dilation,3,2
0X2584F54C17C798FF.avi,90,600,376,224,59.57446808510638,morphological_dilation,3,2
0X258CC502191AF4EC.avi,36,1629,1261,368,29.183187946074547,morphological_dilation,3,2
0X258CC502191AF4EC.avi,51,958,675,283,41.92592592592593,morphological_dilation,3,2
0X25907540CCAE26A4.avi,71,1774,1399,375,26.804860614724802,morphological_dilation,3,2
0X25907540CCAE26A4.avi,88,1105,813,292,35.916359163591636,morphological_dilation,3,2
0X259464E770C6A619.avi,68,1697,1337,360,26.925953627524308,morphological_dilation,3,2
0X259464E770C6A619.avi,80,1517,1177,340,28.88700084961767,morphological_dilation,3,2
0X25964FF07BC01F9F.avi,42,2440,2000,440,22.0,morphological_dilation,3,2
0X25964FF07BC01F9F.avi,63,1634,1266,368,29.067930489731435,morphological_dilation,3,2
0X2596A4518C3B0F1D.avi,128,2031,1612,419,25.992555831265506,morphological_dilation,3,2
0X2596A4518C3B0F1D.avi,146,1250,907,343,37.81697905181918,morphological_dilation,3,2
0X2596D75079E57033.avi,113,2387,1943,444,22.85126093669583,morphological_dilation,3,2
0X2596D75079E57033.avi,128,1506,1122,384,34.22459893048128,morphological_dilation,3,2
0X259876A5AE3180F9.avi,54,1974,1566,408,26.053639846743295,morphological_dilation,3,2
0X259876A5AE3180F9.avi,71,1205,889,316,35.54555680539933,morphological_dilation,3,2
0X259BD7856D76C702.avi,41,2252,1832,420,22.925764192139738,morphological_dilation,3,2
0X259BD7856D76C702.avi,57,1282,950,332,34.94736842105263,morphological_dilation,3,2
0X259C94B50AFAD96B.avi,65,1435,1095,340,31.05022831050228,morphological_dilation,3,2
0X259C94B50AFAD96B.avi,76,1164,836,328,39.23444976076555,morphological_dilation,3,2
0X259CB75B5D7E779C.avi,153,1427,1083,344,31.763619575253927,morphological_dilation,3,2
0X259CB75B5D7E779C.avi,173,1020,728,292,40.10989010989011,morphological_dilation,3,2
0X259CBD1FA6358DC.avi,51,2246,1815,431,23.7465564738292,morphological_dilation,3,2
0X259CBD1FA6358DC.avi,70,1414,1078,336,31.16883116883117,morphological_dilation,3,2
0X259D527FD2BEAECD.avi,33,2404,1976,428,21.65991902834008,morphological_dilation,3,2
0X259D527FD2BEAECD.avi,51,2009,1625,384,23.63076923076923,morphological_dilation,3,2
0X25A6935E6A8C35CD.avi,51,1278,946,332,35.095137420718814,morphological_dilation,3,2
0X25A6935E6A8C35CD.avi,70,865,589,276,46.859083191850594,morphological_dilation,3,2
0X25A6EA066D812683.avi,40,1973,1559,414,26.55548428479795,morphological_dilation,3,2
0X25A6EA066D812683.avi,60,1572,1200,372,31.0,morphological_dilation,3,2
0X25A7456549F3C925.avi,46,1521,1149,372,32.375979112271544,morphological_dilation,3,2
0X25A7456549F3C925.avi,65,959,653,306,46.86064318529862,morphological_dilation,3,2
0X25A8434F6D4F2256.avi,158,1979,1567,412,26.292278238672623,morphological_dilation,3,2
0X25A8434F6D4F2256.avi,181,1179,851,328,38.54289071680376,morphological_dilation,3,2
0X25B0A5E678CC4D13.avi,92,1846,1454,392,26.960110041265473,morphological_dilation,3,2
0X25B0A5E678CC4D13.avi,108,1168,832,336,40.38461538461539,morphological_dilation,3,2
0X25B9B8065140E94A.avi,102,1542,1178,364,30.89983022071307,morphological_dilation,3,2
0X25B9B8065140E94A.avi,120,1247,907,340,37.48621830209482,morphological_dilation,3,2
0X25BD4EC399A57695.avi,0,1461,1097,364,33.181403828623516,morphological_dilation,3,2
0X25BD4EC399A57695.avi,14,661,413,248,60.048426150121074,morphological_dilation,3,2
0X25BF7A8880B7E925.avi,66,1243,919,324,35.2557127312296,morphological_dilation,3,2
0X25BF7A8880B7E925.avi,81,1046,742,304,40.97035040431267,morphological_dilation,3,2
0X25C020CCF59979A4.avi,52,2594,2146,448,20.87604846225536,morphological_dilation,3,2
0X25C020CCF59979A4.avi,71,1622,1250,372,29.759999999999998,morphological_dilation,3,2
0X25C4CF4384EAA0FA.avi,87,2187,1763,424,24.049914917753828,morphological_dilation,3,2
0X25C4CF4384EAA0FA.avi,103,1280,940,340,36.17021276595745,morphological_dilation,3,2
0X25C5D78648D39291.avi,1,2748,2258,490,21.70062001771479,morphological_dilation,3,2
0X25C5D78648D39291.avi,20,1682,1271,411,32.33674272226593,morphological_dilation,3,2
0X25CB97C76159F8E9.avi,96,1738,1362,376,27.606461086637296,morphological_dilation,3,2
0X25CB97C76159F8E9.avi,113,1279,955,324,33.92670157068063,morphological_dilation,3,2
0X25D144CE38BAC3B5.avi,86,1725,1373,352,25.637290604515663,morphological_dilation,3,2
0X25D144CE38BAC3B5.avi,106,1095,803,292,36.36363636363637,morphological_dilation,3,2
0X25D1BFBDD75BFAAE.avi,106,1365,1025,340,33.170731707317074,morphological_dilation,3,2
0X25D1BFBDD75BFAAE.avi,120,774,524,250,47.70992366412214,morphological_dilation,3,2
0X25D22CAAFC2F06F2.avi,56,2675,2199,476,21.646202819463394,morphological_dilation,3,2
0X25D22CAAFC2F06F2.avi,73,1874,1462,412,28.18057455540356,morphological_dilation,3,2
0X25D27D50A4C85F88.avi,159,1838,1466,372,25.375170532060025,morphological_dilation,3,2
0X25D27D50A4C85F88.avi,173,1148,832,316,37.980769230769226,morphological_dilation,3,2
0X25D3F22462D32922.avi,47,1419,1067,352,32.98969072164948,morphological_dilation,3,2
0X25D3F22462D32922.avi,63,852,576,276,47.91666666666667,morphological_dilation,3,2
0X25D630E0245B8D8.avi,30,1356,1024,332,32.421875,morphological_dilation,3,2
0X25D630E0245B8D8.avi,43,746,478,268,56.06694560669456,morphological_dilation,3,2
0X25D970C75A57B3F2.avi,0,1430,1078,352,32.6530612244898,morphological_dilation,3,2
0X25D970C75A57B3F2.avi,16,1026,730,296,40.54794520547945,morphological_dilation,3,2
0X25DD6BFF7103EB50.avi,53,1843,1447,396,27.36696613683483,morphological_dilation,3,2
0X25DD6BFF7103EB50.avi,71,1162,830,332,40.0,morphological_dilation,3,2
0X25E1A2FEB38D5C1A.avi,44,1570,1192,378,31.711409395973156,morphological_dilation,3,2
0X25E1A2FEB38D5C1A.avi,65,1015,702,313,44.58689458689459,morphological_dilation,3,2
0X25E3D9E8E02E9F8C.avi,44,2128,1704,424,24.88262910798122,morphological_dilation,3,2
0X25E3D9E8E02E9F8C.avi,60,1387,1039,348,33.49374398460058,morphological_dilation,3,2
0X25E51194DDD25625.avi,96,2416,1976,440,22.267206477732792,morphological_dilation,3,2
0X25E51194DDD25625.avi,107,1546,1175,371,31.574468085106382,morphological_dilation,3,2
0X25E65648D14CF132.avi,162,2576,2128,448,21.052631578947366,morphological_dilation,3,2
0X25E65648D14CF132.avi,182,1703,1331,372,27.948910593538695,morphological_dilation,3,2
0X25EA04C3BB5BD73A.avi,126,1200,892,308,34.52914798206278,morphological_dilation,3,2
0X25EA04C3BB5BD73A.avi,138,793,533,260,48.78048780487805,morphological_dilation,3,2
0X25F3ABD0BC56E0FC.avi,109,2302,1858,444,23.896663078579117,morphological_dilation,3,2
0X25F3ABD0BC56E0FC.avi,125,1423,1067,356,33.364573570759134,morphological_dilation,3,2
0X25FDAC4206518E5D.avi,64,3198,2675,523,19.55140186915888,morphological_dilation,3,2
0X25FDAC4206518E5D.avi,84,1868,1432,436,30.446927374301673,morphological_dilation,3,2
0X260124F79F295A76.avi,62,3172,2652,520,19.607843137254903,morphological_dilation,3,2
0X260124F79F295A76.avi,79,1964,1545,419,27.119741100323623,morphological_dilation,3,2
0X260767549892A590.avi,0,1891,1499,392,26.150767178118745,morphological_dilation,3,2
0X260767549892A590.avi,14,1520,1172,348,29.692832764505116,morphological_dilation,3,2
0X260789ADF320D4F8.avi,2,2231,1784,447,25.05605381165919,morphological_dilation,3,2
0X260789ADF320D4F8.avi,23,1466,1101,365,33.15168029064487,morphological_dilation,3,2
0X2608D27FDE98149F.avi,38,1708,1308,400,30.58103975535168,morphological_dilation,3,2
0X2608D27FDE98149F.avi,55,1143,803,340,42.34122042341221,morphological_dilation,3,2
0X260C36268AE552EB.avi,111,1845,1461,384,26.283367556468175,morphological_dilation,3,2
0X260C36268AE552EB.avi,123,1116,798,318,39.849624060150376,morphological_dilation,3,2
0X260C383010AEF14B.avi,91,3090,2579,511,19.81388134936022,morphological_dilation,3,2
0X260C383010AEF14B.avi,108,2352,1908,444,23.270440251572328,morphological_dilation,3,2
0X260D4D63B7684BDD.avi,75,1814,1410,404,28.652482269503547,morphological_dilation,3,2
0X260D4D63B7684BDD.avi,90,1605,1205,400,33.19502074688796,morphological_dilation,3,2
0X2617EE50F758E3C5.avi,45,1926,1512,414,27.380952380952383,morphological_dilation,3,2
0X2617EE50F758E3C5.avi,61,1573,1196,377,31.521739130434785,morphological_dilation,3,2
0X26206D5594CF7FB2.avi,71,2359,1923,436,22.67290691627665,morphological_dilation,3,2
0X26206D5594CF7FB2.avi,84,1982,1566,416,26.56449553001277,morphological_dilation,3,2
0X2620ED756670917C.avi,49,2177,1741,436,25.04307869040781,morphological_dilation,3,2
0X2620ED756670917C.avi,64,1261,897,364,40.57971014492754,morphological_dilation,3,2
0X26253C5173D9E765.avi,59,1956,1552,404,26.03092783505155,morphological_dilation,3,2
0X26253C5173D9E765.avi,75,1247,907,340,37.48621830209482,morphological_dilation,3,2
0X262735F84D104CDD.avi,63,2409,1965,444,22.595419847328245,morphological_dilation,3,2
0X262735F84D104CDD.avi,80,1530,1159,371,32.01035375323555,morphological_dilation,3,2
0X262D48995AF25D8D.avi,46,2606,2147,459,21.37866790870983,morphological_dilation,3,2
0X262D48995AF25D8D.avi,62,1464,1108,356,32.12996389891697,morphological_dilation,3,2
0X262EA10B2898736E.avi,56,1868,1480,388,26.216216216216214,morphological_dilation,3,2
0X262EA10B2898736E.avi,65,1295,963,332,34.47559709241953,morphological_dilation,3,2
0X2630F7B1E8035F5B.avi,102,1807,1431,376,26.275331935709296,morphological_dilation,3,2
0X2630F7B1E8035F5B.avi,117,1511,1157,354,30.596369922212617,morphological_dilation,3,2
0X2635B9BFE175C8E4.avi,45,1611,1239,372,30.024213075060537,morphological_dilation,3,2
0X2635B9BFE175C8E4.avi,66,1053,737,316,42.87652645861601,morphological_dilation,3,2
0X263A95AED78DF1B2.avi,0,1823,1411,412,29.199149539333806,morphological_dilation,3,2
0X263A95AED78DF1B2.avi,20,1044,732,312,42.62295081967213,morphological_dilation,3,2
0X263BDA8DEDBBDBAA.avi,55,1771,1391,380,27.31847591660676,morphological_dilation,3,2
0X263BDA8DEDBBDBAA.avi,73,1196,872,324,37.15596330275229,morphological_dilation,3,2
0X263C6A56C2FAA248.avi,37,1259,939,320,34.07880724174654,morphological_dilation,3,2
0X263C6A56C2FAA248.avi,54,739,471,268,56.90021231422505,morphological_dilation,3,2
0X2641B2DB74DE3FF1.avi,24,1584,1221,363,29.72972972972973,morphological_dilation,3,2
0X2641B2DB74DE3FF1.avi,35,980,692,288,41.61849710982659,morphological_dilation,3,2
0X26444E1ACD4FE90F.avi,55,1537,1185,352,29.70464135021097,morphological_dilation,3,2
0X26444E1ACD4FE90F.avi,69,1000,700,300,42.857142857142854,morphological_dilation,3,2
0X2649959DDB6CA52B.avi,46,1482,1146,336,29.31937172774869,morphological_dilation,3,2
0X2649959DDB6CA52B.avi,58,903,623,280,44.9438202247191,morphological_dilation,3,2
0X264B6A93D7EE624A.avi,3,2238,1794,444,24.74916387959866,morphological_dilation,3,2
0X264B6A93D7EE624A.avi,23,1677,1281,396,30.913348946135834,morphological_dilation,3,2
0X264C65C2ABBD368.avi,73,1947,1551,396,25.53191489361702,morphological_dilation,3,2
0X264C65C2ABBD368.avi,91,1211,887,324,36.52762119503946,morphological_dilation,3,2
0X264CFB8943A84B48.avi,30,1426,1086,340,31.30755064456722,morphological_dilation,3,2
0X264CFB8943A84B48.avi,42,919,639,280,43.81846635367762,morphological_dilation,3,2
0X264FE9E65AF38F05.avi,5,2112,1720,392,22.790697674418606,morphological_dilation,3,2
0X264FE9E65AF38F05.avi,31,1433,1097,336,30.628988149498632,morphological_dilation,3,2
0X2651CD8338B30EB.avi,107,1505,1165,340,29.184549356223176,morphological_dilation,3,2
0X2651CD8338B30EB.avi,123,1011,723,288,39.83402489626556,morphological_dilation,3,2
0X26549E8D48ABC8DC.avi,55,1455,1107,348,31.43631436314363,morphological_dilation,3,2
0X26549E8D48ABC8DC.avi,68,1039,739,300,40.59539918809202,morphological_dilation,3,2
0X2654E4234D69980A.avi,58,1617,1245,372,29.87951807228916,morphological_dilation,3,2
0X2654E4234D69980A.avi,74,1025,721,304,42.163661581137305,morphological_dilation,3,2
0X265A95FC3A21FE5.avi,48,1833,1453,380,26.15278733654508,morphological_dilation,3,2
0X265A95FC3A21FE5.avi,65,1248,936,312,33.33333333333333,morphological_dilation,3,2
0X265D6BCE92090FFC.avi,59,1552,1184,368,31.08108108108108,morphological_dilation,3,2
0X265D6BCE92090FFC.avi,81,1037,729,308,42.249657064471876,morphological_dilation,3,2
0X265F7C106F4A0B62.avi,36,2540,2088,452,21.64750957854406,morphological_dilation,3,2
0X265F7C106F4A0B62.avi,53,1719,1336,383,28.66766467065868,morphological_dilation,3,2
0X2660492955910B85.avi,38,1821,1429,392,27.43177046885934,morphological_dilation,3,2
0X2660492955910B85.avi,53,1363,1033,330,31.945788964181993,morphological_dilation,3,2
0X26626AAEFAAEEC0.avi,0,1834,1454,380,26.13480055020633,morphological_dilation,3,2
0X26626AAEFAAEEC0.avi,13,1066,758,308,40.633245382585756,morphological_dilation,3,2
0X26635CBAB84870AA.avi,127,1465,1101,364,33.060853769300635,morphological_dilation,3,2
0X26635CBAB84870AA.avi,143,877,587,290,49.40374787052811,morphological_dilation,3,2
0X2665FA8EF7EEDA20.avi,86,1997,1593,404,25.360954174513495,morphological_dilation,3,2
0X2665FA8EF7EEDA20.avi,102,1241,917,324,35.33260632497274,morphological_dilation,3,2
0X266AD7E3C2CC1BE.avi,46,1602,1218,384,31.527093596059114,morphological_dilation,3,2
0X266AD7E3C2CC1BE.avi,60,969,677,292,43.1314623338257,morphological_dilation,3,2
0X266D751D516B1711.avi,163,2932,2428,504,20.757825370675455,morphological_dilation,3,2
0X266D751D516B1711.avi,184,1862,1431,431,30.118798043326343,morphological_dilation,3,2
0X267065C982C08D41.avi,89,2139,1698,441,25.97173144876325,morphological_dilation,3,2
0X267065C982C08D41.avi,109,1383,999,384,38.43843843843844,morphological_dilation,3,2
0X2670CCCA311E7C7D.avi,92,3080,2564,516,20.12480499219969,morphological_dilation,3,2
0X2670CCCA311E7C7D.avi,108,1885,1457,428,29.375428963623882,morphological_dilation,3,2
0X2671B367BF1DBB8B.avi,105,1836,1448,388,26.795580110497237,morphological_dilation,3,2
0X2671B367BF1DBB8B.avi,126,1142,817,325,39.7796817625459,morphological_dilation,3,2
0X26760E1AE0AA7123.avi,42,1415,1071,344,32.11951447245565,morphological_dilation,3,2
0X26760E1AE0AA7123.avi,57,901,625,276,44.16,morphological_dilation,3,2
0X2676C392F6C80EBD.avi,4,2146,1714,432,25.204200700116687,morphological_dilation,3,2
0X2676C392F6C80EBD.avi,16,1410,1054,356,33.776091081593925,morphological_dilation,3,2
0X267B31C01341EDBA.avi,46,2303,1863,440,23.617820719269993,morphological_dilation,3,2
0X267B31C01341EDBA.avi,65,1610,1226,384,31.321370309951057,morphological_dilation,3,2
0X267E2148259DAA74.avi,53,1047,751,296,39.41411451398136,morphological_dilation,3,2
0X267E2148259DAA74.avi,67,669,413,256,61.98547215496368,morphological_dilation,3,2
0X267E5D3B36A34A6C.avi,31,2126,1706,420,24.6189917936694,morphological_dilation,3,2
0X267E5D3B36A34A6C.avi,49,1408,1045,363,34.73684210526316,morphological_dilation,3,2
0X26804C474CA9671C.avi,31,2213,1741,472,27.110855829982768,morphological_dilation,3,2
0X26804C474CA9671C.avi,41,1440,1057,383,36.23462630085147,morphological_dilation,3,2
0X268D722E60E6E7EC.avi,87,2971,2479,492,19.846712384025817,morphological_dilation,3,2
0X268D722E60E6E7EC.avi,102,1836,1420,416,29.295774647887324,morphological_dilation,3,2
0X26902A58F384934F.avi,2,1065,721,344,47.71151178918169,morphological_dilation,3,2
0X26902A58F384934F.avi,16,668,373,295,79.08847184986595,morphological_dilation,3,2
0X2694F675274D5ED6.avi,57,1526,1174,352,29.982964224872234,morphological_dilation,3,2
0X2694F675274D5ED6.avi,75,983,687,296,43.085880640465795,morphological_dilation,3,2
0X2698E0A4C8C7777C.avi,79,1782,1394,388,27.83357245337159,morphological_dilation,3,2
0X2698E0A4C8C7777C.avi,96,1143,811,332,40.93711467324291,morphological_dilation,3,2
0X269BDCE2A6A294AB.avi,55,1789,1401,388,27.69450392576731,morphological_dilation,3,2
0X269BDCE2A6A294AB.avi,69,1185,861,324,37.63066202090592,morphological_dilation,3,2
0X26A12BDA55DE0DDE.avi,75,2035,1639,396,24.161073825503358,morphological_dilation,3,2
0X26A12BDA55DE0DDE.avi,90,1637,1293,344,26.604795050270692,morphological_dilation,3,2
0X26A8F239F3777D92.avi,35,1948,1560,388,24.871794871794872,morphological_dilation,3,2
0X26A8F239F3777D92.avi,52,1740,1360,380,27.941176470588236,morphological_dilation,3,2
0X26A955191AA5D386.avi,119,1184,880,304,34.54545454545455,morphological_dilation,3,2
0X26A955191AA5D386.avi,137,751,491,260,52.953156822810584,morphological_dilation,3,2
0X26ABE39755AB6CA8.avi,49,1338,986,352,35.699797160243406,morphological_dilation,3,2
0X26ABE39755AB6CA8.avi,62,883,591,292,49.407783417935704,morphological_dilation,3,2
0X26AC778A988D76C1.avi,69,1917,1497,420,28.0561122244489,morphological_dilation,3,2
0X26AC778A988D76C1.avi,87,1167,824,343,41.62621359223301,morphological_dilation,3,2
0X26ACBFDFA9C147C6.avi,36,1470,1106,364,32.91139240506329,morphological_dilation,3,2
0X26ACBFDFA9C147C6.avi,49,892,584,308,52.73972602739726,morphological_dilation,3,2
0X26B10F18D3BA321B.avi,1,1699,1339,360,26.8857356235997,morphological_dilation,3,2
0X26B10F18D3BA321B.avi,20,1044,736,308,41.84782608695652,morphological_dilation,3,2
0X26B209C0083A4AD5.avi,41,2155,1735,420,24.207492795389047,morphological_dilation,3,2
0X26B209C0083A4AD5.avi,56,1561,1193,368,30.846605196982395,morphological_dilation,3,2
0X26B4D2AD6ECD2F2.avi,45,1819,1439,380,26.40722724113968,morphological_dilation,3,2
0X26B4D2AD6ECD2F2.avi,65,1276,940,336,35.74468085106383,morphological_dilation,3,2
0X26B75629377907FA.avi,92,2128,1720,408,23.72093023255814,morphological_dilation,3,2
0X26B75629377907FA.avi,105,1819,1447,372,25.70836212854181,morphological_dilation,3,2
0X26BCB772A8DD9BEC.avi,38,2820,2336,484,20.71917808219178,morphological_dilation,3,2
0X26BCB772A8DD9BEC.avi,55,1934,1499,435,29.01934623082055,morphological_dilation,3,2
0X26C216A513F3EE72.avi,48,929,644,285,44.254658385093165,morphological_dilation,3,2
0X26C216A513F3EE72.avi,61,652,392,260,66.3265306122449,morphological_dilation,3,2
0X26C6F8397D6EC0.avi,120,2197,1757,440,25.04268639726807,morphological_dilation,3,2
0X26C6F8397D6EC0.avi,133,1343,995,348,34.9748743718593,morphological_dilation,3,2
0X26C7FACA5C9DFA73.avi,68,1263,939,324,34.504792332268366,morphological_dilation,3,2
0X26C7FACA5C9DFA73.avi,82,996,696,300,43.103448275862064,morphological_dilation,3,2
0X26C9C9504E3472BC.avi,46,1833,1441,392,27.203331020124917,morphological_dilation,3,2
0X26C9C9504E3472BC.avi,60,1381,1033,348,33.68828654404646,morphological_dilation,3,2
0X26CCB26A138F5904.avi,42,2404,1960,444,22.653061224489797,morphological_dilation,3,2
0X26CCB26A138F5904.avi,65,1398,1046,352,33.652007648183556,morphological_dilation,3,2
0X26CCD2B933FE44D1.avi,100,1403,1063,340,31.984948259642522,morphological_dilation,3,2
0X26CCD2B933FE44D1.avi,115,943,659,284,43.09559939301973,morphological_dilation,3,2
0X26CD1BC6C11A3861.avi,42,1159,831,328,39.4705174488568,morphological_dilation,3,2
0X26CD1BC6C11A3861.avi,58,714,450,264,58.666666666666664,morphological_dilation,3,2
0X26CF0F0BCD885F65.avi,4,2459,1999,460,23.011505752876438,morphological_dilation,3,2
0X26CF0F0BCD885F65.avi,23,1494,1150,344,29.91304347826087,morphological_dilation,3,2
0X26DC58E11003BCA1.avi,83,2054,1654,400,24.18379685610641,morphological_dilation,3,2
0X26DC58E11003BCA1.avi,97,1351,1011,340,33.63006923837784,morphological_dilation,3,2
0X26DCA2BE77293D2D.avi,55,1367,1023,344,33.62658846529814,morphological_dilation,3,2
0X26DCA2BE77293D2D.avi,66,1040,740,300,40.54054054054054,morphological_dilation,3,2
0X26DCCCBC2614214.avi,45,2184,1748,436,24.94279176201373,morphological_dilation,3,2
0X26DCCCBC2614214.avi,61,1489,1109,380,34.265103697024344,morphological_dilation,3,2
0X26DD260B02C5900C.avi,42,1672,1296,376,29.01234567901235,morphological_dilation,3,2
0X26DD260B02C5900C.avi,53,952,656,296,45.1219512195122,morphological_dilation,3,2
0X26DDEAE1C3A6A05.avi,100,1604,1252,352,28.115015974440894,morphological_dilation,3,2
0X26DDEAE1C3A6A05.avi,110,990,690,300,43.47826086956522,morphological_dilation,3,2
0X26E20CDE56AEEAF3.avi,4,2106,1694,412,24.321133412042503,morphological_dilation,3,2
0X26E20CDE56AEEAF3.avi,20,1269,937,332,35.432230522945574,morphological_dilation,3,2
0X26E2492AD4BD86A9.avi,46,2029,1614,415,25.712515489467165,morphological_dilation,3,2
0X26E2492AD4BD86A9.avi,60,1205,860,345,40.116279069767444,morphological_dilation,3,2
0X26E286395968E8C2.avi,34,1565,1209,356,29.44582299421009,morphological_dilation,3,2
0X26E286395968E8C2.avi,47,911,627,284,45.29505582137161,morphological_dilation,3,2
0X26E3E2CF4D4EC82B.avi,81,2484,2044,440,21.52641878669276,morphological_dilation,3,2
0X26E3E2CF4D4EC82B.avi,100,1680,1296,384,29.629629629629626,morphological_dilation,3,2
0X26E6C7FBCBD4AB54.avi,1,1999,1579,420,26.599113362887906,morphological_dilation,3,2
0X26E6C7FBCBD4AB54.avi,21,1244,901,343,38.06881243063263,morphological_dilation,3,2
0X26EA0A49954B4816.avi,51,1874,1490,384,25.771812080536915,morphological_dilation,3,2
0X26EA0A49954B4816.avi,66,1185,873,312,35.738831615120276,morphological_dilation,3,2
0X26EB82C1481E10E7.avi,35,1456,1108,348,31.40794223826715,morphological_dilation,3,2
0X26EB82C1481E10E7.avi,49,894,626,268,42.81150159744409,morphological_dilation,3,2
0X26EBEDBF286CD649.avi,97,1070,778,292,37.53213367609254,morphological_dilation,3,2
0X26EBEDBF286CD649.avi,113,716,468,248,52.991452991452995,morphological_dilation,3,2
0X26F143D493EF7B90.avi,145,1754,1394,360,25.82496413199426,morphological_dilation,3,2
0X26F143D493EF7B90.avi,157,1149,833,316,37.935174069627855,morphological_dilation,3,2
0X26F4ACC4D1DE761E.avi,110,1099,815,284,34.84662576687116,morphological_dilation,3,2
0X26F4ACC4D1DE761E.avi,130,885,613,272,44.37194127243067,morphological_dilation,3,2
0X2704E5FD2037088E.avi,34,1487,1139,348,30.553116769095702,morphological_dilation,3,2
0X2704E5FD2037088E.avi,47,979,687,292,42.503639010189225,morphological_dilation,3,2
0X27077CF4CF371370.avi,200,3018,2506,512,20.43096568236233,morphological_dilation,3,2
0X27077CF4CF371370.avi,235,1738,1330,408,30.67669172932331,morphological_dilation,3,2
0X2709CA13E0E58743.avi,76,2909,2401,508,21.157850895460225,morphological_dilation,3,2
0X2709CA13E0E58743.avi,93,1616,1232,384,31.16883116883117,morphological_dilation,3,2
0X270BF3E8EC3136C9.avi,58,1798,1414,384,27.157001414427157,morphological_dilation,3,2
0X270BF3E8EC3136C9.avi,86,1168,840,328,39.04761904761905,morphological_dilation,3,2
0X27135E2E874381AA.avi,103,2180,1752,428,24.429223744292237,morphological_dilation,3,2
0X27135E2E874381AA.avi,119,1325,929,396,42.6264800861141,morphological_dilation,3,2
0X271545171DA5B5F5.avi,66,1554,1186,368,31.02866779089376,morphological_dilation,3,2
0X271545171DA5B5F5.avi,88,1015,711,304,42.75668073136428,morphological_dilation,3,2
0X27187ECFBEB82A72.avi,69,1053,753,300,39.8406374501992,morphological_dilation,3,2
0X27187ECFBEB82A72.avi,91,631,377,254,67.37400530503979,morphological_dilation,3,2
0X271A48B44C62AFDA.avi,0,2518,2082,436,20.941402497598464,morphological_dilation,3,2
0X271A48B44C62AFDA.avi,13,1683,1319,364,27.596664139499623,morphological_dilation,3,2
0X271C112B61F00E3A.avi,114,2970,2462,508,20.633631194151096,morphological_dilation,3,2
0X271C112B61F00E3A.avi,129,1747,1347,400,29.695619896065327,morphological_dilation,3,2
0X271C3AE602E3785C.avi,54,2856,2368,488,20.60810810810811,morphological_dilation,3,2
0X271C3AE602E3785C.avi,73,1915,1491,424,28.437290409121395,morphological_dilation,3,2
0X272447C91729F139.avi,41,1486,1144,342,29.895104895104897,morphological_dilation,3,2
0X272447C91729F139.avi,56,1056,760,296,38.94736842105263,morphological_dilation,3,2
0X27250C8B6DF1D971.avi,39,1035,708,327,46.186440677966104,morphological_dilation,3,2
0X27250C8B6DF1D971.avi,60,518,286,232,81.11888111888112,morphological_dilation,3,2
0X2728207F531EE47D.avi,40,2005,1597,408,25.547902316844084,morphological_dilation,3,2
0X2728207F531EE47D.avi,53,1172,840,332,39.523809523809526,morphological_dilation,3,2
0X272940207C572D60.avi,57,1430,1086,344,31.675874769797424,morphological_dilation,3,2
0X272940207C572D60.avi,77,1129,817,312,38.188494492044065,morphological_dilation,3,2
0X272A1770B9F8E6A0.avi,81,1926,1534,392,25.554106910039113,morphological_dilation,3,2
0X272A1770B9F8E6A0.avi,99,1693,1329,364,27.389014296463504,morphological_dilation,3,2
0X272CBEA136AB2FC5.avi,44,2941,2465,476,19.310344827586206,morphological_dilation,3,2
0X272CBEA136AB2FC5.avi,59,1909,1493,416,27.863362357669125,morphological_dilation,3,2
0X272D953C352803EA.avi,53,1841,1457,384,26.355525051475638,morphological_dilation,3,2
0X272D953C352803EA.avi,73,1557,1213,344,28.359439406430337,morphological_dilation,3,2
0X27350E8706E23F95.avi,132,1977,1577,400,25.36461636017755,morphological_dilation,3,2
0X27350E8706E23F95.avi,151,1444,1072,372,34.701492537313435,morphological_dilation,3,2
0X2736D654E5082786.avi,0,1532,1172,360,30.716723549488055,morphological_dilation,3,2
0X2736D654E5082786.avi,18,893,581,312,53.700516351118765,morphological_dilation,3,2
0X273A6EE131B06F89.avi,35,1679,1295,384,29.65250965250965,morphological_dilation,3,2
0X273A6EE131B06F89.avi,54,972,668,304,45.50898203592814,morphological_dilation,3,2
0X273A8DAD815E005C.avi,91,2117,1705,412,24.164222873900293,morphological_dilation,3,2
0X273A8DAD815E005C.avi,106,1537,1189,348,29.268292682926827,morphological_dilation,3,2
0X273E4A9DF1C9DAC9.avi,52,1147,843,304,36.06168446026097,morphological_dilation,3,2
0X273E4A9DF1C9DAC9.avi,70,724,471,253,53.71549893842887,morphological_dilation,3,2
0X274474F672CA7CCA.avi,0,2308,1856,452,24.353448275862068,morphological_dilation,3,2
0X274474F672CA7CCA.avi,15,1559,1177,382,32.4553950722175,morphological_dilation,3,2
0X2749DB8810BA40F9.avi,43,1655,1275,380,29.80392156862745,morphological_dilation,3,2
0X2749DB8810BA40F9.avi,57,1013,725,288,39.724137931034484,morphological_dilation,3,2
0X27508F921B0D7D12.avi,94,2625,2153,472,21.92289828146772,morphological_dilation,3,2
0X27508F921B0D7D12.avi,112,1488,1116,372,33.33333333333333,morphological_dilation,3,2
0X2752526D9BC50FE3.avi,47,2917,2429,488,20.09057225195554,morphological_dilation,3,2
0X2752526D9BC50FE3.avi,65,1920,1508,412,27.320954907161806,morphological_dilation,3,2
0X2753C50A8B05D7D5.avi,72,1592,1224,368,30.065359477124183,morphological_dilation,3,2
0X2753C50A8B05D7D5.avi,84,1035,727,308,42.36588720770289,morphological_dilation,3,2
0X2754B4D0ABE17BD0.avi,81,2256,1824,432,23.684210526315788,morphological_dilation,3,2
0X2754B4D0ABE17BD0.avi,99,1908,1508,400,26.525198938992045,morphological_dilation,3,2
0X2755371160DC96FC.avi,57,1755,1371,384,28.00875273522976,morphological_dilation,3,2
0X2755371160DC96FC.avi,84,1165,848,317,37.38207547169811,morphological_dilation,3,2
0X275ABCD76B8D34C0.avi,64,1435,1071,364,33.98692810457516,morphological_dilation,3,2
0X275ABCD76B8D34C0.avi,77,1192,860,332,38.604651162790695,morphological_dilation,3,2
0X275B6562C2CAB56D.avi,42,1572,1228,344,28.013029315960914,morphological_dilation,3,2
0X275B6562C2CAB56D.avi,55,975,695,280,40.28776978417266,morphological_dilation,3,2
0X275C7438812C25A1.avi,101,1404,1040,364,35.0,morphological_dilation,3,2
0X275C7438812C25A1.avi,115,829,557,272,48.83303411131059,morphological_dilation,3,2
0X276409ED976E48CA.avi,40,1848,1468,380,25.885558583106267,morphological_dilation,3,2
0X276409ED976E48CA.avi,60,1066,740,326,44.054054054054056,morphological_dilation,3,2
0X2764D7135244AB7A.avi,79,1987,1572,415,26.39949109414758,morphological_dilation,3,2
0X2764D7135244AB7A.avi,96,1234,898,336,37.41648106904232,morphological_dilation,3,2
0X2768CE554B3E0BED.avi,146,2185,1721,464,26.96106914584544,morphological_dilation,3,2
0X2768CE554B3E0BED.avi,163,1387,981,406,41.386340468909275,morphological_dilation,3,2
0X276B38EA6C9DED77.avi,39,2149,1697,452,26.635238656452564,morphological_dilation,3,2
0X276B38EA6C9DED77.avi,55,1420,1058,362,34.215500945179585,morphological_dilation,3,2
0X276C46369286E618.avi,65,1435,1087,348,32.01471941122355,morphological_dilation,3,2
0X276C46369286E618.avi,72,1021,701,320,45.6490727532097,morphological_dilation,3,2
0X276DED2DD51341DA.avi,52,1684,1304,380,29.141104294478527,morphological_dilation,3,2
0X276DED2DD51341DA.avi,71,1027,719,308,42.83727399165508,morphological_dilation,3,2
0X2774E9E5AFD94FFD.avi,49,1799,1403,396,28.225231646471844,morphological_dilation,3,2
0X2774E9E5AFD94FFD.avi,73,1598,1226,372,30.342577487765087,morphological_dilation,3,2
0X2774EAE17709B110.avi,105,2502,2022,480,23.738872403560833,morphological_dilation,3,2
0X2774EAE17709B110.avi,121,1556,1135,421,37.092511013215855,morphological_dilation,3,2
0X2776B06CA00EE370.avi,115,1894,1486,408,27.456258411843876,morphological_dilation,3,2
0X2776B06CA00EE370.avi,129,1155,819,336,41.02564102564102,morphological_dilation,3,2
0X2778AF8121E07236.avi,37,3127,2568,559,21.76791277258567,morphological_dilation,3,2
0X2778AF8121E07236.avi,50,1761,1312,449,34.22256097560975,morphological_dilation,3,2
0X277FC348812C0E79.avi,74,1932,1532,400,26.109660574412537,morphological_dilation,3,2
0X277FC348812C0E79.avi,90,1692,1324,368,27.794561933534744,morphological_dilation,3,2
0X27836E538BD008A.avi,49,2224,1788,436,24.384787472035793,morphological_dilation,3,2
0X27836E538BD008A.avi,69,1435,1067,368,34.4892221180881,morphological_dilation,3,2
0X278A875DF27E7F42.avi,70,1641,1243,398,32.01930812550282,morphological_dilation,3,2
0X278A875DF27E7F42.avi,86,1107,791,316,39.94943109987358,morphological_dilation,3,2
0X2790203453E55347.avi,84,1862,1478,384,25.98105548037889,morphological_dilation,3,2
0X2790203453E55347.avi,101,1288,968,320,33.057851239669425,morphological_dilation,3,2
0X2795D1D6CC01F594.avi,44,1836,1444,392,27.146814404432135,morphological_dilation,3,2
0X2795D1D6CC01F594.avi,62,1092,771,321,41.63424124513619,morphological_dilation,3,2
0X2795F92CA80D4F5F.avi,45,1057,765,292,38.169934640522875,morphological_dilation,3,2
0X2795F92CA80D4F5F.avi,64,772,508,264,51.96850393700787,morphological_dilation,3,2
0X2797ABAED6ABCE28.avi,83,3123,2603,520,19.976949673453706,morphological_dilation,3,2
0X2797ABAED6ABCE28.avi,102,2553,2093,460,21.978021978021978,morphological_dilation,3,2
0X279B82BB85870F8D.avi,70,1542,1178,364,30.89983022071307,morphological_dilation,3,2
0X279B82BB85870F8D.avi,80,1131,803,328,40.846824408468244,morphological_dilation,3,2
0X279CA7868FB35FB2.avi,69,3101,2612,489,18.72128637059724,morphological_dilation,3,2
0X279CA7868FB35FB2.avi,84,1948,1528,420,27.486910994764397,morphological_dilation,3,2
0X27A14489647DFCB.avi,1,1160,876,284,32.42009132420091,morphological_dilation,3,2
0X27A14489647DFCB.avi,13,1157,828,329,39.73429951690821,morphological_dilation,3,2
0X27A172BEF8B816CD.avi,32,1893,1509,384,25.44731610337972,morphological_dilation,3,2
0X27A172BEF8B816CD.avi,49,1009,705,304,43.12056737588652,morphological_dilation,3,2
0X27A4A5840BC00390.avi,107,3054,2502,552,22.062350119904075,morphological_dilation,3,2
0X27A4A5840BC00390.avi,126,1944,1496,448,29.946524064171122,morphological_dilation,3,2
0X27AB73CC472E519D.avi,38,2755,2272,483,21.258802816901408,morphological_dilation,3,2
0X27AB73CC472E519D.avi,60,1600,1208,392,32.450331125827816,morphological_dilation,3,2
0X27AD2D53372C8B2C.avi,52,2215,1779,436,24.50815064643058,morphological_dilation,3,2
0X27AD2D53372C8B2C.avi,70,1298,938,360,38.37953091684435,morphological_dilation,3,2
0X27AE655830163CF2.avi,89,1532,1180,352,29.830508474576273,morphological_dilation,3,2
0X27AE655830163CF2.avi,108,927,643,284,44.16796267496112,morphological_dilation,3,2
0X27B4E7A56393A167.avi,104,2606,2146,460,21.435228331780056,morphological_dilation,3,2
0X27B4E7A56393A167.avi,123,1678,1306,372,28.483920367534456,morphological_dilation,3,2
0X27B83995F6D5BDBB.avi,63,1193,869,324,37.284234752589185,morphological_dilation,3,2
0X27B83995F6D5BDBB.avi,78,727,467,260,55.6745182012848,morphological_dilation,3,2
0X27BBC1D9367BD3F.avi,61,3637,3089,548,17.740369051472967,morphological_dilation,3,2
0X27BBC1D9367BD3F.avi,84,2368,1912,456,23.84937238493724,morphological_dilation,3,2
0X27BF8122053FB24F.avi,105,1718,1322,396,29.954614220877456,morphological_dilation,3,2
0X27BF8122053FB24F.avi,116,1075,751,324,43.142476697736356,morphological_dilation,3,2
0X27C0E8036DA99281.avi,117,2591,2115,476,22.505910165484632,morphological_dilation,3,2
0X27C0E8036DA99281.avi,136,1668,1264,404,31.962025316455694,morphological_dilation,3,2
0X27C871612E887EF6.avi,96,3025,2525,500,19.801980198019802,morphological_dilation,3,2
0X27C871612E887EF6.avi,116,1824,1412,412,29.178470254957507,morphological_dilation,3,2
0X27CA6FFE2C5843BD.avi,0,1143,851,292,34.312573443008226,morphological_dilation,3,2
0X27CA6FFE2C5843BD.avi,14,875,611,264,43.207855973813416,morphological_dilation,3,2
0X27CC9C6EAF53A68F.avi,58,3056,2536,520,20.50473186119874,morphological_dilation,3,2
0X27CC9C6EAF53A68F.avi,76,1993,1553,440,28.3322601416613,morphological_dilation,3,2
0X27D24C1F2489FB74.avi,45,1851,1451,400,27.567195037904895,morphological_dilation,3,2
0X27D24C1F2489FB74.avi,61,1532,1179,353,29.940627650551317,morphological_dilation,3,2
0X27DE40A84F577EBD.avi,98,1782,1402,380,27.10413694721826,morphological_dilation,3,2
0X27DE40A84F577EBD.avi,108,1187,873,314,35.967926689576174,morphological_dilation,3,2
0X27E3BABA985C6485.avi,88,2009,1593,416,26.1142498430634,morphological_dilation,3,2
0X27E3BABA985C6485.avi,102,1327,983,344,34.99491353001017,morphological_dilation,3,2
0X27E5A824236613DF.avi,85,1870,1478,392,26.522327469553453,morphological_dilation,3,2
0X27E5A824236613DF.avi,100,1309,969,340,35.08771929824561,morphological_dilation,3,2
0X27E5FF18C326FC22.avi,51,2553,2093,460,21.978021978021978,morphological_dilation,3,2
0X27E5FF18C326FC22.avi,68,1632,1252,380,30.35143769968051,morphological_dilation,3,2
0X27E8DE815C310DE2.avi,95,6713,5965,748,12.539815590947192,morphological_dilation,3,2
0X27E8DE815C310DE2.avi,121,3782,3221,561,17.416951257373487,morphological_dilation,3,2
0X27EBBB70B35C2BDF.avi,81,1940,1552,388,25.0,morphological_dilation,3,2
0X27EBBB70B35C2BDF.avi,100,1116,804,312,38.80597014925373,morphological_dilation,3,2
0X27ED61D9D1D7C33.avi,39,1104,795,309,38.86792452830189,morphological_dilation,3,2
0X27ED61D9D1D7C33.avi,52,767,503,264,52.48508946322068,morphological_dilation,3,2
0X27F9E56828CA9A79.avi,58,1823,1435,388,27.038327526132406,morphological_dilation,3,2
0X27F9E56828CA9A79.avi,75,1056,744,312,41.935483870967744,morphological_dilation,3,2
0X27FB927A584A359C.avi,0,1342,994,348,35.01006036217304,morphological_dilation,3,2
0X27FB927A584A359C.avi,16,875,558,317,56.81003584229391,morphological_dilation,3,2
0X2800557D97ACA8FA.avi,117,1114,806,308,38.21339950372209,morphological_dilation,3,2
0X2800557D97ACA8FA.avi,134,700,464,236,50.86206896551724,morphological_dilation,3,2
0X2802CA3B99221213.avi,94,1551,1175,376,32.0,morphological_dilation,3,2
0X2802CA3B99221213.avi,110,1058,732,326,44.53551912568306,morphological_dilation,3,2
0X280B7441A7E287B2.avi,1,942,633,309,48.81516587677725,morphological_dilation,3,2
0X280B7441A7E287B2.avi,117,737,481,256,53.222453222453225,morphological_dilation,3,2
0X280E7E6433076E5B.avi,68,2983,2459,524,21.309475396502645,morphological_dilation,3,2
0X280E7E6433076E5B.avi,82,1990,1542,448,29.05317769130999,morphological_dilation,3,2
0X2812459832695FC3.avi,42,1669,1313,356,27.113480578827115,morphological_dilation,3,2
0X2812459832695FC3.avi,55,1390,1062,328,30.88512241054614,morphological_dilation,3,2
0X281A54A385859C72.avi,166,1369,1033,336,32.526621490803485,morphological_dilation,3,2
0X281A54A385859C72.avi,179,840,569,271,47.6274165202109,morphological_dilation,3,2
0X281BFB3D114BB83A.avi,78,2857,2333,524,22.460351478782684,morphological_dilation,3,2
0X281BFB3D114BB83A.avi,96,1650,1258,392,31.160572337042925,morphological_dilation,3,2
0X28236C2AA117D80B.avi,88,2073,1641,432,26.3254113345521,morphological_dilation,3,2
0X28236C2AA117D80B.avi,98,1446,1042,404,38.771593090211134,morphological_dilation,3,2
0X28259FC1DD8D4DCC.avi,92,1597,1237,360,29.102667744543247,morphological_dilation,3,2
0X28259FC1DD8D4DCC.avi,104,1395,1065,330,30.985915492957744,morphological_dilation,3,2
0X2826DDFD5A2904F4.avi,49,1529,1165,364,31.244635193133046,morphological_dilation,3,2
0X2826DDFD5A2904F4.avi,66,908,624,284,45.51282051282051,morphological_dilation,3,2
0X282AA53113273C8B.avi,103,1711,1327,384,28.937452901281084,morphological_dilation,3,2
0X282AA53113273C8B.avi,116,1114,786,328,41.73027989821883,morphological_dilation,3,2
0X282CA4F9C50B6F6B.avi,68,2114,1682,432,25.68370986920333,morphological_dilation,3,2
0X282CA4F9C50B6F6B.avi,86,1421,1014,407,40.138067061143985,morphological_dilation,3,2
0X2833102D81E9117C.avi,51,1344,1012,332,32.80632411067194,morphological_dilation,3,2
0X2833102D81E9117C.avi,69,1002,706,296,41.92634560906516,morphological_dilation,3,2
0X2835A031AB3FF693.avi,55,1573,1213,360,29.67848309975268,morphological_dilation,3,2
0X2835A031AB3FF693.avi,71,1020,724,296,40.88397790055249,morphological_dilation,3,2
0X2837905EB4C648A6.avi,132,5387,4832,555,11.485927152317881,morphological_dilation,3,2
0X2837905EB4C648A6.avi,155,3234,2710,524,19.33579335793358,morphological_dilation,3,2
0X283B9F3D9498F401.avi,55,1405,1065,340,31.92488262910798,morphological_dilation,3,2
0X283B9F3D9498F401.avi,70,874,605,269,44.46280991735537,morphological_dilation,3,2
0X283E07E657955D9D.avi,36,2136,1740,396,22.758620689655174,morphological_dilation,3,2
0X283E07E657955D9D.avi,51,1950,1574,376,23.88818297331639,morphological_dilation,3,2
0X283EA34320D8C58B.avi,136,1569,1197,372,31.07769423558897,morphological_dilation,3,2
0X283EA34320D8C58B.avi,148,996,667,329,49.32533733133433,morphological_dilation,3,2
0X283F3C018BBAA3FB.avi,53,1588,1208,380,31.456953642384107,morphological_dilation,3,2
0X283F3C018BBAA3FB.avi,71,1019,707,312,44.13012729844413,morphological_dilation,3,2
0X2840438B29E95F1F.avi,154,1861,1474,387,26.255088195386705,morphological_dilation,3,2
0X2840438B29E95F1F.avi,170,1169,849,320,37.69140164899882,morphological_dilation,3,2
0X2841EE2AE1958F10.avi,85,1648,1256,392,31.210191082802545,morphological_dilation,3,2
0X2841EE2AE1958F10.avi,102,1064,720,344,47.77777777777778,morphological_dilation,3,2
0X28482EB3CD2FDA9D.avi,59,2743,2259,484,21.425409473218238,morphological_dilation,3,2
0X28482EB3CD2FDA9D.avi,72,1986,1570,416,26.496815286624205,morphological_dilation,3,2
0X284834DEEBB7C5C2.avi,57,1895,1515,380,25.082508250825082,morphological_dilation,3,2
0X284834DEEBB7C5C2.avi,79,1169,861,308,35.77235772357724,morphological_dilation,3,2
0X284D36D6CA672984.avi,153,1692,1304,388,29.754601226993866,morphological_dilation,3,2
0X284D36D6CA672984.avi,173,988,692,296,42.77456647398844,morphological_dilation,3,2
0X284DA4EF4567F673.avi,41,1840,1476,364,24.661246612466126,morphological_dilation,3,2
0X284DA4EF4567F673.avi,59,1325,1013,312,30.799605133267523,morphological_dilation,3,2
0X2851536849A2542B.avi,39,1598,1254,344,27.432216905901118,morphological_dilation,3,2
0X2851536849A2542B.avi,52,1226,918,308,33.551198257080614,morphological_dilation,3,2
0X2851818C006989E0.avi,158,1781,1413,368,26.043878273177633,morphological_dilation,3,2
0X2851818C006989E0.avi,179,1000,700,300,42.857142857142854,morphological_dilation,3,2
0X2855741E46DF1FA3.avi,43,1258,938,320,34.11513859275053,morphological_dilation,3,2
0X2855741E46DF1FA3.avi,58,831,559,272,48.658318425760285,morphological_dilation,3,2
0X285939779C4DBE60.avi,34,1120,828,292,35.26570048309179,morphological_dilation,3,2
0X285939779C4DBE60.avi,50,846,585,261,44.61538461538462,morphological_dilation,3,2
0X285B6CE9FA9200E1.avi,212,1356,1000,356,35.6,morphological_dilation,3,2
0X285B6CE9FA9200E1.avi,238,880,583,297,50.943396226415096,morphological_dilation,3,2
0X2863C1D767AA05C.avi,42,1235,895,340,37.988826815642454,morphological_dilation,3,2
0X2863C1D767AA05C.avi,60,902,598,304,50.836120401337794,morphological_dilation,3,2
0X286661146EB02EE4.avi,63,738,490,248,50.61224489795918,morphological_dilation,3,2
0X286661146EB02EE4.avi,76,437,261,176,67.43295019157088,morphological_dilation,3,2
0X286856FF99946B18.avi,113,1472,1120,352,31.428571428571427,morphological_dilation,3,2
0X286856FF99946B18.avi,129,908,612,296,48.36601307189542,morphological_dilation,3,2
0X286CE13D5E499A83.avi,45,1458,1099,359,32.666060054595086,morphological_dilation,3,2
0X286CE13D5E499A83.avi,66,868,566,302,53.35689045936396,morphological_dilation,3,2
0X2870FB8B7A63E9F7.avi,36,1675,1303,372,28.54950115118956,morphological_dilation,3,2
0X2870FB8B7A63E9F7.avi,51,1087,771,316,40.985732814526585,morphological_dilation,3,2
0X28712788DD9BC1B6.avi,98,3244,2713,531,19.572429045337262,morphological_dilation,3,2
0X28712788DD9BC1B6.avi,120,2847,2336,511,21.875,morphological_dilation,3,2
0X2871AB68D43C2FAE.avi,74,1232,912,320,35.08771929824561,morphological_dilation,3,2
0X2871AB68D43C2FAE.avi,90,822,563,259,46.00355239786856,morphological_dilation,3,2
0X2871C2C07B263E65.avi,3,4230,3614,616,17.044825677919203,morphological_dilation,3,2
0X2871C2C07B263E65.avi,25,2389,1929,460,23.846552617936755,morphological_dilation,3,2
0X2878D9240A9B5CC4.avi,2,1854,1446,408,28.21576763485477,morphological_dilation,3,2
0X2878D9240A9B5CC4.avi,17,1298,938,360,38.37953091684435,morphological_dilation,3,2
0X287940BA389ACFE8.avi,42,1671,1307,364,27.850038255547055,morphological_dilation,3,2
0X287940BA389ACFE8.avi,61,1175,855,320,37.42690058479532,morphological_dilation,3,2
0X287AFCC7F6DEED83.avi,112,2729,2241,488,21.77599286033021,morphological_dilation,3,2
0X287AFCC7F6DEED83.avi,145,1670,1282,388,30.265210608424336,morphological_dilation,3,2
0X287BF355C298ACA.avi,124,2422,1974,448,22.69503546099291,morphological_dilation,3,2
0X287BF355C298ACA.avi,140,1595,1231,364,29.56945572705118,morphological_dilation,3,2
0X287C85967E202E62.avi,45,1718,1338,380,28.400597907324364,morphological_dilation,3,2
0X287C85967E202E62.avi,61,1088,780,308,39.48717948717949,morphological_dilation,3,2
0X2882179032E434E1.avi,13,2479,2023,456,22.540781018289668,morphological_dilation,3,2
0X2882179032E434E1.avi,22,1840,1444,396,27.42382271468144,morphological_dilation,3,2
0X28845A25C055F9DC.avi,8,2417,1993,424,21.274460612142498,morphological_dilation,3,2
0X28845A25C055F9DC.avi,16,2190,1794,396,22.073578595317723,morphological_dilation,3,2
0X2889D8C33077C148.avi,57,1388,1029,359,34.88824101068999,morphological_dilation,3,2
0X2889D8C33077C148.avi,79,794,526,268,50.950570342205324,morphological_dilation,3,2
0X288EB79F76CDA89F.avi,66,1754,1394,360,25.82496413199426,morphological_dilation,3,2
0X288EB79F76CDA89F.avi,74,1512,1180,332,28.135593220338983,morphological_dilation,3,2
0X28903421E8658F6A.avi,73,1786,1419,367,25.863284002818887,morphological_dilation,3,2
0X28903421E8658F6A.avi,86,1451,1111,340,30.603060306030606,morphological_dilation,3,2
0X28917531761A46E7.avi,2,2122,1718,404,23.51571594877765,morphological_dilation,3,2
0X28917531761A46E7.avi,14,1343,1019,324,31.79587831207066,morphological_dilation,3,2
0X28923B334611CFC1.avi,46,1344,1032,312,30.23255813953488,morphological_dilation,3,2
0X28923B334611CFC1.avi,65,944,671,273,40.68554396423249,morphological_dilation,3,2
0X2893E0784C56B75.avi,41,1132,840,292,34.76190476190476,morphological_dilation,3,2
0X2893E0784C56B75.avi,53,704,456,248,54.385964912280706,morphological_dilation,3,2
0X28957333BC12D494.avi,80,1258,930,328,35.26881720430107,morphological_dilation,3,2
0X28957333BC12D494.avi,112,2017,1597,420,26.29931120851597,morphological_dilation,3,2
0X28957EA81265C8D9.avi,83,2150,1710,440,25.730994152046783,morphological_dilation,3,2
0X28957EA81265C8D9.avi,96,1195,863,332,38.47045191193511,morphological_dilation,3,2
0X28980B95F9769CE7.avi,3,2361,1907,454,23.807026743576298,morphological_dilation,3,2
0X28980B95F9769CE7.avi,21,1533,1086,447,41.16022099447514,morphological_dilation,3,2
0X28A2034B93DBE0D6.avi,34,668,444,224,50.45045045045045,morphological_dilation,3,2
0X28A2034B93DBE0D6.avi,51,468,276,192,69.56521739130434,morphological_dilation,3,2
0X28A422DF50B05663.avi,85,1137,829,308,37.15319662243667,morphological_dilation,3,2
0X28A422DF50B05663.avi,104,672,428,244,57.009345794392516,morphological_dilation,3,2
0X28AABB6786125B68.avi,40,1831,1447,384,26.53766413268832,morphological_dilation,3,2
0X28AABB6786125B68.avi,53,1490,1126,364,32.326820603907635,morphological_dilation,3,2
0X28B349884BCB88D2.avi,53,1886,1502,384,25.5659121171771,morphological_dilation,3,2
0X28B349884BCB88D2.avi,75,1526,1174,352,29.982964224872234,morphological_dilation,3,2
0X28B494298CA73B42.avi,36,1423,1077,346,32.12627669452182,morphological_dilation,3,2
0X28B494298CA73B42.avi,49,898,618,280,45.307443365695796,morphological_dilation,3,2
0X28B77DCB71D1245A.avi,96,1749,1302,447,34.331797235023046,morphological_dilation,3,2
0X28B77DCB71D1245A.avi,120,1096,736,360,48.91304347826087,morphological_dilation,3,2
0X28B8302CC1B2FCB.avi,91,2284,1848,436,23.593073593073594,morphological_dilation,3,2
0X28B8302CC1B2FCB.avi,108,1259,880,379,43.06818181818181,morphological_dilation,3,2
0X28BD4F110426601C.avi,2,1569,1209,360,29.776674937965257,morphological_dilation,3,2
0X28BD4F110426601C.avi,27,1103,777,326,41.95624195624196,morphological_dilation,3,2
0X28C73B18FDF845BC.avi,179,4049,3421,628,18.357205495469163,morphological_dilation,3,2
0X28C73B18FDF845BC.avi,194,3382,2794,588,21.045096635647816,morphological_dilation,3,2
0X28C95C58B1790E20.avi,61,1119,799,320,40.05006257822278,morphological_dilation,3,2
0X28C95C58B1790E20.avi,77,702,419,283,67.5417661097852,morphological_dilation,3,2
0X28C9F49BA9170823.avi,62,1587,1231,356,28.9195775792039,morphological_dilation,3,2
0X28C9F49BA9170823.avi,76,958,658,300,45.59270516717325,morphological_dilation,3,2
0X28CA9C46619120F3.avi,45,2484,2034,450,22.123893805309734,morphological_dilation,3,2
0X28CA9C46619120F3.avi,59,1750,1378,372,26.995645863570395,morphological_dilation,3,2
0X28CB8784368E0723.avi,67,1293,943,350,37.11558854718982,morphological_dilation,3,2
0X28CB8784368E0723.avi,82,925,582,343,58.93470790378007,morphological_dilation,3,2
0X28CFBCA1B785A2F2.avi,45,1997,1573,424,26.954863318499683,morphological_dilation,3,2
0X28CFBCA1B785A2F2.avi,62,1305,954,351,36.79245283018868,morphological_dilation,3,2
0X28CFCF51E65B1B31.avi,98,888,612,276,45.09803921568628,morphological_dilation,3,2
0X28CFCF51E65B1B31.avi,114,600,380,220,57.89473684210527,morphological_dilation,3,2
0X28D1BD6F5325C92C.avi,91,1453,1093,360,32.93687099725526,morphological_dilation,3,2
0X28D1BD6F5325C92C.avi,104,846,562,284,50.5338078291815,morphological_dilation,3,2
0X28D708482E66EDE5.avi,71,1638,1263,375,29.69121140142518,morphological_dilation,3,2
0X28D708482E66EDE5.avi,86,998,710,288,40.563380281690144,morphological_dilation,3,2
0X28DDDD1528582978.avi,33,2373,1913,460,24.046001045478306,morphological_dilation,3,2
0X28DDDD1528582978.avi,48,1414,1038,376,36.22350674373796,morphological_dilation,3,2
0X28DDF77DCDD5982A.avi,50,1296,964,332,34.439834024896264,morphological_dilation,3,2
0X28DDF77DCDD5982A.avi,63,843,567,276,48.67724867724868,morphological_dilation,3,2
0X28E0837117794467.avi,0,1404,1084,320,29.520295202952028,morphological_dilation,3,2
0X28E0837117794467.avi,16,1079,803,276,34.37110834371108,morphological_dilation,3,2
0X28E57A04871E4BC0.avi,88,2036,1620,416,25.679012345679013,morphological_dilation,3,2
0X28E57A04871E4BC0.avi,107,1258,926,332,35.85313174946004,morphological_dilation,3,2
0X28E5D0919BC9A280.avi,80,1326,1006,320,31.809145129224653,morphological_dilation,3,2
0X28E5D0919BC9A280.avi,97,946,678,268,39.52802359882006,morphological_dilation,3,2
0X28EA2B0204CD390C.avi,59,1437,1089,348,31.955922865013775,morphological_dilation,3,2
0X28EA2B0204CD390C.avi,80,884,596,288,48.322147651006716,morphological_dilation,3,2
0X28EAD9701FAB642B.avi,93,1519,1159,360,31.061259706643657,morphological_dilation,3,2
0X28EAD9701FAB642B.avi,113,787,475,312,65.6842105263158,morphological_dilation,3,2
0X28EDD31B54CBEBD9.avi,106,2426,1942,484,24.922760041194643,morphological_dilation,3,2
0X28EDD31B54CBEBD9.avi,132,1868,1420,448,31.549295774647888,morphological_dilation,3,2
0X28EDDD27E7D737BB.avi,104,1502,1150,352,30.60869565217391,morphological_dilation,3,2
0X28EDDD27E7D737BB.avi,116,842,574,268,46.68989547038328,morphological_dilation,3,2
0X28EF4C40DB0E777D.avi,81,2223,1747,476,27.24670864338867,morphological_dilation,3,2
0X28EF4C40DB0E777D.avi,98,1251,871,380,43.62801377726751,morphological_dilation,3,2
0X28F054EA79CDB082.avi,125,1139,843,296,35.11269276393831,morphological_dilation,3,2
0X28F054EA79CDB082.avi,139,891,627,264,42.10526315789473,morphological_dilation,3,2
0X28F2E8C16B4A4974.avi,75,1959,1555,404,25.980707395498392,morphological_dilation,3,2
0X28F2E8C16B4A4974.avi,101,1203,863,340,39.39745075318656,morphological_dilation,3,2
0X28F376B3A1AC9A38.avi,50,2359,1923,436,22.67290691627665,morphological_dilation,3,2
0X28F376B3A1AC9A38.avi,68,1692,1324,368,27.794561933534744,morphological_dilation,3,2
0X28F676EC204B892.avi,48,1693,1321,372,28.160484481453445,morphological_dilation,3,2
0X28F676EC204B892.avi,59,1614,1250,364,29.12,morphological_dilation,3,2
0X28FB1162DC7E5985.avi,100,2267,1795,472,26.295264623955433,morphological_dilation,3,2
0X28FB1162DC7E5985.avi,129,1422,1031,391,37.92434529582929,morphological_dilation,3,2
0X28FBB5E92B4E4970.avi,173,3410,2862,548,19.14744933612858,morphological_dilation,3,2
0X28FBB5E92B4E4970.avi,193,2792,2304,488,21.180555555555554,morphological_dilation,3,2
0X28FC7D7A02E982B1.avi,41,1429,1095,334,30.502283105022833,morphological_dilation,3,2
0X28FC7D7A02E982B1.avi,59,974,673,301,44.72511144130758,morphological_dilation,3,2
0X290387F4D1B37AE0.avi,55,1259,923,336,36.403033586132175,morphological_dilation,3,2
0X290387F4D1B37AE0.avi,75,784,518,266,51.35135135135135,morphological_dilation,3,2
0X29044407543B4ED0.avi,30,1497,1165,332,28.49785407725322,morphological_dilation,3,2
0X29044407543B4ED0.avi,42,1399,1083,316,29.17820867959372,morphological_dilation,3,2
0X29088E4297D24753.avi,50,1009,705,304,43.12056737588652,morphological_dilation,3,2
0X29088E4297D24753.avi,68,669,411,258,62.77372262773723,morphological_dilation,3,2
0X2909743644F8B146.avi,78,1525,1169,356,30.453378956372966,morphological_dilation,3,2
0X2909743644F8B146.avi,93,975,691,284,41.09985528219971,morphological_dilation,3,2
0X290C040A358C02C1.avi,87,1341,1009,332,32.90386521308226,morphological_dilation,3,2
0X290C040A358C02C1.avi,99,854,518,336,64.86486486486487,morphological_dilation,3,2
0X29148E0F44A62490.avi,56,3644,3112,532,17.09511568123393,morphological_dilation,3,2
0X29148E0F44A62490.avi,78,2548,2084,464,22.264875239923224,morphological_dilation,3,2
0X2918B2872C91B115.avi,79,1029,717,312,43.51464435146444,morphological_dilation,3,2
0X2918B2872C91B115.avi,93,603,357,246,68.90756302521008,morphological_dilation,3,2
0X291C4F5273C6D916.avi,46,883,611,272,44.51718494271686,morphological_dilation,3,2
0X291C4F5273C6D916.avi,60,562,346,216,62.42774566473989,morphological_dilation,3,2
0X29205B46A897CCE4.avi,45,1564,1212,352,29.042904290429046,morphological_dilation,3,2
0X29205B46A897CCE4.avi,62,1309,985,324,32.89340101522843,morphological_dilation,3,2
0X2925FF720D4E48F.avi,98,1943,1559,384,24.631173829377808,morphological_dilation,3,2
0X2925FF720D4E48F.avi,125,1091,791,300,37.92667509481669,morphological_dilation,3,2
0X292971284482F563.avi,129,1878,1502,376,25.03328894806924,morphological_dilation,3,2
0X292971284482F563.avi,147,1204,896,308,34.375,morphological_dilation,3,2
0X292A1F9335000CC5.avi,54,1482,1142,340,29.772329246935204,morphological_dilation,3,2
0X292A1F9335000CC5.avi,72,920,644,276,42.857142857142854,morphological_dilation,3,2
0X292BD6E101B932B9.avi,49,1742,1358,384,28.276877761413843,morphological_dilation,3,2
0X292BD6E101B932B9.avi,66,1153,833,320,38.41536614645859,morphological_dilation,3,2
0X292CF3666916BFEE.avi,46,1620,1248,372,29.807692307692307,morphological_dilation,3,2
0X292CF3666916BFEE.avi,59,1005,705,300,42.5531914893617,morphological_dilation,3,2
0X2936BE5BD2B454BE.avi,43,1685,1325,360,27.169811320754718,morphological_dilation,3,2
0X2936BE5BD2B454BE.avi,61,1450,1110,340,30.630630630630627,morphological_dilation,3,2
0X29372D09CBD2D8D0.avi,45,1810,1410,400,28.368794326241137,morphological_dilation,3,2
0X29372D09CBD2D8D0.avi,60,1156,824,332,40.29126213592233,morphological_dilation,3,2
0X293C81AED2A80133.avi,88,1663,1284,379,29.517133956386292,morphological_dilation,3,2
0X293C81AED2A80133.avi,112,991,695,296,42.589928057553955,morphological_dilation,3,2
0X293C9951DFBCD9D8.avi,58,2369,1905,464,24.35695538057743,morphological_dilation,3,2
0X293C9951DFBCD9D8.avi,81,1403,1039,364,35.03368623676612,morphological_dilation,3,2
0X293D1E326007C469.avi,106,1331,979,352,35.95505617977528,morphological_dilation,3,2
0X293D1E326007C469.avi,120,883,582,301,51.71821305841925,morphological_dilation,3,2
0X293DC06147AADAD2.avi,3,1596,1244,352,28.29581993569132,morphological_dilation,3,2
0X293DC06147AADAD2.avi,18,1019,715,304,42.51748251748252,morphological_dilation,3,2
0X293E8502D91120B4.avi,32,1831,1455,376,25.841924398625434,morphological_dilation,3,2
0X293E8502D91120B4.avi,45,1631,1275,356,27.92156862745098,morphological_dilation,3,2
0X294BA2FC928E6983.avi,90,2655,2167,488,22.519612367328104,morphological_dilation,3,2
0X294BA2FC928E6983.avi,109,2261,1809,452,24.98618021006081,morphological_dilation,3,2
0X294D929C1B18A74C.avi,39,984,692,292,42.19653179190752,morphological_dilation,3,2
0X294D929C1B18A74C.avi,49,627,375,252,67.2,morphological_dilation,3,2
0X29576307FEE7F10E.avi,77,2291,1863,428,22.973698336017176,morphological_dilation,3,2
0X29576307FEE7F10E.avi,94,1910,1514,396,26.1558784676354,morphological_dilation,3,2
0X29582FA0A66ECA89.avi,43,2160,1756,404,23.006833712984054,morphological_dilation,3,2
0X29582FA0A66ECA89.avi,63,1517,1169,348,29.769033361847736,morphological_dilation,3,2
0X2959FF1D90DC5714.avi,80,1644,1272,372,29.245283018867923,morphological_dilation,3,2
0X2959FF1D90DC5714.avi,96,1346,1010,336,33.26732673267327,morphological_dilation,3,2
0X295CBC8E87EBEA7E.avi,36,1599,1247,352,28.22774659182037,morphological_dilation,3,2
0X295CBC8E87EBEA7E.avi,53,1045,749,296,39.519359145527375,morphological_dilation,3,2
0X295D7794423319AD.avi,86,2021,1620,401,24.753086419753085,morphological_dilation,3,2
0X295D7794423319AD.avi,102,1571,1200,371,30.916666666666664,morphological_dilation,3,2
0X296284667D0B48F7.avi,47,1707,1319,388,29.41622441243366,morphological_dilation,3,2
0X296284667D0B48F7.avi,61,1052,744,308,41.39784946236559,morphological_dilation,3,2
0X2962BA442DE9E45B.avi,75,1692,1284,408,31.775700934579437,morphological_dilation,3,2
0X2962BA442DE9E45B.avi,90,1179,828,351,42.391304347826086,morphological_dilation,3,2
0X29640FD5E676FCF2.avi,105,1883,1468,415,28.269754768392367,morphological_dilation,3,2
0X29640FD5E676FCF2.avi,118,1187,867,320,36.90888119953864,morphological_dilation,3,2
0X2966D3700CD4B8B5.avi,14,3277,2769,508,18.34597327555074,morphological_dilation,3,2
0X2966D3700CD4B8B5.avi,32,2289,1853,436,23.52941176470588,morphological_dilation,3,2
0X29670BE6399C86BC.avi,48,1389,1041,348,33.429394812680115,morphological_dilation,3,2
0X29670BE6399C86BC.avi,61,941,637,304,47.72370486656201,morphological_dilation,3,2
0X296BF1BFDF695E01.avi,115,1925,1514,411,27.14663143989432,morphological_dilation,3,2
0X296BF1BFDF695E01.avi,133,1272,920,352,38.26086956521739,morphological_dilation,3,2
0X296D27E36A3B10B1.avi,1,2618,2118,500,23.60717658168083,morphological_dilation,3,2
0X296D27E36A3B10B1.avi,21,1725,1298,427,32.89676425269646,morphological_dilation,3,2
0X296F1EF6CF0AFE57.avi,47,2336,1896,440,23.20675105485232,morphological_dilation,3,2
0X296F1EF6CF0AFE57.avi,70,1424,1076,348,32.342007434944236,morphological_dilation,3,2
0X2971776F0E51B880.avi,153,1279,964,315,32.67634854771784,morphological_dilation,3,2
0X2971776F0E51B880.avi,172,1015,744,271,36.424731182795696,morphological_dilation,3,2
0X29735078772CEC7C.avi,88,1623,1239,384,30.99273607748184,morphological_dilation,3,2
0X29735078772CEC7C.avi,104,1157,780,377,48.333333333333336,morphological_dilation,3,2
0X2973BE861413FD44.avi,174,1748,1379,369,26.75852066715011,morphological_dilation,3,2
0X2973BE861413FD44.avi,191,1160,844,316,37.44075829383886,morphological_dilation,3,2
0X2975F53722811E61.avi,57,2324,1888,436,23.093220338983052,morphological_dilation,3,2
0X2975F53722811E61.avi,73,1479,1099,380,34.57688808007279,morphological_dilation,3,2
0X297C35461EDC1C32.avi,51,781,545,236,43.30275229357798,morphological_dilation,3,2
0X297C35461EDC1C32.avi,62,492,296,196,66.21621621621621,morphological_dilation,3,2
0X297F7F40A699959B.avi,127,2420,1972,448,22.718052738336713,morphological_dilation,3,2
0X297F7F40A699959B.avi,144,2214,1802,412,22.86348501664817,morphological_dilation,3,2
0X2980C863A2001D4F.avi,286,4044,3492,552,15.807560137457044,morphological_dilation,3,2
0X2980C863A2001D4F.avi,318,3322,2818,504,17.885024840312276,morphological_dilation,3,2
0X298127FA6EF9AE66.avi,81,1802,1422,380,26.72292545710267,morphological_dilation,3,2
0X298127FA6EF9AE66.avi,101,1101,797,304,38.14303638644919,morphological_dilation,3,2
0X298213C78149E758.avi,82,2338,1890,448,23.703703703703706,morphological_dilation,3,2
0X298213C78149E758.avi,98,1381,1037,344,33.17261330761813,morphological_dilation,3,2
0X2987121B61405E4A.avi,36,1696,1324,372,28.09667673716012,morphological_dilation,3,2
0X2987121B61405E4A.avi,56,1019,723,296,40.94052558782849,morphological_dilation,3,2
0X29891201362B3276.avi,45,2883,2407,476,19.775654341503948,morphological_dilation,3,2
0X29891201362B3276.avi,64,2543,2079,464,22.318422318422318,morphological_dilation,3,2
0X2989EFBB544B63BF.avi,61,1410,1074,336,31.28491620111732,morphological_dilation,3,2
0X2989EFBB544B63BF.avi,84,876,604,272,45.033112582781456,morphological_dilation,3,2
0X298EBAF6CC2B526.avi,107,1304,984,320,32.52032520325203,morphological_dilation,3,2
0X298EBAF6CC2B526.avi,123,763,511,252,49.31506849315068,morphological_dilation,3,2
0X2994B5330ED757B9.avi,57,2365,1897,468,24.670532419609913,morphological_dilation,3,2
0X2994B5330ED757B9.avi,74,1486,1094,392,35.831809872029254,morphological_dilation,3,2
0X299A88D5675F49D0.avi,80,2060,1640,420,25.609756097560975,morphological_dilation,3,2
0X299A88D5675F49D0.avi,103,1349,997,352,35.30591775325978,morphological_dilation,3,2
0X299E0A308114BAE3.avi,38,1430,1086,344,31.675874769797424,morphological_dilation,3,2
0X299E0A308114BAE3.avi,55,941,649,292,44.99229583975347,morphological_dilation,3,2
0X29A2919E823A0D12.avi,58,1701,1321,380,28.766086298258898,morphological_dilation,3,2
0X29A2919E823A0D12.avi,81,1085,785,300,38.21656050955414,morphological_dilation,3,2
0X29A336DCE20541A0.avi,75,1566,1222,344,28.150572831423897,morphological_dilation,3,2
0X29A336DCE20541A0.avi,91,1406,1062,344,32.39171374764595,morphological_dilation,3,2
0X29A4B28DB80C5246.avi,68,1144,823,321,39.00364520048603,morphological_dilation,3,2
0X29A4B28DB80C5246.avi,80,764,462,302,65.36796536796537,morphological_dilation,3,2
0X29AF1111EE5795F.avi,31,1483,1143,340,29.74628171478565,morphological_dilation,3,2
0X29AF1111EE5795F.avi,45,974,694,280,40.345821325648416,morphological_dilation,3,2
0X29BB9686E6983297.avi,79,3356,2824,532,18.8385269121813,morphological_dilation,3,2
0X29BB9686E6983297.avi,94,2581,2117,464,21.91780821917808,morphological_dilation,3,2
0X29C17E1745706401.avi,48,1400,1064,336,31.57894736842105,morphological_dilation,3,2
0X29C17E1745706401.avi,60,943,671,272,40.536512667660205,morphological_dilation,3,2
0X29C57DC906DE1162.avi,96,1301,981,320,32.61977573904179,morphological_dilation,3,2
0X29C57DC906DE1162.avi,117,860,596,264,44.29530201342282,morphological_dilation,3,2
0X29C61163B3107A0F.avi,34,1167,863,304,35.22595596755504,morphological_dilation,3,2
0X29C61163B3107A0F.avi,48,852,588,264,44.89795918367347,morphological_dilation,3,2
0X29C62BE737EF818E.avi,90,2106,1666,440,26.410564225690276,morphological_dilation,3,2
0X29C62BE737EF818E.avi,107,1285,921,364,39.52225841476656,morphological_dilation,3,2
0X29C81728B50A2E6C.avi,44,1543,1195,348,29.121338912133893,morphological_dilation,3,2
0X29C81728B50A2E6C.avi,65,979,703,276,39.26031294452347,morphological_dilation,3,2
0X29C990BE357DA21C.avi,53,2021,1609,412,25.605966438781852,morphological_dilation,3,2
0X29C990BE357DA21C.avi,69,1192,864,328,37.96296296296296,morphological_dilation,3,2
0X29CB7E7DE6A747BD.avi,89,1796,1397,399,28.561202576950606,morphological_dilation,3,2
0X29CB7E7DE6A747BD.avi,103,1094,762,332,43.569553805774284,morphological_dilation,3,2
0X29DC850F81AD37D8.avi,49,2303,1859,444,23.883808499193115,morphological_dilation,3,2
0X29DC850F81AD37D8.avi,67,2019,1593,426,26.741996233521657,morphological_dilation,3,2
0X29DFB3EEC01DD44C.avi,110,2720,2260,460,20.353982300884958,morphological_dilation,3,2
0X29DFB3EEC01DD44C.avi,132,1946,1542,404,26.19974059662776,morphological_dilation,3,2
0X29E0C74AFAC38079.avi,43,2714,2238,476,21.26899016979446,morphological_dilation,3,2
0X29E0C74AFAC38079.avi,63,1726,1342,384,28.614008941877795,morphological_dilation,3,2
0X29E4873A1EDEDCE2.avi,110,3283,2771,512,18.477084085167807,morphological_dilation,3,2
0X29E4873A1EDEDCE2.avi,130,2556,2108,448,21.25237191650854,morphological_dilation,3,2
0X29E5CE47FBC8961D.avi,156,1646,1258,388,30.842607313195547,morphological_dilation,3,2
0X29E5CE47FBC8961D.avi,168,1019,711,308,43.319268635724335,morphological_dilation,3,2
0X29E66C557C99EC32.avi,38,1338,1000,338,33.800000000000004,morphological_dilation,3,2
0X29E66C557C99EC32.avi,49,778,506,272,53.75494071146245,morphological_dilation,3,2
0X29EA5EC080FF78D6.avi,122,1487,1135,352,31.013215859030836,morphological_dilation,3,2
0X29EA5EC080FF78D6.avi,142,931,635,296,46.61417322834646,morphological_dilation,3,2
0X29EAD82D1B3029D2.avi,85,1909,1517,392,25.84047462096243,morphological_dilation,3,2
0X29EAD82D1B3029D2.avi,103,1163,851,312,36.66274970622796,morphological_dilation,3,2
0X29EB469268DC5E30.avi,49,1942,1554,388,24.967824967824967,morphological_dilation,3,2
0X29EB469268DC5E30.avi,65,1385,1033,352,34.07550822846079,morphological_dilation,3,2
0X29ED6C257E2FC811.avi,37,2483,2031,452,22.25504677498769,morphological_dilation,3,2
0X29ED6C257E2FC811.avi,50,1547,1188,359,30.218855218855218,morphological_dilation,3,2
0X29F5DCEC80F87BA6.avi,48,1458,1114,344,30.879712746858168,morphological_dilation,3,2
0X29F5DCEC80F87BA6.avi,61,842,554,288,51.985559566786996,morphological_dilation,3,2
0X29F88FD41325783F.avi,48,1592,1204,388,32.22591362126246,morphological_dilation,3,2
0X29F88FD41325783F.avi,60,1068,748,320,42.780748663101605,morphological_dilation,3,2
0X29F98334C8C86ACF.avi,77,1868,1432,436,30.446927374301673,morphological_dilation,3,2
0X29F98334C8C86ACF.avi,94,1291,884,407,46.04072398190045,morphological_dilation,3,2
0X29FA8548E33956DA.avi,46,1710,1334,376,28.18590704647676,morphological_dilation,3,2
0X29FA8548E33956DA.avi,63,957,661,296,44.78063540090771,morphological_dilation,3,2
0X29FDE0A4498AB572.avi,74,2488,2044,444,21.722113502935418,morphological_dilation,3,2
0X29FDE0A4498AB572.avi,91,2091,1679,412,24.538415723645027,morphological_dilation,3,2
0X2A005531D741B5AE.avi,35,1666,1318,348,26.403641881638844,morphological_dilation,3,2
0X2A005531D741B5AE.avi,49,1271,955,316,33.089005235602095,morphological_dilation,3,2
0X2A01716CA8E6B78C.avi,52,1604,1244,360,28.938906752411576,morphological_dilation,3,2
0X2A01716CA8E6B78C.avi,67,1178,862,316,36.65893271461717,morphological_dilation,3,2
0X2A071BC3FD1AC4EC.avi,42,1966,1558,408,26.187419768934532,morphological_dilation,3,2
0X2A071BC3FD1AC4EC.avi,59,1371,1018,353,34.67583497053045,morphological_dilation,3,2
0X2A09D7E5E6F9F9DF.avi,41,1861,1473,388,26.3408010862186,morphological_dilation,3,2
0X2A09D7E5E6F9F9DF.avi,59,1435,1091,344,31.53070577451879,morphological_dilation,3,2
0X2A0B8E212C49D706.avi,77,1518,1162,356,30.6368330464716,morphological_dilation,3,2
0X2A0B8E212C49D706.avi,92,915,611,304,49.754500818330605,morphological_dilation,3,2
0X2A179DC26614D64F.avi,97,2168,1752,416,23.74429223744292,morphological_dilation,3,2
0X2A179DC26614D64F.avi,114,1187,877,310,35.34777651083238,morphological_dilation,3,2
0X2A1AE3B6420FD216.avi,42,2016,1604,412,25.6857855361596,morphological_dilation,3,2
0X2A1AE3B6420FD216.avi,59,1305,961,344,35.796045785639954,morphological_dilation,3,2
0X2A1F8EEF3A53DF5E.avi,117,1470,1110,360,32.432432432432435,morphological_dilation,3,2
0X2A1F8EEF3A53DF5E.avi,130,895,623,272,43.659711075441415,morphological_dilation,3,2
0X2A20552783F445AE.avi,130,1884,1464,420,28.688524590163933,morphological_dilation,3,2
0X2A20552783F445AE.avi,141,1207,852,355,41.66666666666667,morphological_dilation,3,2
0X2A2C1D627826C72.avi,45,1231,919,312,33.949945593035906,morphological_dilation,3,2
0X2A2C1D627826C72.avi,57,743,507,236,46.548323471400394,morphological_dilation,3,2
0X2A2C6AF671DB82E7.avi,109,2359,1903,456,23.96216500262743,morphological_dilation,3,2
0X2A2C6AF671DB82E7.avi,123,1837,1445,392,27.1280276816609,morphological_dilation,3,2
0X2A2C7C74F6D0D042.avi,38,1377,1041,336,32.27665706051873,morphological_dilation,3,2
0X2A2C7C74F6D0D042.avi,56,1151,847,304,35.891381345926796,morphological_dilation,3,2
0X2A2D19625CBF1D16.avi,112,1737,1349,388,28.76204595997035,morphological_dilation,3,2
0X2A2D19625CBF1D16.avi,122,1456,1076,380,35.31598513011153,morphological_dilation,3,2
0X2A312A5ECB7000FC.avi,127,1370,1054,316,29.98102466793169,morphological_dilation,3,2
0X2A312A5ECB7000FC.avi,146,790,554,236,42.59927797833935,morphological_dilation,3,2
0X2A388C798DF4CFF0.avi,3,1439,1095,344,31.41552511415525,morphological_dilation,3,2
0X2A388C798DF4CFF0.avi,15,939,667,272,40.779610194902546,morphological_dilation,3,2
0X2A3BB51936839E6D.avi,38,2069,1669,400,23.96644697423607,morphological_dilation,3,2
0X2A3BB51936839E6D.avi,52,1180,872,308,35.321100917431195,morphological_dilation,3,2
0X2A449C0A5F6A9CCB.avi,40,1455,1111,344,30.96309630963096,morphological_dilation,3,2
0X2A449C0A5F6A9CCB.avi,58,913,641,272,42.43369734789392,morphological_dilation,3,2
0X2A45204FA70C5C9.avi,35,1777,1401,376,26.837972876516776,morphological_dilation,3,2
0X2A45204FA70C5C9.avi,50,1461,1125,336,29.86666666666667,morphological_dilation,3,2
0X2A46A6A93DF181FA.avi,45,2242,1818,424,23.32233223322332,morphological_dilation,3,2
0X2A46A6A93DF181FA.avi,57,1696,1324,372,28.09667673716012,morphological_dilation,3,2
0X2A4B6CD214AAB6A0.avi,128,1882,1478,404,27.33423545331529,morphological_dilation,3,2
0X2A4B6CD214AAB6A0.avi,146,1188,857,331,38.62310385064177,morphological_dilation,3,2
0X2A4B8B438E6DE7FF.avi,51,1932,1501,431,28.71419053964024,morphological_dilation,3,2
0X2A4B8B438E6DE7FF.avi,69,1488,1099,389,35.3958143767061,morphological_dilation,3,2
0X2A4CE8DBE3CCDE95.avi,42,2463,1967,496,25.216065073716322,morphological_dilation,3,2
0X2A4CE8DBE3CCDE95.avi,64,1780,1348,432,32.047477744807125,morphological_dilation,3,2
0X2A5507B5E2C166BA.avi,3,1745,1381,364,26.357711803041273,morphological_dilation,3,2
0X2A5507B5E2C166BA.avi,17,1073,773,300,38.809831824062094,morphological_dilation,3,2
0X2A55659AE64722AA.avi,16,971,703,268,38.12233285917496,morphological_dilation,3,2
0X2A55659AE64722AA.avi,28,1344,1033,311,30.10648596321394,morphological_dilation,3,2
0X2A5A066CD7F27D5C.avi,37,1086,778,308,39.588688946015424,morphological_dilation,3,2
0X2A5A066CD7F27D5C.avi,49,642,387,255,65.89147286821705,morphological_dilation,3,2
0X2A5B7EE5D039818C.avi,88,1455,1091,364,33.36388634280477,morphological_dilation,3,2
0X2A5B7EE5D039818C.avi,109,928,624,304,48.717948717948715,morphological_dilation,3,2
0X2A651E015F9439C0.avi,55,2275,1839,436,23.708537248504623,morphological_dilation,3,2
0X2A651E015F9439C0.avi,76,1438,1090,348,31.926605504587158,morphological_dilation,3,2
0X2A6635B01B13AAA4.avi,85,1527,1171,356,30.401366353543978,morphological_dilation,3,2
0X2A6635B01B13AAA4.avi,96,1046,742,304,40.97035040431267,morphological_dilation,3,2
0X2A667FD468D528A2.avi,51,1896,1504,392,26.063829787234045,morphological_dilation,3,2
0X2A667FD468D528A2.avi,69,1324,988,336,34.0080971659919,morphological_dilation,3,2
0X2A67800D05897E40.avi,1,1980,1569,411,26.19502868068834,morphological_dilation,3,2
0X2A67800D05897E40.avi,11,1091,799,292,36.545682102628284,morphological_dilation,3,2
0X2A68164E9B03130B.avi,31,2359,1931,428,22.16468151216986,morphological_dilation,3,2
0X2A68164E9B03130B.avi,47,2075,1675,400,23.88059701492537,morphological_dilation,3,2
0X2A6A2DB28C7B4608.avi,49,1912,1512,400,26.455026455026452,morphological_dilation,3,2
0X2A6A2DB28C7B4608.avi,68,1325,993,332,33.434038267875124,morphological_dilation,3,2
0X2A6A33D5D510FDBF.avi,55,1954,1558,396,25.41720154043646,morphological_dilation,3,2
0X2A6A33D5D510FDBF.avi,74,1127,823,304,36.93803159173755,morphological_dilation,3,2
0X2A75592E9961EB81.avi,48,1688,1280,408,31.874999999999996,morphological_dilation,3,2
0X2A75592E9961EB81.avi,64,915,611,304,49.754500818330605,morphological_dilation,3,2
0X2A76C86F7457546F.avi,34,1246,926,320,34.557235421166304,morphological_dilation,3,2
0X2A76C86F7457546F.avi,49,820,557,263,47.217235188509875,morphological_dilation,3,2
0X2A777BDE3B51C189.avi,0,2363,1907,456,23.911903513371787,morphological_dilation,3,2
0X2A777BDE3B51C189.avi,15,1403,1052,351,33.365019011406844,morphological_dilation,3,2
0X2A7C5F0B89FED627.avi,68,1664,1312,352,26.82926829268293,morphological_dilation,3,2
0X2A7C5F0B89FED627.avi,83,1129,825,304,36.848484848484844,morphological_dilation,3,2
0X2A7FCA76C4FAEAFD.avi,43,2663,2203,460,20.880617339990923,morphological_dilation,3,2
0X2A7FCA76C4FAEAFD.avi,60,2290,1850,440,23.783783783783786,morphological_dilation,3,2
0X2A830BC4A3A36A93.avi,39,1616,1252,364,29.073482428115017,morphological_dilation,3,2
0X2A830BC4A3A36A93.avi,55,980,692,288,41.61849710982659,morphological_dilation,3,2
0X2A8498756C4D6E82.avi,56,2168,1760,408,23.18181818181818,morphological_dilation,3,2
0X2A8498756C4D6E82.avi,79,1248,940,308,32.76595744680851,morphological_dilation,3,2
0X2A855CCD4A6C6BD3.avi,91,1176,828,348,42.028985507246375,morphological_dilation,3,2
0X2A855CCD4A6C6BD3.avi,108,708,436,272,62.38532110091744,morphological_dilation,3,2
0X2A85B05A9671F32E.avi,56,4156,3552,604,17.004504504504506,morphological_dilation,3,2
0X2A85B05A9671F32E.avi,80,2343,1875,468,24.959999999999997,morphological_dilation,3,2
0X2A85FF99D2016B7D.avi,47,1662,1294,368,28.438948995363216,morphological_dilation,3,2
0X2A85FF99D2016B7D.avi,68,941,633,308,48.657187993680886,morphological_dilation,3,2
0X2A8A694D5740E1F0.avi,99,3161,2601,560,21.53018069973087,morphological_dilation,3,2
0X2A8A694D5740E1F0.avi,113,2329,1841,488,26.5073329712113,morphological_dilation,3,2
0X2A8AF50D1F38A71.avi,112,1504,1168,336,28.767123287671232,morphological_dilation,3,2
0X2A8AF50D1F38A71.avi,123,930,650,280,43.07692307692308,morphological_dilation,3,2
0X2A8DA996FB52D5CB.avi,111,1761,1365,396,29.010989010989015,morphological_dilation,3,2
0X2A8DA996FB52D5CB.avi,124,1155,812,343,42.241379310344826,morphological_dilation,3,2
0X2A904CE88E96E7.avi,114,1766,1406,360,25.604551920341397,morphological_dilation,3,2
0X2A904CE88E96E7.avi,127,1570,1226,344,28.05872756933116,morphological_dilation,3,2
0X2A91906B774CE547.avi,71,1707,1331,376,28.249436513899322,morphological_dilation,3,2
0X2A91906B774CE547.avi,97,1083,763,320,41.9397116644823,morphological_dilation,3,2
0X2A928235B332DBCF.avi,83,1130,834,296,35.4916067146283,morphological_dilation,3,2
0X2A928235B332DBCF.avi,95,787,527,260,49.33586337760911,morphological_dilation,3,2
0X2A9687F49EE5406.avi,53,1789,1417,372,26.252646436132675,morphological_dilation,3,2
0X2A9687F49EE5406.avi,67,1023,734,289,39.3732970027248,morphological_dilation,3,2
0X2A99BFFB26E9ECE2.avi,49,1651,1291,360,27.885360185902403,morphological_dilation,3,2
0X2A99BFFB26E9ECE2.avi,63,1355,1027,328,31.93768257059396,morphological_dilation,3,2
0X2A9CDF57A90DBE32.avi,106,2130,1714,416,24.27071178529755,morphological_dilation,3,2
0X2A9CDF57A90DBE32.avi,121,1432,1066,366,34.33395872420263,morphological_dilation,3,2
0X2AA7D76F830E270.avi,36,2106,1663,443,26.638604930847865,morphological_dilation,3,2
0X2AA7D76F830E270.avi,50,1265,917,348,37.94983642311887,morphological_dilation,3,2
0X2AA86B752CDAFC28.avi,59,2157,1721,436,25.33410807669959,morphological_dilation,3,2
0X2AA86B752CDAFC28.avi,77,1200,872,328,37.61467889908257,morphological_dilation,3,2
0X2AB5732368D8A3F9.avi,85,2285,1834,451,24.591057797164666,morphological_dilation,3,2
0X2AB5732368D8A3F9.avi,103,1357,980,377,38.46938775510204,morphological_dilation,3,2
0X2AB73E07EA2A8D7F.avi,51,1905,1518,387,25.494071146245062,morphological_dilation,3,2
0X2AB73E07EA2A8D7F.avi,69,1275,933,342,36.655948553054664,morphological_dilation,3,2
0X2AB81C540CAFDB5A.avi,35,1916,1524,392,25.72178477690289,morphological_dilation,3,2
0X2AB81C540CAFDB5A.avi,57,1538,1194,344,28.8107202680067,morphological_dilation,3,2
0X2AB98AC8D400D5DB.avi,76,1100,792,308,38.88888888888889,morphological_dilation,3,2
0X2AB98AC8D400D5DB.avi,86,693,430,263,61.16279069767442,morphological_dilation,3,2
0X2ABAD17326F8DC47.avi,43,2690,2202,488,22.161671207992732,morphological_dilation,3,2
0X2ABAD17326F8DC47.avi,64,1436,1061,375,35.3440150801131,morphological_dilation,3,2
0X2ABBA31A554D6E2.avi,114,1854,1438,416,28.929068150208625,morphological_dilation,3,2
0X2ABBA31A554D6E2.avi,130,1070,738,332,44.986449864498645,morphological_dilation,3,2
0X2ABBDEA046C1EBF1.avi,79,1092,788,304,38.578680203045685,morphological_dilation,3,2
0X2ABBDEA046C1EBF1.avi,93,780,498,282,56.62650602409639,morphological_dilation,3,2
0X2AC09763183674E8.avi,43,1807,1451,356,24.534803583735354,morphological_dilation,3,2
0X2AC09763183674E8.avi,64,2184,1650,534,32.36363636363636,morphological_dilation,3,2
0X2AC18208BD3CA1FF.avi,37,993,689,304,44.12191582002903,morphological_dilation,3,2
0X2AC18208BD3CA1FF.avi,49,570,331,239,72.20543806646525,morphological_dilation,3,2
0X2AC54813DFFE6A44.avi,35,2320,1868,452,24.197002141327623,morphological_dilation,3,2
0X2AC54813DFFE6A44.avi,54,1934,1506,428,28.419654714475435,morphological_dilation,3,2
0X2ACD4F35A8D82C7C.avi,83,1644,1262,382,30.269413629160063,morphological_dilation,3,2
0X2ACD4F35A8D82C7C.avi,100,1055,751,304,40.47936085219707,morphological_dilation,3,2
0X2ACE034731B7CA96.avi,49,1342,1002,340,33.93213572854291,morphological_dilation,3,2
0X2ACE034731B7CA96.avi,63,864,525,339,64.57142857142857,morphological_dilation,3,2
0X2ACEC865BDA02BE4.avi,79,1502,1154,348,30.155979202772965,morphological_dilation,3,2
0X2ACEC865BDA02BE4.avi,94,923,587,336,57.240204429301535,morphological_dilation,3,2
0X2ACF3F84A3F9A6ED.avi,57,1624,1253,371,29.608938547486037,morphological_dilation,3,2
0X2ACF3F84A3F9A6ED.avi,84,1953,1565,388,24.792332268370608,morphological_dilation,3,2
0X2AD46881C37E12F.avi,122,1873,1481,392,26.46860229574612,morphological_dilation,3,2
0X2AD46881C37E12F.avi,134,1268,924,344,37.22943722943723,morphological_dilation,3,2
0X2AD648B03DA6DDB6.avi,56,1709,1349,360,26.686434395848778,morphological_dilation,3,2
0X2AD648B03DA6DDB6.avi,70,1332,1012,320,31.620553359683797,morphological_dilation,3,2
0X2AD994F98C491FA6.avi,41,1392,1044,348,33.33333333333333,morphological_dilation,3,2
0X2AD994F98C491FA6.avi,57,961,642,319,49.68847352024922,morphological_dilation,3,2
0X2ADEADB93D232F1F.avi,41,2066,1658,408,24.60796139927624,morphological_dilation,3,2
0X2ADEADB93D232F1F.avi,57,1347,1003,344,34.297108673978066,morphological_dilation,3,2
0X2ADF6020233E02A5.avi,75,1634,1274,360,28.257456828885402,morphological_dilation,3,2
0X2ADF6020233E02A5.avi,91,1144,828,316,38.164251207729464,morphological_dilation,3,2
0X2AE5EC02C6B6F6DB.avi,55,2704,2240,464,20.714285714285715,morphological_dilation,3,2
0X2AE5EC02C6B6F6DB.avi,73,1494,1118,376,33.631484794275494,morphological_dilation,3,2
0X2AE7F3D6A1A2A977.avi,0,3388,2860,528,18.461538461538463,morphological_dilation,3,2
0X2AE7F3D6A1A2A977.avi,21,2056,1640,416,25.365853658536587,morphological_dilation,3,2
0X2AEB1E1DE5E9144F.avi,94,1641,1273,368,28.908091123330713,morphological_dilation,3,2
0X2AEB1E1DE5E9144F.avi,113,1101,772,329,42.61658031088083,morphological_dilation,3,2
0X2AEB5ED737A6EA90.avi,1,1523,1143,380,33.24584426946632,morphological_dilation,3,2
0X2AEB5ED737A6EA90.avi,18,1044,736,308,41.84782608695652,morphological_dilation,3,2
0X2AEBE2737F2F198E.avi,88,1028,732,296,40.43715846994536,morphological_dilation,3,2
0X2AEBE2737F2F198E.avi,107,715,424,291,68.63207547169812,morphological_dilation,3,2
0X2AF780DBAFAEE9DD.avi,105,1630,1258,372,29.570747217806044,morphological_dilation,3,2
0X2AF780DBAFAEE9DD.avi,116,979,683,296,43.33821376281113,morphological_dilation,3,2
0X2AFCAC3003694C4D.avi,81,1569,1169,400,34.217279726261765,morphological_dilation,3,2
0X2AFCAC3003694C4D.avi,99,1121,757,364,48.084544253632764,morphological_dilation,3,2
0X2AFCEF38F2CB4FD.avi,49,1680,1316,364,27.659574468085108,morphological_dilation,3,2
0X2AFCEF38F2CB4FD.avi,61,1024,736,288,39.130434782608695,morphological_dilation,3,2
0X2AFE868FF0F26037.avi,160,1551,1187,364,30.66554338668913,morphological_dilation,3,2
0X2AFE868FF0F26037.avi,178,1358,1014,344,33.92504930966469,morphological_dilation,3,2
0X2AFFF29A1DA11CEC.avi,105,1469,1137,332,29.199648197009676,morphological_dilation,3,2
0X2AFFF29A1DA11CEC.avi,120,857,585,272,46.495726495726494,morphological_dilation,3,2
0X2B00EBE66CDF22EF.avi,96,1699,1323,376,28.420256991685562,morphological_dilation,3,2
0X2B00EBE66CDF22EF.avi,114,1305,965,340,35.233160621761655,morphological_dilation,3,2
0X2B0188BDC08AE8F3.avi,127,1209,873,336,38.48797250859107,morphological_dilation,3,2
0X2B0188BDC08AE8F3.avi,140,749,453,296,65.34216335540839,morphological_dilation,3,2
0X2B04379243A07D3E.avi,100,2825,2350,475,20.212765957446805,morphological_dilation,3,2
0X2B04379243A07D3E.avi,120,1880,1489,391,26.259234385493617,morphological_dilation,3,2
0X2B049A419C740450.avi,83,1408,1060,348,32.83018867924528,morphological_dilation,3,2
0X2B049A419C740450.avi,97,909,621,288,46.3768115942029,morphological_dilation,3,2
0X2B04D402904C0AF3.avi,49,1958,1570,388,24.713375796178344,morphological_dilation,3,2
0X2B04D402904C0AF3.avi,63,1267,939,328,34.93077742279021,morphological_dilation,3,2
0X2B0639FDC76E788B.avi,129,1756,1348,408,30.267062314540063,morphological_dilation,3,2
0X2B0639FDC76E788B.avi,143,1277,907,370,40.79382579933848,morphological_dilation,3,2
0X2B0C7B1FD6FDF2FA.avi,100,1691,1311,380,28.985507246376812,morphological_dilation,3,2
0X2B0C7B1FD6FDF2FA.avi,122,1020,712,308,43.258426966292134,morphological_dilation,3,2
0X2B0F87B014648FF1.avi,77,3327,2783,544,19.54725116780453,morphological_dilation,3,2
0X2B0F87B014648FF1.avi,102,2242,1778,464,26.09673790776153,morphological_dilation,3,2
0X2B11C46C12F72E1.avi,90,1732,1340,392,29.253731343283583,morphological_dilation,3,2
0X2B11C46C12F72E1.avi,109,1365,1021,344,33.692458374142994,morphological_dilation,3,2
0X2B13AFFF378DA58A.avi,23,1426,1078,348,32.28200371057514,morphological_dilation,3,2
0X2B13AFFF378DA58A.avi,41,1114,798,316,39.59899749373433,morphological_dilation,3,2
0X2B1407FFE2B14FB4.avi,41,1822,1426,396,27.769985974754558,morphological_dilation,3,2
0X2B1407FFE2B14FB4.avi,62,1242,893,349,39.08174692049272,morphological_dilation,3,2
0X2B1EA4FE61E09B04.avi,42,1623,1251,372,29.73621103117506,morphological_dilation,3,2
0X2B1EA4FE61E09B04.avi,57,1032,707,325,45.96888260254597,morphological_dilation,3,2
0X2B2471C251239AD7.avi,54,3229,2690,539,20.03717472118959,morphological_dilation,3,2
0X2B2471C251239AD7.avi,71,2274,1810,464,25.635359116022098,morphological_dilation,3,2
0X2B2494C2C6EF6F9.avi,48,1807,1411,396,28.065201984408223,morphological_dilation,3,2
0X2B2494C2C6EF6F9.avi,66,1071,759,312,41.10671936758894,morphological_dilation,3,2
0X2B25C29EF3612FD9.avi,69,1113,817,296,36.23011015911873,morphological_dilation,3,2
0X2B25C29EF3612FD9.avi,81,732,472,260,55.08474576271186,morphological_dilation,3,2
0X2B26BF7B0DC2B52E.avi,105,961,689,272,39.477503628447025,morphological_dilation,3,2
0X2B26BF7B0DC2B52E.avi,119,724,480,244,50.83333333333333,morphological_dilation,3,2
0X2B2D3664A4F59EF6.avi,47,1553,1185,368,31.05485232067511,morphological_dilation,3,2
0X2B2D3664A4F59EF6.avi,65,987,675,312,46.22222222222222,morphological_dilation,3,2
0X2B337C895834063D.avi,3,2042,1642,400,24.3605359317905,morphological_dilation,3,2
0X2B337C895834063D.avi,25,1221,889,332,37.34533183352081,morphological_dilation,3,2
0X2B357569BC532F43.avi,37,1959,1555,404,25.980707395498392,morphological_dilation,3,2
0X2B357569BC532F43.avi,52,1286,950,336,35.368421052631575,morphological_dilation,3,2
0X2B36749BB015C796.avi,50,2490,2038,452,22.178606476938175,morphological_dilation,3,2
0X2B36749BB015C796.avi,64,1961,1565,396,25.303514376996805,morphological_dilation,3,2
0X2B36907D5AB72242.avi,51,2418,1934,484,25.0258531540848,morphological_dilation,3,2
0X2B36907D5AB72242.avi,70,1566,1178,388,32.93718166383701,morphological_dilation,3,2
0X2B39C678737EB346.avi,126,1415,1071,344,32.11951447245565,morphological_dilation,3,2
0X2B39C678737EB346.avi,145,1073,769,304,39.531859557867364,morphological_dilation,3,2
0X2B39E514C7DED838.avi,101,1319,983,336,34.18107833163784,morphological_dilation,3,2
0X2B39E514C7DED838.avi,109,820,552,268,48.55072463768116,morphological_dilation,3,2
0X2B3A07F9F9F16B0B.avi,81,1767,1348,419,31.083086053412462,morphological_dilation,3,2
0X2B3A07F9F9F16B0B.avi,98,1090,688,402,58.43023255813954,morphological_dilation,3,2
0X2B3CFA85CCB59333.avi,25,2622,2174,448,20.607175712971483,morphological_dilation,3,2
0X2B3CFA85CCB59333.avi,36,1847,1459,388,26.593557230980124,morphological_dilation,3,2
0X2B45ECFBC4E2299A.avi,46,1020,728,292,40.10989010989011,morphological_dilation,3,2
0X2B45ECFBC4E2299A.avi,61,644,408,236,57.84313725490197,morphological_dilation,3,2
0X2B4ACDDAB3F1DA2E.avi,62,2073,1669,404,24.206111443978433,morphological_dilation,3,2
0X2B4ACDDAB3F1DA2E.avi,80,1863,1475,388,26.305084745762713,morphological_dilation,3,2
0X2B559592BBB6E421.avi,80,2092,1669,423,25.34451767525464,morphological_dilation,3,2
0X2B559592BBB6E421.avi,100,1299,959,340,35.45359749739312,morphological_dilation,3,2
0X2B5619B4EDE8F1B8.avi,52,1620,1268,352,27.760252365930597,morphological_dilation,3,2
0X2B5619B4EDE8F1B8.avi,67,1356,1028,328,31.906614785992215,morphological_dilation,3,2
0X2B591E1ED1F86C25.avi,43,1370,1019,351,34.44553483807655,morphological_dilation,3,2
0X2B591E1ED1F86C25.avi,57,821,533,288,54.03377110694184,morphological_dilation,3,2
0X2B5B9DA97FC8A1A7.avi,54,1608,1248,360,28.846153846153843,morphological_dilation,3,2
0X2B5B9DA97FC8A1A7.avi,68,1032,740,292,39.45945945945946,morphological_dilation,3,2
0X2B5C65259968F31D.avi,43,1608,1228,380,30.944625407166125,morphological_dilation,3,2
0X2B5C65259968F31D.avi,58,901,617,284,46.029173419773095,morphological_dilation,3,2
0X2B5D059047625083.avi,44,1913,1494,419,28.045515394912986,morphological_dilation,3,2
0X2B5D059047625083.avi,59,1212,880,332,37.72727272727273,morphological_dilation,3,2
0X2B5E93155A8601B3.avi,88,1450,1114,336,30.16157989228007,morphological_dilation,3,2
0X2B5E93155A8601B3.avi,99,1002,698,304,43.553008595988544,morphological_dilation,3,2
0X2B62A0DEB27B4C10.avi,52,2941,2433,508,20.879572544184136,morphological_dilation,3,2
0X2B62A0DEB27B4C10.avi,72,1793,1409,384,27.253371185237757,morphological_dilation,3,2
0X2B650F4F171CC99F.avi,32,2988,2472,516,20.87378640776699,morphological_dilation,3,2
0X2B650F4F171CC99F.avi,45,1983,1551,432,27.852998065764023,morphological_dilation,3,2
0X2B6BB50CF65EE164.avi,89,2684,2196,488,22.22222222222222,morphological_dilation,3,2
0X2B6BB50CF65EE164.avi,105,1802,1374,428,31.149927219796215,morphological_dilation,3,2
0X2B6E6D287F09E2A0.avi,66,3138,2634,504,19.134396355353076,morphological_dilation,3,2
0X2B6E6D287F09E2A0.avi,85,2007,1599,408,25.515947467166978,morphological_dilation,3,2
0X2B6EBF9236788362.avi,36,1593,1221,372,30.46683046683047,morphological_dilation,3,2
0X2B6EBF9236788362.avi,55,1096,760,336,44.21052631578947,morphological_dilation,3,2
0X2B75FD103FD8FA5E.avi,64,2027,1619,408,25.20074119827054,morphological_dilation,3,2
0X2B75FD103FD8FA5E.avi,86,1095,797,298,37.39021329987453,morphological_dilation,3,2
0X2B76F1C5F5D0466D.avi,86,1545,1157,388,33.53500432152118,morphological_dilation,3,2
0X2B76F1C5F5D0466D.avi,97,943,635,308,48.503937007874015,morphological_dilation,3,2
0X2B79C68A21B5F520.avi,59,2746,2286,460,20.122484689413824,morphological_dilation,3,2
0X2B79C68A21B5F520.avi,80,1881,1493,388,25.987943737441395,morphological_dilation,3,2
0X2B7ABC059BB8090D.avi,78,1580,1196,384,32.10702341137124,morphological_dilation,3,2
0X2B7ABC059BB8090D.avi,93,1042,718,324,45.12534818941504,morphological_dilation,3,2
0X2B810D03C090DE59.avi,124,1316,996,320,32.1285140562249,morphological_dilation,3,2
0X2B810D03C090DE59.avi,139,865,609,256,42.03612479474548,morphological_dilation,3,2
0X2B81FE1EF971B25A.avi,0,1527,1151,376,32.667245873153774,morphological_dilation,3,2
0X2B81FE1EF971B25A.avi,19,921,622,299,48.07073954983923,morphological_dilation,3,2
0X2B831262FD6E0F44.avi,106,2186,1742,444,25.487944890929963,morphological_dilation,3,2
0X2B831262FD6E0F44.avi,126,1343,999,344,34.434434434434436,morphological_dilation,3,2
0X2B8349B0466DDFE9.avi,43,1656,1296,360,27.77777777777778,morphological_dilation,3,2
0X2B8349B0466DDFE9.avi,62,1184,876,308,35.15981735159817,morphological_dilation,3,2
0X2B867271589725B9.avi,86,3878,3314,564,17.018708509354255,morphological_dilation,3,2
0X2B867271589725B9.avi,105,2424,1973,451,22.85859097820578,morphological_dilation,3,2
0X2B888E6F035154BB.avi,20,1563,1195,368,30.794979079497907,morphological_dilation,3,2
0X2B888E6F035154BB.avi,40,1337,977,360,36.8474923234391,morphological_dilation,3,2
0X2B8D66D3AF8E8B84.avi,15,1511,1171,340,29.035012809564474,morphological_dilation,3,2
0X2B8D66D3AF8E8B84.avi,23,807,547,260,47.53199268738574,morphological_dilation,3,2
0X2B8E2C047E853E71.avi,40,2155,1747,408,23.354321694333144,morphological_dilation,3,2
0X2B8E2C047E853E71.avi,54,1596,1244,352,28.29581993569132,morphological_dilation,3,2
0X2B9185D91BBE0E97.avi,54,2564,2081,483,23.20999519461797,morphological_dilation,3,2
0X2B9185D91BBE0E97.avi,67,1470,1086,384,35.35911602209944,morphological_dilation,3,2
0X2B92A8AA5710178B.avi,1,1787,1387,400,28.83922134102379,morphological_dilation,3,2
0X2B92A8AA5710178B.avi,19,1090,762,328,43.044619422572175,morphological_dilation,3,2
0X2B935E3B4404D29E.avi,91,2055,1648,407,24.696601941747574,morphological_dilation,3,2
0X2B935E3B4404D29E.avi,107,1506,1143,363,31.758530183727036,morphological_dilation,3,2
0X2B974E47EADA843.avi,46,1835,1439,396,27.51911049339819,morphological_dilation,3,2
0X2B974E47EADA843.avi,62,1335,987,348,35.25835866261398,morphological_dilation,3,2
0X2B9B38D0E03561B3.avi,106,2054,1642,412,25.091352009744217,morphological_dilation,3,2
0X2B9B38D0E03561B3.avi,121,1217,897,320,35.67447045707915,morphological_dilation,3,2
0X2BA0CC0FD446A0CD.avi,30,2230,1750,480,27.42857142857143,morphological_dilation,3,2
0X2BA0CC0FD446A0CD.avi,47,1343,987,356,36.06889564336373,morphological_dilation,3,2
0X2BA56103B7A6BE7C.avi,1,2602,2134,468,21.930646672914715,morphological_dilation,3,2
0X2BA56103B7A6BE7C.avi,20,1799,1407,392,27.860696517412936,morphological_dilation,3,2
0X2BB46B720AC47098.avi,40,1754,1350,404,29.925925925925927,morphological_dilation,3,2
0X2BB46B720AC47098.avi,55,1045,725,320,44.13793103448276,morphological_dilation,3,2
0X2BB4D1569CCBAAF0.avi,126,1109,789,320,40.557667934093786,morphological_dilation,3,2
0X2BB4D1569CCBAAF0.avi,133,671,403,268,66.50124069478908,morphological_dilation,3,2
0X2BB53A7347B59BC6.avi,39,2979,2440,539,22.09016393442623,morphological_dilation,3,2
0X2BB53A7347B59BC6.avi,53,1847,1411,436,30.900070871722185,morphological_dilation,3,2
0X2BB72AFEFA5753AA.avi,83,1636,1256,380,30.254777070063692,morphological_dilation,3,2
0X2BB72AFEFA5753AA.avi,98,1051,724,327,45.16574585635359,morphological_dilation,3,2
0X2BB766EF1A13DECC.avi,47,1469,1117,352,31.5129811996419,morphological_dilation,3,2
0X2BB766EF1A13DECC.avi,62,948,668,280,41.91616766467065,morphological_dilation,3,2
0X2BB8F8D3346376DA.avi,28,1993,1574,419,26.62007623888183,morphological_dilation,3,2
0X2BB8F8D3346376DA.avi,44,1182,850,332,39.05882352941176,morphological_dilation,3,2
0X2BBE07A50418CB3.avi,110,1602,1254,348,27.751196172248804,morphological_dilation,3,2
0X2BBE07A50418CB3.avi,127,1041,753,288,38.24701195219124,morphological_dilation,3,2
0X2BC272DCF674E2FC.avi,94,1876,1484,392,26.41509433962264,morphological_dilation,3,2
0X2BC272DCF674E2FC.avi,106,1136,814,322,39.55773955773956,morphological_dilation,3,2
0X2BC37749440CC632.avi,0,2721,2249,472,20.987105380168963,morphological_dilation,3,2
0X2BC37749440CC632.avi,21,2302,1854,448,24.163969795037758,morphological_dilation,3,2
0X2BCA5CD0E25723F1.avi,65,2792,2312,480,20.761245674740483,morphological_dilation,3,2
0X2BCA5CD0E25723F1.avi,79,1531,1171,360,30.74295473953886,morphological_dilation,3,2
0X2BCB6F4D73191177.avi,39,1741,1373,368,26.802621995630005,morphological_dilation,3,2
0X2BCB6F4D73191177.avi,57,1436,1108,328,29.602888086642597,morphological_dilation,3,2
0X2BCCE250005CFD40.avi,0,2071,1671,400,23.937761819269898,morphological_dilation,3,2
0X2BCCE250005CFD40.avi,16,1502,1154,348,30.155979202772965,morphological_dilation,3,2
0X2BD1518044A7F1E7.avi,81,2336,1912,424,22.17573221757322,morphological_dilation,3,2
0X2BD1518044A7F1E7.avi,99,1432,1084,348,32.10332103321033,morphological_dilation,3,2
0X2BD2EAEB075A7A56.avi,65,3721,3189,532,16.682345562872374,morphological_dilation,3,2
0X2BD2EAEB075A7A56.avi,83,3338,2830,508,17.95053003533569,morphological_dilation,3,2
0X2BD5CA404CF4822.avi,45,1723,1363,360,26.41232575201761,morphological_dilation,3,2
0X2BD5CA404CF4822.avi,63,1355,1035,320,30.917874396135264,morphological_dilation,3,2
0X2BDAE57715F1BBF4.avi,43,1604,1240,364,29.354838709677416,morphological_dilation,3,2
0X2BDAE57715F1BBF4.avi,59,1068,752,316,42.02127659574468,morphological_dilation,3,2
0X2BDE03448DF23DEB.avi,63,1460,1120,340,30.357142857142854,morphological_dilation,3,2
0X2BDE03448DF23DEB.avi,77,946,666,280,42.04204204204204,morphological_dilation,3,2
0X2BDF20FFCF3D29F8.avi,40,1446,1094,352,32.17550274223035,morphological_dilation,3,2
0X2BDF20FFCF3D29F8.avi,57,999,691,308,44.57308248914617,morphological_dilation,3,2
0X2BDFE5712EFDDD47.avi,52,1736,1344,392,29.166666666666668,morphological_dilation,3,2
0X2BDFE5712EFDDD47.avi,68,1163,832,331,39.78365384615385,morphological_dilation,3,2
0X2BE0908F65A5A564.avi,42,2037,1544,493,31.930051813471504,morphological_dilation,3,2
0X2BE0908F65A5A564.avi,61,1443,1021,422,41.33202742409402,morphological_dilation,3,2
0X2BE38B4D5D345FFA.avi,38,1974,1554,420,27.027027027027028,morphological_dilation,3,2
0X2BE38B4D5D345FFA.avi,52,1222,886,336,37.92325056433409,morphological_dilation,3,2
0X2BEAF12F3432C314.avi,40,1412,1080,332,30.74074074074074,morphological_dilation,3,2
0X2BEAF12F3432C314.avi,58,1053,769,284,36.93107932379714,morphological_dilation,3,2
0X2BEC544FB23D724A.avi,43,1993,1577,416,26.379201014584652,morphological_dilation,3,2
0X2BEC544FB23D724A.avi,57,1577,1205,372,30.87136929460581,morphological_dilation,3,2
0X2BF16ED5C2D8A0D3.avi,90,2821,2361,460,19.483269800931808,morphological_dilation,3,2
0X2BF16ED5C2D8A0D3.avi,104,2460,2006,454,22.6321036889332,morphological_dilation,3,2
0X2BF66637343A27ED.avi,28,1831,1443,388,26.888426888426885,morphological_dilation,3,2
0X2BF66637343A27ED.avi,39,1552,1204,348,28.903654485049834,morphological_dilation,3,2
0X2BF77B6A39CD9A0B.avi,143,3259,2719,540,19.86024273630011,morphological_dilation,3,2
0X2BF77B6A39CD9A0B.avi,157,2401,1877,524,27.916888652104422,morphological_dilation,3,2
0X2C03CDC4A9D90ACD.avi,48,2176,1764,412,23.356009070294785,morphological_dilation,3,2
0X2C03CDC4A9D90ACD.avi,62,1347,1007,340,33.76365441906653,morphological_dilation,3,2
0X2C03FAE807BF8E76.avi,45,2740,2248,492,21.88612099644128,morphological_dilation,3,2
0X2C03FAE807BF8E76.avi,62,1755,1351,404,29.90377498149519,morphological_dilation,3,2
0X2C04949A6CC88C77.avi,0,2758,2302,456,19.808861859252826,morphological_dilation,3,2
0X2C04949A6CC88C77.avi,20,2341,1917,424,22.117892540427754,morphological_dilation,3,2
0X2C073A809964F995.avi,39,2010,1594,416,26.097867001254706,morphological_dilation,3,2
0X2C073A809964F995.avi,58,1100,804,296,36.81592039800995,morphological_dilation,3,2
0X2C0B21D4520985EB.avi,43,1988,1572,416,26.463104325699742,morphological_dilation,3,2
0X2C0B21D4520985EB.avi,58,1275,927,348,37.54045307443366,morphological_dilation,3,2
0X2C12346EFB5636F3.avi,134,1927,1531,396,25.865447419986936,morphological_dilation,3,2
0X2C12346EFB5636F3.avi,152,1097,781,316,40.46094750320102,morphological_dilation,3,2
0X2C12A8B71D39E8DA.avi,4,1627,1236,391,31.63430420711974,morphological_dilation,3,2
0X2C12A8B71D39E8DA.avi,16,1273,921,352,38.219326818675356,morphological_dilation,3,2
0X2C12BF73BA0A814C.avi,95,2679,2199,480,21.828103683492497,morphological_dilation,3,2
0X2C12BF73BA0A814C.avi,121,1508,1144,364,31.818181818181817,morphological_dilation,3,2
0X2C14699B62EE346C.avi,55,2695,2215,480,21.670428893905193,morphological_dilation,3,2
0X2C14699B62EE346C.avi,74,1794,1363,431,31.621423330887747,morphological_dilation,3,2
0X2C18E8C665E9D9A3.avi,35,1113,794,319,40.17632241813602,morphological_dilation,3,2
0X2C18E8C665E9D9A3.avi,49,667,388,279,71.90721649484536,morphological_dilation,3,2
0X2C190FF79A686E07.avi,97,1744,1360,384,28.235294117647058,morphological_dilation,3,2
0X2C190FF79A686E07.avi,119,1283,947,336,35.480464625131994,morphological_dilation,3,2
0X2C1966CD61F4608D.avi,123,1660,1284,376,29.283489096573206,morphological_dilation,3,2
0X2C1966CD61F4608D.avi,143,1038,714,324,45.378151260504204,morphological_dilation,3,2
0X2C19EFC05FC3B091.avi,42,1594,1226,368,30.0163132137031,morphological_dilation,3,2
0X2C19EFC05FC3B091.avi,53,1076,760,316,41.578947368421055,morphological_dilation,3,2
0X2C21A633164A6BFB.avi,98,1432,1092,340,31.135531135531135,morphological_dilation,3,2
0X2C21A633164A6BFB.avi,115,889,605,284,46.942148760330575,morphological_dilation,3,2
0X2C2DDBD3EB793DAA.avi,49,1754,1370,384,28.029197080291972,morphological_dilation,3,2
0X2C2DDBD3EB793DAA.avi,63,979,683,296,43.33821376281113,morphological_dilation,3,2
0X2C34E713BB4D3308.avi,150,2222,1782,440,24.691358024691358,morphological_dilation,3,2
0X2C34E713BB4D3308.avi,165,1579,1215,364,29.958847736625515,morphological_dilation,3,2
0X2C35AFD93B9496EA.avi,54,1746,1366,380,27.81844802342606,morphological_dilation,3,2
0X2C35AFD93B9496EA.avi,71,1191,896,295,32.924107142857146,morphological_dilation,3,2
0X2C36F355EB681B07.avi,120,1901,1514,387,25.561426684280054,morphological_dilation,3,2
0X2C36F355EB681B07.avi,138,1266,934,332,35.54603854389722,morphological_dilation,3,2
0X2C41E0CF2733C297.avi,49,1751,1363,388,28.46661775495231,morphological_dilation,3,2
0X2C41E0CF2733C297.avi,70,1057,737,320,43.419267299864316,morphological_dilation,3,2
0X2C45F28244AF0456.avi,56,1817,1401,416,29.693076374018556,morphological_dilation,3,2
0X2C45F28244AF0456.avi,69,1068,748,320,42.780748663101605,morphological_dilation,3,2
0X2C49216A08762644.avi,52,1863,1483,380,25.623735670937286,morphological_dilation,3,2
0X2C49216A08762644.avi,67,1053,749,304,40.58744993324432,morphological_dilation,3,2
0X2C49AB7562FAA93.avi,69,2232,1812,420,23.178807947019866,morphological_dilation,3,2
0X2C49AB7562FAA93.avi,84,1473,1129,344,30.46944198405669,morphological_dilation,3,2
0X2C49F6FD06CCBCF8.avi,152,2637,2193,444,20.24623803009576,morphological_dilation,3,2
0X2C49F6FD06CCBCF8.avi,172,1665,1309,356,27.19633307868602,morphological_dilation,3,2
0X2C4D02125B318CBD.avi,123,1492,1152,340,29.51388888888889,morphological_dilation,3,2
0X2C4D02125B318CBD.avi,145,986,694,292,42.07492795389049,morphological_dilation,3,2
0X2C511E5B9B2D8D2C.avi,47,1314,990,324,32.72727272727273,morphological_dilation,3,2
0X2C511E5B9B2D8D2C.avi,64,841,573,268,46.77137870855148,morphological_dilation,3,2
0X2C5353EF79A2AE33.avi,47,1583,1223,360,29.435813573180702,morphological_dilation,3,2
0X2C5353EF79A2AE33.avi,60,986,700,286,40.85714285714286,morphological_dilation,3,2
0X2C56A1B8986F6EA7.avi,3,2623,2135,488,22.857142857142858,morphological_dilation,3,2
0X2C56A1B8986F6EA7.avi,19,1605,1175,430,36.59574468085106,morphological_dilation,3,2
0X2C5FA07F95C49BEE.avi,53,1898,1518,380,25.03293807641634,morphological_dilation,3,2
0X2C5FA07F95C49BEE.avi,74,1367,1039,328,31.56881616939365,morphological_dilation,3,2
0X2C6012D44180AE4A.avi,34,1939,1551,388,25.01611863313991,morphological_dilation,3,2
0X2C6012D44180AE4A.avi,47,1721,1361,360,26.451138868479056,morphological_dilation,3,2
0X2C61E96BC700B20F.avi,112,3184,2676,508,18.98355754857997,morphological_dilation,3,2
0X2C61E96BC700B20F.avi,141,1788,1388,400,28.818443804034583,morphological_dilation,3,2
0X2C693B4B714F5F77.avi,59,1859,1455,404,27.766323024054984,morphological_dilation,3,2
0X2C693B4B714F5F77.avi,65,1182,850,332,39.05882352941176,morphological_dilation,3,2
0X2C73664CB7057853.avi,44,2067,1651,416,25.196850393700785,morphological_dilation,3,2
0X2C73664CB7057853.avi,67,1341,977,364,37.25690890481064,morphological_dilation,3,2
0X2C75C3C43D12BF.avi,95,1535,1163,372,31.986242476354253,morphological_dilation,3,2
0X2C75C3C43D12BF.avi,108,920,628,292,46.496815286624205,morphological_dilation,3,2
0X2C76048845DB3B26.avi,34,2404,1948,456,23.408624229979466,morphological_dilation,3,2
0X2C76048845DB3B26.avi,49,1316,950,366,38.526315789473685,morphological_dilation,3,2
0X2C79C011E028C5C8.avi,132,1907,1511,396,26.207809397749838,morphological_dilation,3,2
0X2C79C011E028C5C8.avi,151,1138,834,304,36.45083932853717,morphological_dilation,3,2
0X2C7D0289D4D9C8DA.avi,3,1670,1294,376,29.057187017001546,morphological_dilation,3,2
0X2C7D0289D4D9C8DA.avi,18,1064,744,320,43.01075268817204,morphological_dilation,3,2
0X2C7EE3815ECE5418.avi,57,1159,843,316,37.48517200474496,morphological_dilation,3,2
0X2C7EE3815ECE5418.avi,79,691,411,280,68.1265206812652,morphological_dilation,3,2
0X2C82A1C3E914188A.avi,141,1910,1502,408,27.163781624500665,morphological_dilation,3,2
0X2C82A1C3E914188A.avi,159,1457,1101,356,32.334241598546775,morphological_dilation,3,2
0X2C871D22AD5EAD1A.avi,90,1868,1482,386,26.045883940620783,morphological_dilation,3,2
0X2C871D22AD5EAD1A.avi,110,1382,1050,332,31.61904761904762,morphological_dilation,3,2
0X2C87657038E600E4.avi,111,1643,1267,376,29.67640094711918,morphological_dilation,3,2
0X2C87657038E600E4.avi,127,1017,712,305,42.837078651685395,morphological_dilation,3,2
0X2C8891A017BD1976.avi,53,1719,1347,372,27.616926503340757,morphological_dilation,3,2
0X2C8891A017BD1976.avi,68,1054,758,296,39.050131926121374,morphological_dilation,3,2
0X2C8D4E3F973C4C0C.avi,28,1400,1048,352,33.587786259541986,morphological_dilation,3,2
0X2C8D4E3F973C4C0C.avi,43,1045,737,308,41.7910447761194,morphological_dilation,3,2
0X2C8D5BE1148380DD.avi,45,1946,1558,388,24.90372272143774,morphological_dilation,3,2
0X2C8D5BE1148380DD.avi,57,1140,827,313,37.84764207980653,morphological_dilation,3,2
0X2C8E3C1FD1F556BC.avi,128,2183,1751,432,24.671616219303257,morphological_dilation,3,2
0X2C8E3C1FD1F556BC.avi,146,1275,935,340,36.36363636363637,morphological_dilation,3,2
0X2C8F95568F4E8742.avi,38,2554,2102,452,21.503330161750714,morphological_dilation,3,2
0X2C8F95568F4E8742.avi,56,1795,1385,410,29.602888086642597,morphological_dilation,3,2
0X2C90DA7EB02FCCD2.avi,45,3723,3186,537,16.854990583804145,morphological_dilation,3,2
0X2C90DA7EB02FCCD2.avi,69,2366,1906,460,24.134312696747116,morphological_dilation,3,2
0X2C91EA24C7C0B398.avi,125,1826,1442,384,26.629680998613036,morphological_dilation,3,2
0X2C91EA24C7C0B398.avi,142,1002,690,312,45.21739130434783,morphological_dilation,3,2
0X2C9357E39710C30C.avi,74,1729,1361,368,27.03894195444526,morphological_dilation,3,2
0X2C9357E39710C30C.avi,87,1347,1015,332,32.70935960591133,morphological_dilation,3,2
0X2C9420596D198D01.avi,83,2050,1638,412,25.152625152625152,morphological_dilation,3,2
0X2C9420596D198D01.avi,99,1352,1000,352,35.199999999999996,morphological_dilation,3,2
0X2C97A655ED70FABF.avi,121,1247,927,320,34.51995685005394,morphological_dilation,3,2
0X2C97A655ED70FABF.avi,143,760,507,253,49.90138067061144,morphological_dilation,3,2
0X2C97ECB94ED1AD37.avi,56,1610,1238,372,30.048465266558967,morphological_dilation,3,2
0X2C97ECB94ED1AD37.avi,73,973,677,296,43.72230428360414,morphological_dilation,3,2
0X2CA3761058236EF3.avi,98,1853,1473,380,25.797691785471827,morphological_dilation,3,2
0X2CA3761058236EF3.avi,115,1090,793,297,37.452711223203025,morphological_dilation,3,2
0X2CA42A8211675132.avi,55,2257,1841,416,22.596414991852253,morphological_dilation,3,2
0X2CA42A8211675132.avi,69,1312,980,332,33.87755102040816,morphological_dilation,3,2
0X2CA89051DE3DEC33.avi,82,1934,1510,424,28.079470198675498,morphological_dilation,3,2
0X2CA89051DE3DEC33.avi,98,1074,717,357,49.7907949790795,morphological_dilation,3,2
0X2CA927607A7AB65A.avi,46,1601,1226,375,30.587275693311582,morphological_dilation,3,2
0X2CA927607A7AB65A.avi,65,1123,815,308,37.79141104294478,morphological_dilation,3,2
0X2CAA96B0D5EB2D62.avi,33,1865,1469,396,26.9571136827774,morphological_dilation,3,2
0X2CAA96B0D5EB2D62.avi,44,1663,1283,380,29.61808261886204,morphological_dilation,3,2
0X2CADB19F2FEE68AD.avi,53,3637,3053,584,19.12872584343269,morphological_dilation,3,2
0X2CADB19F2FEE68AD.avi,68,2736,2225,511,22.966292134831463,morphological_dilation,3,2
0X2CAE2DE8A42A2342.avi,39,1685,1313,372,28.33206397562833,morphological_dilation,3,2
0X2CAE2DE8A42A2342.avi,53,1043,739,304,41.13667117726658,morphological_dilation,3,2
0X2CB0D18E525D7C37.avi,39,1687,1299,388,29.869130100076983,morphological_dilation,3,2
0X2CB0D18E525D7C37.avi,54,1047,747,300,40.16064257028113,morphological_dilation,3,2
0X2CB14DA1C391E86B.avi,150,2561,2109,452,21.431958274063536,morphological_dilation,3,2
0X2CB14DA1C391E86B.avi,182,1547,1195,352,29.456066945606697,morphological_dilation,3,2
0X2CB15E6A301D6B19.avi,121,1854,1454,400,27.51031636863824,morphological_dilation,3,2
0X2CB15E6A301D6B19.avi,141,1131,789,342,43.346007604562736,morphological_dilation,3,2
0X2CB1956D0DB0180C.avi,124,1375,1043,332,31.831255992329815,morphological_dilation,3,2
0X2CB1956D0DB0180C.avi,138,863,595,268,45.04201680672269,morphological_dilation,3,2
0X2CB329D5D9E62171.avi,31,1751,1355,396,29.225092250922508,morphological_dilation,3,2
0X2CB329D5D9E62171.avi,54,1237,877,360,41.04903078677309,morphological_dilation,3,2
0X2CB7A24A2CFDC0DE.avi,65,1337,1005,332,33.03482587064677,morphological_dilation,3,2
0X2CB7A24A2CFDC0DE.avi,86,798,534,264,49.43820224719101,morphological_dilation,3,2
0X2CB7A5F709ABD767.avi,44,1733,1373,360,26.219956300072834,morphological_dilation,3,2
0X2CB7A5F709ABD767.avi,58,1083,791,292,36.91529709228824,morphological_dilation,3,2
0X2CBCF722CBB5B80D.avi,54,1546,1178,368,31.239388794567063,morphological_dilation,3,2
0X2CBCF722CBB5B80D.avi,66,1340,996,344,34.53815261044177,morphological_dilation,3,2
0X2CBD88FCC98A48FB.avi,56,1811,1427,384,26.90960056061668,morphological_dilation,3,2
0X2CBD88FCC98A48FB.avi,73,1222,894,328,36.68903803131991,morphological_dilation,3,2
0X2CC10C4F3C7A5F8C.avi,56,5394,4710,684,14.522292993630574,morphological_dilation,3,2
0X2CC10C4F3C7A5F8C.avi,74,2997,2481,516,20.79806529625151,morphological_dilation,3,2
0X2CC1ACAF0876862A.avi,4,2424,1968,456,23.170731707317074,morphological_dilation,3,2
0X2CC1ACAF0876862A.avi,20,1661,1218,443,36.37110016420361,morphological_dilation,3,2
0X2CC9EEC1D61BB2BF.avi,42,1559,1187,372,31.33951137320977,morphological_dilation,3,2
0X2CC9EEC1D61BB2BF.avi,54,913,633,280,44.23380726698262,morphological_dilation,3,2
0X2CCCED512683D687.avi,1,1488,1144,344,30.069930069930066,morphological_dilation,3,2
0X2CCCED512683D687.avi,16,971,685,286,41.75182481751825,morphological_dilation,3,2
0X2CCF9716099B6F41.avi,82,1687,1307,380,29.074215761285387,morphological_dilation,3,2
0X2CCF9716099B6F41.avi,99,1165,841,324,38.525564803805,morphological_dilation,3,2
0X2CD8C8DD79E1675F.avi,61,3140,2621,519,19.8016024418161,morphological_dilation,3,2
0X2CD8C8DD79E1675F.avi,86,2348,1892,456,24.101479915433405,morphological_dilation,3,2
0X2CE0CBE435FB7161.avi,75,1451,1083,368,33.97968605724838,morphological_dilation,3,2
0X2CE0CBE435FB7161.avi,91,900,592,308,52.02702702702703,morphological_dilation,3,2
0X2CE2BBE899FB30A.avi,30,1696,1316,380,28.87537993920973,morphological_dilation,3,2
0X2CE2BBE899FB30A.avi,45,956,643,313,48.67807153965785,morphological_dilation,3,2
0X2CE2C2ECE6B2DEF3.avi,47,2047,1635,412,25.198776758409785,morphological_dilation,3,2
0X2CE2C2ECE6B2DEF3.avi,63,1716,1348,368,27.299703264094955,morphological_dilation,3,2
0X2CE35C58DEBA5E84.avi,89,2074,1658,416,25.090470446320868,morphological_dilation,3,2
0X2CE35C58DEBA5E84.avi,108,1164,848,316,37.264150943396224,morphological_dilation,3,2
0X2CE3CF0F97E7FC72.avi,47,2329,1893,436,23.032223983095616,morphological_dilation,3,2
0X2CE3CF0F97E7FC72.avi,61,1442,1078,364,33.76623376623377,morphological_dilation,3,2
0X2CE44822F7569ED4.avi,33,1796,1424,372,26.12359550561798,morphological_dilation,3,2
0X2CE44822F7569ED4.avi,45,1509,1165,344,29.527896995708154,morphological_dilation,3,2
0X2CE840CE9B6A835E.avi,99,3280,2740,540,19.708029197080293,morphological_dilation,3,2
0X2CE840CE9B6A835E.avi,117,1816,1356,460,33.92330383480826,morphological_dilation,3,2
0X2CE8B16185B68E.avi,2,2028,1620,408,25.185185185185183,morphological_dilation,3,2
0X2CE8B16185B68E.avi,19,1734,1350,384,28.444444444444443,morphological_dilation,3,2
0X2CEF6124DDC757CF.avi,61,1863,1471,392,26.648538409245408,morphological_dilation,3,2
0X2CEF6124DDC757CF.avi,71,1623,1263,360,28.50356294536817,morphological_dilation,3,2
0X2CF28B839885FBAE.avi,52,2111,1699,412,24.249558563861097,morphological_dilation,3,2
0X2CF28B839885FBAE.avi,67,1260,924,336,36.36363636363637,morphological_dilation,3,2
0X2CF2FAD1B2A26CEF.avi,54,2089,1665,424,25.465465465465464,morphological_dilation,3,2
0X2CF2FAD1B2A26CEF.avi,71,1499,1115,384,34.43946188340807,morphological_dilation,3,2
0X2CF7B35D7849A5D.avi,0,2607,2155,452,20.97447795823666,morphological_dilation,3,2
0X2CF7B35D7849A5D.avi,17,1518,1151,367,31.885317115551693,morphological_dilation,3,2
0X2CF9DE123FE188CA.avi,73,1367,1043,324,31.064237775647175,morphological_dilation,3,2
0X2CF9DE123FE188CA.avi,86,813,545,268,49.174311926605505,morphological_dilation,3,2
0X2CFC388D482B5B31.avi,0,1487,1139,348,30.553116769095702,morphological_dilation,3,2
0X2CFC388D482B5B31.avi,24,1214,898,316,35.18930957683742,morphological_dilation,3,2
0X2CFD447B055E05BF.avi,74,1786,1394,392,28.120516499282637,morphological_dilation,3,2
0X2CFD447B055E05BF.avi,85,1082,758,324,42.74406332453825,morphological_dilation,3,2
0X2CFD990707C2AFEF.avi,116,1727,1331,396,29.75206611570248,morphological_dilation,3,2
0X2CFD990707C2AFEF.avi,133,1086,757,329,43.46103038309115,morphological_dilation,3,2
0X2D03DD1D93E5C751.avi,115,1625,1241,384,30.942788074133766,morphological_dilation,3,2
0X2D03DD1D93E5C751.avi,125,1187,845,342,40.47337278106509,morphological_dilation,3,2
0X2D103F41D2E38399.avi,46,2291,1863,428,22.973698336017176,morphological_dilation,3,2
0X2D103F41D2E38399.avi,63,1724,1356,368,27.13864306784661,morphological_dilation,3,2
0X2D1062571172E8A7.avi,48,1797,1421,376,26.460239268121043,morphological_dilation,3,2
0X2D1062571172E8A7.avi,67,1225,921,304,33.00760043431053,morphological_dilation,3,2
0X2D10BE0BA5D1B6A9.avi,51,2634,2174,460,21.159153633854647,morphological_dilation,3,2
0X2D10BE0BA5D1B6A9.avi,68,1859,1467,392,26.7211997273347,morphological_dilation,3,2
0X2D17D1C132427A37.avi,39,1338,1006,332,33.00198807157058,morphological_dilation,3,2
0X2D17D1C132427A37.avi,49,906,630,276,43.80952380952381,morphological_dilation,3,2
0X2D196F26588E2E17.avi,63,2619,2131,488,22.90004692632567,morphological_dilation,3,2
0X2D196F26588E2E17.avi,77,1504,1120,384,34.285714285714285,morphological_dilation,3,2
0X2D19E502F1A7362E.avi,37,2859,2323,536,23.073611708996985,morphological_dilation,3,2
0X2D19E502F1A7362E.avi,49,1660,1216,444,36.51315789473684,morphological_dilation,3,2
0X2D1CE5FC57B6FBC1.avi,112,2080,1684,396,23.51543942992874,morphological_dilation,3,2
0X2D1CE5FC57B6FBC1.avi,134,1699,1343,356,26.5078183172003,morphological_dilation,3,2
0X2D23A079EADDFA54.avi,1,2560,2084,476,22.84069097888676,morphological_dilation,3,2
0X2D23A079EADDFA54.avi,17,1399,1047,352,33.61986628462273,morphological_dilation,3,2
0X2D2ED63C8BA47E4D.avi,45,2757,2281,476,20.8680403331872,morphological_dilation,3,2
0X2D2ED63C8BA47E4D.avi,61,1838,1430,408,28.53146853146853,morphological_dilation,3,2
0X2D30608E926E7FC8.avi,35,1562,1198,364,30.38397328881469,morphological_dilation,3,2
0X2D30608E926E7FC8.avi,47,921,621,300,48.309178743961354,morphological_dilation,3,2
0X2D34C7C038A1E3D2.avi,53,2636,2164,472,21.811460258780038,morphological_dilation,3,2
0X2D34C7C038A1E3D2.avi,71,1678,1277,401,31.40172278778387,morphological_dilation,3,2
0X2D3555E57E30410B.avi,46,1309,973,336,34.53237410071942,morphological_dilation,3,2
0X2D3555E57E30410B.avi,70,820,540,280,51.85185185185185,morphological_dilation,3,2
0X2D374A42BC63F7D3.avi,28,1688,1320,368,27.878787878787882,morphological_dilation,3,2
0X2D374A42BC63F7D3.avi,38,975,695,280,40.28776978417266,morphological_dilation,3,2
0X2D37B879A205F20E.avi,102,1698,1322,376,28.44175491679274,morphological_dilation,3,2
0X2D37B879A205F20E.avi,118,1078,762,316,41.46981627296588,morphological_dilation,3,2
0X2D37C242683F1061.avi,56,1139,835,304,36.40718562874252,morphological_dilation,3,2
0X2D37C242683F1061.avi,71,729,461,268,58.13449023861171,morphological_dilation,3,2
0X2D385BC839299FE6.avi,64,1438,1082,356,32.90203327171904,morphological_dilation,3,2
0X2D385BC839299FE6.avi,83,939,638,301,47.17868338557994,morphological_dilation,3,2
0X2D3D5BE721D93FAB.avi,48,1675,1299,376,28.94534257120862,morphological_dilation,3,2
0X2D3D5BE721D93FAB.avi,69,1152,822,330,40.14598540145985,morphological_dilation,3,2
0X2D3E3C182D1459C8.avi,52,1206,882,324,36.734693877551024,morphological_dilation,3,2
0X2D3E3C182D1459C8.avi,63,694,339,355,104.71976401179941,morphological_dilation,3,2
0X2D3F2E5FFA807CFF.avi,34,910,626,284,45.367412140575084,morphological_dilation,3,2
0X2D3F2E5FFA807CFF.avi,47,652,400,252,63.0,morphological_dilation,3,2
0X2D3F7E5490285446.avi,115,1313,985,328,33.2994923857868,morphological_dilation,3,2
0X2D3F7E5490285446.avi,130,749,497,252,50.70422535211267,morphological_dilation,3,2
0X2D405B452654D053.avi,71,1305,969,336,34.6749226006192,morphological_dilation,3,2
0X2D405B452654D053.avi,89,964,672,292,43.452380952380956,morphological_dilation,3,2
0X2D40DC11D737F49B.avi,44,2155,1723,432,25.07254788160186,morphological_dilation,3,2
0X2D40DC11D737F49B.avi,58,1451,1083,368,33.97968605724838,morphological_dilation,3,2
0X2D4304FA6A09F93E.avi,182,2743,2227,516,23.170184104176023,morphological_dilation,3,2
0X2D4304FA6A09F93E.avi,202,2354,1895,459,24.221635883905012,morphological_dilation,3,2
0X2D44B66B9949BE4D.avi,61,2169,1721,448,26.031377106333526,morphological_dilation,3,2
0X2D44B66B9949BE4D.avi,81,1219,859,360,41.90919674039581,morphological_dilation,3,2
0X2D4C335281042D7F.avi,76,1302,962,340,35.343035343035346,morphological_dilation,3,2
0X2D4C335281042D7F.avi,109,1760,1365,395,28.93772893772894,morphological_dilation,3,2
0X2D4E0673C195F693.avi,87,2665,2081,584,28.0634310427679,morphological_dilation,3,2
0X2D4E0673C195F693.avi,104,1591,1122,469,41.80035650623886,morphological_dilation,3,2
0X2D4F77FD196A3828.avi,156,1441,1105,336,30.407239819004523,morphological_dilation,3,2
0X2D4F77FD196A3828.avi,176,859,599,260,43.40567612687813,morphological_dilation,3,2
0X2D597332A98E785E.avi,72,3101,2605,496,19.040307101727446,morphological_dilation,3,2
0X2D597332A98E785E.avi,91,1607,1251,356,28.457234212629896,morphological_dilation,3,2
0X2D5BD6E67BD7AE69.avi,37,1683,1311,372,28.37528604118993,morphological_dilation,3,2
0X2D5BD6E67BD7AE69.avi,56,1143,819,324,39.56043956043956,morphological_dilation,3,2
0X2D5CC137BFF6A623.avi,60,1941,1537,404,26.284970722186074,morphological_dilation,3,2
0X2D5CC137BFF6A623.avi,82,1257,933,324,34.726688102893895,morphological_dilation,3,2
0X2D5E11117A6B333B.avi,60,2108,1688,420,24.881516587677723,morphological_dilation,3,2
0X2D5E11117A6B333B.avi,74,1268,924,344,37.22943722943723,morphological_dilation,3,2
0X2D604D85FE921D9.avi,35,1541,1185,356,30.042194092827003,morphological_dilation,3,2
0X2D604D85FE921D9.avi,48,803,551,252,45.73502722323049,morphological_dilation,3,2
0X2D658517E159F3F4.avi,42,2044,1640,404,24.634146341463413,morphological_dilation,3,2
0X2D658517E159F3F4.avi,57,1292,968,324,33.47107438016529,morphological_dilation,3,2
0X2D6601DFA32D0382.avi,33,1649,1289,360,27.928626842513577,morphological_dilation,3,2
0X2D6601DFA32D0382.avi,48,1070,759,311,40.974967061923586,morphological_dilation,3,2
0X2D66386606994937.avi,144,1905,1509,396,26.24254473161034,morphological_dilation,3,2
0X2D66386606994937.avi,164,1092,776,316,40.72164948453608,morphological_dilation,3,2
0X2D69D2B24305EB5.avi,28,2823,2327,496,21.3149978513107,morphological_dilation,3,2
0X2D69D2B24305EB5.avi,44,2258,1822,436,23.929747530186606,morphological_dilation,3,2
0X2D6CA36A674EDC8F.avi,42,2008,1600,408,25.5,morphological_dilation,3,2
0X2D6CA36A674EDC8F.avi,56,1527,1163,364,31.29836629406707,morphological_dilation,3,2
0X2D6F8C1DEA6EF363.avi,95,1759,1343,416,30.97542814594192,morphological_dilation,3,2
0X2D6F8C1DEA6EF363.avi,112,999,687,312,45.414847161572055,morphological_dilation,3,2
0X2D72B203AB220EAB.avi,59,1325,1001,324,32.36763236763237,morphological_dilation,3,2
0X2D72B203AB220EAB.avi,75,804,552,252,45.65217391304348,morphological_dilation,3,2
0X2D7C2A7FD48AC5CA.avi,28,1389,1049,340,32.41182078169685,morphological_dilation,3,2
0X2D7C2A7FD48AC5CA.avi,46,1017,717,300,41.84100418410041,morphological_dilation,3,2
0X2D7E8B6DA9FDB3E0.avi,147,2067,1648,419,25.4247572815534,morphological_dilation,3,2
0X2D7E8B6DA9FDB3E0.avi,173,1686,1297,389,29.9922898997687,morphological_dilation,3,2
0X2D82FF915BD14EFD.avi,96,1440,1084,356,32.84132841328413,morphological_dilation,3,2
0X2D82FF915BD14EFD.avi,113,933,641,292,45.55382215288611,morphological_dilation,3,2
0X2D88CA57C0CA4328.avi,96,1756,1344,412,30.654761904761905,morphological_dilation,3,2
0X2D88CA57C0CA4328.avi,116,1166,810,356,43.95061728395061,morphological_dilation,3,2
0X2D8A896770271A60.avi,22,1772,1373,399,29.060451565914057,morphological_dilation,3,2
0X2D8A896770271A60.avi,32,1350,998,352,35.27054108216433,morphological_dilation,3,2
0X2D8B38AA1ADBB074.avi,42,1603,1239,364,29.37853107344633,morphological_dilation,3,2
0X2D8B38AA1ADBB074.avi,57,1172,868,304,35.02304147465438,morphological_dilation,3,2
0X2D8BD5AF3B8DED9C.avi,28,1105,805,300,37.267080745341616,morphological_dilation,3,2
0X2D8BD5AF3B8DED9C.avi,46,676,436,240,55.04587155963303,morphological_dilation,3,2
0X2D909B4FCF030F77.avi,86,1833,1433,400,27.91346824842987,morphological_dilation,3,2
0X2D909B4FCF030F77.avi,99,1100,776,324,41.75257731958763,morphological_dilation,3,2
0X2D93EB042A3DB0E2.avi,34,2495,2039,456,22.36390387444826,morphological_dilation,3,2
0X2D93EB042A3DB0E2.avi,59,1469,1094,375,34.27787934186471,morphological_dilation,3,2
0X2D9566C4D06D6F28.avi,2,1299,967,332,34.332988624612206,morphological_dilation,3,2
0X2D9566C4D06D6F28.avi,19,915,623,292,46.869983948635635,morphological_dilation,3,2
0X2D958648FECCDF1E.avi,42,1376,996,380,38.152610441767074,morphological_dilation,3,2
0X2D958648FECCDF1E.avi,59,844,540,304,56.2962962962963,morphological_dilation,3,2
0X2D982113D0EC3AA0.avi,33,1472,1124,348,30.96085409252669,morphological_dilation,3,2
0X2D982113D0EC3AA0.avi,47,851,578,273,47.2318339100346,morphological_dilation,3,2
0X2D9DB9841B21B473.avi,99,1847,1459,388,26.593557230980124,morphological_dilation,3,2
0X2D9DB9841B21B473.avi,117,1500,1160,340,29.310344827586203,morphological_dilation,3,2
0X2D9E50E6BDB7CF9.avi,49,1403,1047,356,34.00191021967526,morphological_dilation,3,2
0X2D9E50E6BDB7CF9.avi,65,872,569,303,53.25131810193322,morphological_dilation,3,2
0X2DA55EE48DCFCD80.avi,37,2876,2388,488,20.435510887772192,morphological_dilation,3,2
0X2DA55EE48DCFCD80.avi,52,2472,2024,448,22.134387351778656,morphological_dilation,3,2
0X2DA7DA5B3CBF9227.avi,38,1726,1342,384,28.614008941877795,morphological_dilation,3,2
0X2DA7DA5B3CBF9227.avi,52,1049,741,308,41.56545209176788,morphological_dilation,3,2
0X2DA998F63F173C44.avi,88,1823,1423,400,28.109627547434997,morphological_dilation,3,2
0X2DA998F63F173C44.avi,103,1350,1020,330,32.35294117647059,morphological_dilation,3,2
0X2DA99F9FC1DAD8A9.avi,99,2190,1754,436,24.857468643101484,morphological_dilation,3,2
0X2DA99F9FC1DAD8A9.avi,114,1253,905,348,38.453038674033145,morphological_dilation,3,2
0X2DAD48A6BD57C623.avi,161,1166,860,306,35.581395348837205,morphological_dilation,3,2
0X2DAD48A6BD57C623.avi,174,788,524,264,50.38167938931297,morphological_dilation,3,2
0X2DAE446A22A6038.avi,86,1069,766,303,39.55613577023499,morphological_dilation,3,2
0X2DAE446A22A6038.avi,118,1475,1127,348,30.87843833185448,morphological_dilation,3,2
0X2DB1613A3E1C52F3.avi,55,1456,1124,332,29.537366548042705,morphological_dilation,3,2
0X2DB1613A3E1C52F3.avi,67,1199,887,312,35.174746335963924,morphological_dilation,3,2
0X2DB1F8801485264A.avi,75,2018,1582,436,27.560050568900124,morphological_dilation,3,2
0X2DB1F8801485264A.avi,91,1255,907,348,38.36824696802646,morphological_dilation,3,2
0X2DB87473EC321C75.avi,75,1860,1468,392,26.70299727520436,morphological_dilation,3,2
0X2DB87473EC321C75.avi,88,1101,801,300,37.453183520599254,morphological_dilation,3,2
0X2DC165EBD4F6A499.avi,72,1379,1059,320,30.217186024551463,morphological_dilation,3,2
0X2DC165EBD4F6A499.avi,94,1036,768,268,34.89583333333333,morphological_dilation,3,2
0X2DC355CC1C2B3876.avi,105,1495,1132,363,32.06713780918728,morphological_dilation,3,2
0X2DC355CC1C2B3876.avi,126,1001,687,314,45.70596797671033,morphological_dilation,3,2
0X2DC8C2A8797096FA.avi,84,2220,1788,432,24.161073825503358,morphological_dilation,3,2
0X2DC8C2A8797096FA.avi,104,1473,1097,376,34.275296262534184,morphological_dilation,3,2
0X2DCE146E4AE80A3D.avi,0,1681,1333,348,26.106526631657918,morphological_dilation,3,2
0X2DCE146E4AE80A3D.avi,20,1584,1220,364,29.836065573770494,morphological_dilation,3,2
0X2DD4B303E3F4FCB5.avi,81,2326,1894,432,22.80887011615628,morphological_dilation,3,2
0X2DD4B303E3F4FCB5.avi,100,1427,1083,344,31.763619575253927,morphological_dilation,3,2
0X2DD603AC2C74F6EC.avi,41,1204,876,328,37.44292237442922,morphological_dilation,3,2
0X2DD603AC2C74F6EC.avi,57,673,415,258,62.16867469879518,morphological_dilation,3,2
0X2DD74DF5EE1C2986.avi,99,1657,1285,372,28.949416342412455,morphological_dilation,3,2
0X2DD74DF5EE1C2986.avi,132,1019,719,300,41.72461752433936,morphological_dilation,3,2
0X2DDA61D944C9F9C3.avi,43,1367,1035,332,32.07729468599034,morphological_dilation,3,2
0X2DDA61D944C9F9C3.avi,53,837,554,283,51.08303249097473,morphological_dilation,3,2
0X2DDFB92556009B4C.avi,66,1413,1020,393,38.529411764705884,morphological_dilation,3,2
0X2DDFB92556009B4C.avi,78,951,631,320,50.71315372424723,morphological_dilation,3,2
0X2DE30D01995BB762.avi,78,2027,1615,412,25.510835913312697,morphological_dilation,3,2
0X2DE30D01995BB762.avi,92,1253,927,326,35.16720604099245,morphological_dilation,3,2
0X2DE58B024738E3C7.avi,0,1549,1169,380,32.50641573994867,morphological_dilation,3,2
0X2DE58B024738E3C7.avi,16,972,636,336,52.83018867924528,morphological_dilation,3,2
0X2DE5DE59AE16AF82.avi,60,2236,1816,420,23.127753303964756,morphological_dilation,3,2
0X2DE5DE59AE16AF82.avi,80,1475,1111,364,32.76327632763276,morphological_dilation,3,2
0X2DE6608CDEC4A536.avi,2,2153,1741,412,23.664560597357838,morphological_dilation,3,2
0X2DE6608CDEC4A536.avi,15,1186,849,337,39.69375736160188,morphological_dilation,3,2
0X2DE6FC105DDE8B38.avi,38,1463,1127,336,29.81366459627329,morphological_dilation,3,2
0X2DE6FC105DDE8B38.avi,51,1392,1064,328,30.82706766917293,morphological_dilation,3,2
0X2DEC11BFCC04AD8.avi,128,2060,1664,396,23.798076923076923,morphological_dilation,3,2
0X2DEC11BFCC04AD8.avi,151,1225,905,320,35.35911602209944,morphological_dilation,3,2
0X2DEDA110B28EFD48.avi,47,1488,1144,344,30.069930069930066,morphological_dilation,3,2
0X2DEDA110B28EFD48.avi,63,889,626,263,42.01277955271566,morphological_dilation,3,2
0X2DF0CD09785D2C10.avi,159,1900,1456,444,30.494505494505496,morphological_dilation,3,2
0X2DF0CD09785D2C10.avi,178,1614,1214,400,32.948929159802304,morphological_dilation,3,2
0X2DF88C27BB20C25D.avi,157,1562,1222,340,27.823240589198033,morphological_dilation,3,2
0X2DF88C27BB20C25D.avi,172,1161,873,288,32.98969072164948,morphological_dilation,3,2
0X2DFB4F76758EF666.avi,96,3134,2606,528,20.260936300844207,morphological_dilation,3,2
0X2DFB4F76758EF666.avi,110,1995,1571,424,26.98917886696372,morphological_dilation,3,2
0X2E0036AF7A9C970E.avi,52,1671,1287,384,29.836829836829835,morphological_dilation,3,2
0X2E0036AF7A9C970E.avi,66,1012,708,304,42.93785310734463,morphological_dilation,3,2
0X2E00AD0FD28287B9.avi,72,4075,3511,564,16.063799487325547,morphological_dilation,3,2
0X2E00AD0FD28287B9.avi,90,3305,2801,504,17.993573723670117,morphological_dilation,3,2
0X2E03541DE1D78F8C.avi,44,1590,1214,376,30.971993410214164,morphological_dilation,3,2
0X2E03541DE1D78F8C.avi,57,835,535,300,56.074766355140184,morphological_dilation,3,2
0X2E041070DF3C0BCD.avi,51,1901,1489,412,27.669576897246472,morphological_dilation,3,2
0X2E041070DF3C0BCD.avi,73,1291,935,356,38.074866310160424,morphological_dilation,3,2
0X2E08BE7843E94F2C.avi,52,1266,950,316,33.26315789473684,morphological_dilation,3,2
0X2E08BE7843E94F2C.avi,74,827,575,252,43.826086956521735,morphological_dilation,3,2
0X2E0A75B64C955D2F.avi,94,2553,2090,463,22.15311004784689,morphological_dilation,3,2
0X2E0A75B64C955D2F.avi,113,1414,1062,352,33.14500941619586,morphological_dilation,3,2
0X2E0FDC08CC93A3C6.avi,115,2226,1814,412,22.712238147739804,morphological_dilation,3,2
0X2E0FDC08CC93A3C6.avi,133,1371,1021,350,34.280117531831536,morphological_dilation,3,2
0X2E10D578B99BF9F3.avi,1,3903,3323,580,17.454107733975324,morphological_dilation,3,2
0X2E10D578B99BF9F3.avi,19,2227,1764,463,26.24716553287982,morphological_dilation,3,2
0X2E1476D1A5C2BA29.avi,31,1378,1047,331,31.614135625596944,morphological_dilation,3,2
0X2E1476D1A5C2BA29.avi,43,932,642,290,45.17133956386293,morphological_dilation,3,2
0X2E17DD438B26829.avi,38,1801,1414,387,27.36916548797737,morphological_dilation,3,2
0X2E17DD438B26829.avi,54,1141,821,320,38.976857490864795,morphological_dilation,3,2
0X2E19B6DE8518F7FD.avi,112,1452,1112,340,30.575539568345324,morphological_dilation,3,2
0X2E19B6DE8518F7FD.avi,125,1019,715,304,42.51748251748252,morphological_dilation,3,2
0X2E1C7FD7AF5F7124.avi,51,1937,1513,424,28.02379378717779,morphological_dilation,3,2
0X2E1C7FD7AF5F7124.avi,66,1190,858,332,38.6946386946387,morphological_dilation,3,2
0X2E1EAA6DEAA3C9A4.avi,42,1445,1085,360,33.17972350230415,morphological_dilation,3,2
0X2E1EAA6DEAA3C9A4.avi,61,858,536,322,60.07462686567165,morphological_dilation,3,2
0X2E1EF8E244CECCFD.avi,91,2141,1729,412,23.828802776171198,morphological_dilation,3,2
0X2E1EF8E244CECCFD.avi,109,1409,1061,348,32.79924599434496,morphological_dilation,3,2
0X2E2A4F7D4604622F.avi,120,2056,1648,408,24.75728155339806,morphological_dilation,3,2
0X2E2A4F7D4604622F.avi,137,1429,1065,364,34.178403755868544,morphological_dilation,3,2
0X2E2E861DD589D587.avi,110,2275,1827,448,24.521072796934863,morphological_dilation,3,2
0X2E2E861DD589D587.avi,125,1357,1009,348,34.489593657086225,morphological_dilation,3,2
0X2E2FB299A22B2B76.avi,64,1868,1489,379,25.453324378777705,morphological_dilation,3,2
0X2E2FB299A22B2B76.avi,83,1056,772,284,36.787564766839374,morphological_dilation,3,2
0X2E38C47AC9A2A3E6.avi,80,874,588,286,48.63945578231292,morphological_dilation,3,2
0X2E38C47AC9A2A3E6.avi,96,584,350,234,66.85714285714286,morphological_dilation,3,2
0X2E407BCA61BDF192.avi,45,1806,1422,384,27.004219409282697,morphological_dilation,3,2
0X2E407BCA61BDF192.avi,63,1030,742,288,38.81401617250674,morphological_dilation,3,2
0X2E410E770355AAC2.avi,109,1647,1271,376,29.58300550747443,morphological_dilation,3,2
0X2E410E770355AAC2.avi,126,912,624,288,46.15384615384615,morphological_dilation,3,2
0X2E42A13CDA91A601.avi,40,3166,2639,527,19.969685486926867,morphological_dilation,3,2
0X2E42A13CDA91A601.avi,56,2449,1963,486,24.758023433520123,morphological_dilation,3,2
0X2E462984BEAE8FCD.avi,119,1168,864,304,35.18518518518518,morphological_dilation,3,2
0X2E462984BEAE8FCD.avi,134,707,455,252,55.38461538461539,morphological_dilation,3,2
0X2E46B7FD40A6955D.avi,40,2162,1742,420,24.110218140068888,morphological_dilation,3,2
0X2E46B7FD40A6955D.avi,56,1540,1182,358,30.287648054145517,morphological_dilation,3,2
0X2E47B387F4355FB3.avi,84,1852,1468,384,26.158038147138964,morphological_dilation,3,2
0X2E47B387F4355FB3.avi,100,1163,839,324,38.61740166865316,morphological_dilation,3,2
0X2E4CC2441CFABDB0.avi,49,2571,2112,459,21.732954545454543,morphological_dilation,3,2
0X2E4CC2441CFABDB0.avi,68,1489,1121,368,32.8278322925959,morphological_dilation,3,2
0X2E52102EE379C357.avi,52,4760,4140,620,14.975845410628018,morphological_dilation,3,2
0X2E52102EE379C357.avi,66,2914,2426,488,20.115416323165704,morphological_dilation,3,2
0X2E5298542F1F9C97.avi,137,2293,1853,440,23.745277927684835,morphological_dilation,3,2
0X2E5298542F1F9C97.avi,151,1601,1213,388,31.986809563066775,morphological_dilation,3,2
0X2E580D3095F8413D.avi,44,2004,1561,443,28.379244074311337,morphological_dilation,3,2
0X2E580D3095F8413D.avi,56,1197,832,365,43.87019230769231,morphological_dilation,3,2
0X2E5D1A5A950E394A.avi,55,1552,1208,344,28.47682119205298,morphological_dilation,3,2
0X2E5D1A5A950E394A.avi,75,1055,755,300,39.735099337748345,morphological_dilation,3,2
0X2E5D7030DC1C9FBC.avi,171,2854,2374,480,20.219039595619208,morphological_dilation,3,2
0X2E5D7030DC1C9FBC.avi,189,2398,1958,440,22.47191011235955,morphological_dilation,3,2
0X2E5EDA11D632F50.avi,55,1536,1180,356,30.16949152542373,morphological_dilation,3,2
0X2E5EDA11D632F50.avi,73,962,674,288,42.72997032640949,morphological_dilation,3,2
0X2E61656CEDFA0B02.avi,126,1959,1559,400,25.657472738935216,morphological_dilation,3,2
0X2E61656CEDFA0B02.avi,148,1253,921,332,36.047774158523346,morphological_dilation,3,2
0X2E636FB653B4D46.avi,60,1861,1461,400,27.378507871321013,morphological_dilation,3,2
0X2E636FB653B4D46.avi,85,1163,842,321,38.12351543942993,morphological_dilation,3,2
0X2E707E80B324D9F8.avi,68,3332,2808,524,18.66096866096866,morphological_dilation,3,2
0X2E707E80B324D9F8.avi,88,2118,1690,428,25.325443786982248,morphological_dilation,3,2
0X2E711400B03C543B.avi,56,1695,1339,356,26.58700522778193,morphological_dilation,3,2
0X2E711400B03C543B.avi,74,1154,843,311,36.8920521945433,morphological_dilation,3,2
0X2E71FF0BAAC3BEC1.avi,69,2167,1751,416,23.75785265562536,morphological_dilation,3,2
0X2E71FF0BAAC3BEC1.avi,81,1268,924,344,37.22943722943723,morphological_dilation,3,2
0X2E733C8B779C06B7.avi,34,2315,1879,436,23.203831825439064,morphological_dilation,3,2
0X2E733C8B779C06B7.avi,55,1892,1476,416,28.184281842818425,morphological_dilation,3,2
0X2E74B3A21BA7934E.avi,137,1555,1201,354,29.475437135720234,morphological_dilation,3,2
0X2E74B3A21BA7934E.avi,149,994,666,328,49.249249249249246,morphological_dilation,3,2
0X2E77A82F2D70D940.avi,41,1865,1465,400,27.303754266211605,morphological_dilation,3,2
0X2E77A82F2D70D940.avi,56,1172,844,328,38.862559241706165,morphological_dilation,3,2
0X2E7C63C6E680E0FD.avi,58,1549,1197,352,29.406850459482037,morphological_dilation,3,2
0X2E7C63C6E680E0FD.avi,80,1031,727,304,41.81568088033013,morphological_dilation,3,2
0X2E7D89B9C53F4DBF.avi,37,1053,761,292,38.370565045992116,morphological_dilation,3,2
0X2E7D89B9C53F4DBF.avi,48,704,456,248,54.385964912280706,morphological_dilation,3,2
0X2E8342A7771D0391.avi,50,1110,786,324,41.221374045801525,morphological_dilation,3,2
0X2E8342A7771D0391.avi,61,742,453,289,63.796909492273734,morphological_dilation,3,2
0X2E879F97E4C4DB87.avi,32,1324,1000,324,32.4,morphological_dilation,3,2
0X2E879F97E4C4DB87.avi,44,898,626,272,43.45047923322684,morphological_dilation,3,2
0X2E8A4D028176C17A.avi,76,2549,2117,432,20.40623523854511,morphological_dilation,3,2
0X2E8A4D028176C17A.avi,96,2191,1787,404,22.607722439843315,morphological_dilation,3,2
0X2E8CF6423EA1B7EC.avi,49,1461,1117,344,30.796777081468218,morphological_dilation,3,2
0X2E8CF6423EA1B7EC.avi,65,964,676,288,42.60355029585799,morphological_dilation,3,2
0X2E908EB5E89DD099.avi,94,2733,2229,504,22.611036339165544,morphological_dilation,3,2
0X2E908EB5E89DD099.avi,108,1563,1159,404,34.85763589301122,morphological_dilation,3,2
0X2E924753D4D5ED2A.avi,103,1582,1226,356,29.03752039151713,morphological_dilation,3,2
0X2E924753D4D5ED2A.avi,114,1037,737,300,40.70556309362279,morphological_dilation,3,2
0X2E94465751550B92.avi,1,2097,1685,412,24.451038575667656,morphological_dilation,3,2
0X2E94465751550B92.avi,19,1226,914,312,34.13566739606127,morphological_dilation,3,2
0X2E9602C7CB2FD797.avi,58,2116,1692,424,25.059101654846334,morphological_dilation,3,2
0X2E9602C7CB2FD797.avi,74,1326,970,356,36.70103092783505,morphological_dilation,3,2
0X2E9AEFC26169C304.avi,37,1338,1010,328,32.475247524752476,morphological_dilation,3,2
0X2E9AEFC26169C304.avi,51,887,608,279,45.88815789473684,morphological_dilation,3,2
0X2E9E2C168789FA46.avi,42,4070,3451,619,17.936829904375543,morphological_dilation,3,2
0X2E9E2C168789FA46.avi,62,2633,2142,491,22.92250233426704,morphological_dilation,3,2
0X2EA240C55AAD9858.avi,1,2569,2113,456,21.580690960719355,morphological_dilation,3,2
0X2EA240C55AAD9858.avi,21,1606,1234,372,30.14586709886548,morphological_dilation,3,2
0X2EA4BD879EEE7D43.avi,101,1038,750,288,38.4,morphological_dilation,3,2
0X2EA4BD879EEE7D43.avi,111,733,477,256,53.66876310272537,morphological_dilation,3,2
0X2EA8A7FE9B5CD93E.avi,41,2244,1816,428,23.568281938325992,morphological_dilation,3,2
0X2EA8A7FE9B5CD93E.avi,62,1402,1050,352,33.523809523809526,morphological_dilation,3,2
0X2EADDC6889C08ABC.avi,64,1829,1441,388,26.925746009715475,morphological_dilation,3,2
0X2EADDC6889C08ABC.avi,81,1128,812,316,38.91625615763547,morphological_dilation,3,2
0X2EAF0F81176431E0.avi,116,1552,1192,360,30.201342281879196,morphological_dilation,3,2
0X2EAF0F81176431E0.avi,127,959,671,288,42.92101341281669,morphological_dilation,3,2
0X2EAF0FCB979CE980.avi,58,1744,1376,368,26.744186046511626,morphological_dilation,3,2
0X2EAF0FCB979CE980.avi,78,1154,846,308,36.40661938534279,morphological_dilation,3,2
0X2EB2CC02E37A1070.avi,35,1185,881,304,34.50624290578887,morphological_dilation,3,2
0X2EB2CC02E37A1070.avi,51,990,718,272,37.88300835654596,morphological_dilation,3,2
0X2EB39D9717E466FB.avi,42,1452,1128,324,28.723404255319153,morphological_dilation,3,2
0X2EB39D9717E466FB.avi,56,930,662,268,40.483383685800604,morphological_dilation,3,2
0X2EB86B8EAE0A26F0.avi,54,3150,2650,500,18.867924528301888,morphological_dilation,3,2
0X2EB86B8EAE0A26F0.avi,72,1921,1517,404,26.631509558338827,morphological_dilation,3,2
0X2EB93A2E4548142E.avi,31,2131,1719,412,23.9674229203025,morphological_dilation,3,2
0X2EB93A2E4548142E.avi,49,1703,1331,372,27.948910593538695,morphological_dilation,3,2
0X2EBCFAC54E08438.avi,55,3379,2835,544,19.188712522045854,morphological_dilation,3,2
0X2EBCFAC54E08438.avi,74,2104,1668,436,26.139088729016784,morphological_dilation,3,2
0X2EC24D55FD3FC423.avi,102,1947,1557,390,25.048169556840076,morphological_dilation,3,2
0X2EC24D55FD3FC423.avi,116,1148,796,352,44.221105527638194,morphological_dilation,3,2
0X2EC2E75D27C6F224.avi,18,1124,828,296,35.748792270531396,morphological_dilation,3,2
0X2EC2E75D27C6F224.avi,46,1670,1306,364,27.871362940275652,morphological_dilation,3,2
0X2EC3A1A5F3971273.avi,71,2321,1905,416,21.83727034120735,morphological_dilation,3,2
0X2EC3A1A5F3971273.avi,81,2026,1634,392,23.990208078335375,morphological_dilation,3,2
0X2EC3E1044DE5412D.avi,48,1839,1447,392,27.090532135452662,morphological_dilation,3,2
0X2EC3E1044DE5412D.avi,62,1188,872,316,36.23853211009174,morphological_dilation,3,2
0X2EC46449B60FD85B.avi,90,1812,1424,388,27.247191011235955,morphological_dilation,3,2
0X2EC46449B60FD85B.avi,104,1084,776,308,39.69072164948454,morphological_dilation,3,2
0X2EC469A29DD619FF.avi,68,1470,1122,348,31.016042780748666,morphological_dilation,3,2
0X2EC469A29DD619FF.avi,79,1058,754,304,40.318302387267906,morphological_dilation,3,2
0X2EC98D548B0A3542.avi,129,1693,1329,364,27.389014296463504,morphological_dilation,3,2
0X2EC98D548B0A3542.avi,148,986,698,288,41.260744985673355,morphological_dilation,3,2
0X2ECD35E6B98033EB.avi,70,2322,1894,428,22.597676874340024,morphological_dilation,3,2
0X2ECD35E6B98033EB.avi,84,1744,1368,376,27.485380116959064,morphological_dilation,3,2
0X2ECE3ECC0BF62256.avi,65,2057,1637,420,25.65668906536347,morphological_dilation,3,2
0X2ECE3ECC0BF62256.avi,80,1222,858,364,42.42424242424242,morphological_dilation,3,2
0X2ED5BE4B6181065A.avi,52,1374,1038,336,32.369942196531795,morphological_dilation,3,2
0X2ED5BE4B6181065A.avi,62,915,612,303,49.50980392156863,morphological_dilation,3,2
0X2ED852A3EC97B2E1.avi,2,1641,1265,376,29.723320158102766,morphological_dilation,3,2
0X2ED852A3EC97B2E1.avi,22,971,649,322,49.61479198767334,morphological_dilation,3,2
0X2EDA3A769536EEF8.avi,149,2461,1997,464,23.234852278417627,morphological_dilation,3,2
0X2EDA3A769536EEF8.avi,164,1991,1568,423,26.977040816326532,morphological_dilation,3,2
0X2EDDFC5697535B9C.avi,55,3110,2610,500,19.157088122605366,morphological_dilation,3,2
0X2EDDFC5697535B9C.avi,74,1969,1553,416,26.78686413393432,morphological_dilation,3,2
0X2EDF6921AA560E72.avi,82,1763,1391,372,26.74335010783609,morphological_dilation,3,2
0X2EDF6921AA560E72.avi,104,1029,741,288,38.8663967611336,morphological_dilation,3,2
0X2EE0A304184B797.avi,39,1189,873,316,36.19702176403207,morphological_dilation,3,2
0X2EE0A304184B797.avi,55,778,516,262,50.775193798449614,morphological_dilation,3,2
0X2EE1815F10D8A1F.avi,92,1191,891,300,33.670033670033675,morphological_dilation,3,2
0X2EE1815F10D8A1F.avi,107,819,571,248,43.43257443082312,morphological_dilation,3,2
0X2EE56F270D208DF2.avi,45,3827,3357,470,14.000595770032767,morphological_dilation,3,2
0X2EE56F270D208DF2.avi,63,2941,2488,453,18.207395498392284,morphological_dilation,3,2
0X2EE5F2D684F133AA.avi,42,2160,1748,412,23.569794050343248,morphological_dilation,3,2
0X2EE5F2D684F133AA.avi,54,1503,1139,364,31.957857769973664,morphological_dilation,3,2
0X2EE799C4FDC049DB.avi,8,1508,1164,344,29.553264604810998,morphological_dilation,3,2
0X2EE799C4FDC049DB.avi,26,942,658,284,43.161094224924014,morphological_dilation,3,2
0X2EEB52E916176270.avi,98,1870,1475,395,26.779661016949152,morphological_dilation,3,2
0X2EEB52E916176270.avi,118,1074,774,300,38.759689922480625,morphological_dilation,3,2
0X2EF360C2BADB742.avi,77,2194,1782,412,23.120089786756452,morphological_dilation,3,2
0X2EF360C2BADB742.avi,89,1773,1385,388,28.014440433212997,morphological_dilation,3,2
0X2EF6FF02EC002834.avi,253,1927,1543,384,24.88658457550227,morphological_dilation,3,2
0X2EF6FF02EC002834.avi,276,1605,1249,356,28.502802241793436,morphological_dilation,3,2
0X2EF985AA40F1925D.avi,46,2749,2289,460,20.096111839231106,morphological_dilation,3,2
0X2EF985AA40F1925D.avi,66,1637,1265,372,29.40711462450593,morphological_dilation,3,2
0X2EFB024B09168681.avi,48,2321,1886,435,23.064687168610817,morphological_dilation,3,2
0X2EFB024B09168681.avi,68,1732,1360,372,27.35294117647059,morphological_dilation,3,2
0X2EFB608A1CC1437F.avi,63,1460,1132,328,28.975265017667844,morphological_dilation,3,2
0X2EFB608A1CC1437F.avi,79,1155,847,308,36.36363636363637,morphological_dilation,3,2
0X2F064717C2ADEB37.avi,61,1314,988,326,32.99595141700405,morphological_dilation,3,2
0X2F064717C2ADEB37.avi,76,861,572,289,50.52447552447552,morphological_dilation,3,2
0X2F094CEC2EEA4606.avi,54,1494,1138,356,31.282952548330407,morphological_dilation,3,2
0X2F094CEC2EEA4606.avi,72,1057,757,300,39.63011889035667,morphological_dilation,3,2
0X2F0A8FC115DF5430.avi,47,1665,1305,360,27.586206896551722,morphological_dilation,3,2
0X2F0A8FC115DF5430.avi,63,1294,982,312,31.771894093686353,morphological_dilation,3,2
0X2F0CAB93EBD17678.avi,67,1271,957,314,32.81086729362591,morphological_dilation,3,2
0X2F0CAB93EBD17678.avi,88,738,490,248,50.61224489795918,morphological_dilation,3,2
0X2F0CC49D6B277135.avi,77,2062,1634,428,26.193390452876375,morphological_dilation,3,2
0X2F0CC49D6B277135.avi,103,1324,972,352,36.21399176954733,morphological_dilation,3,2
0X2F0F6CF2E9C4A169.avi,46,1872,1476,396,26.82926829268293,morphological_dilation,3,2
0X2F0F6CF2E9C4A169.avi,61,1141,817,324,39.657282741738065,morphological_dilation,3,2
0X2F102F29E46CC1C0.avi,49,1591,1235,356,28.825910931174086,morphological_dilation,3,2
0X2F102F29E46CC1C0.avi,64,1014,722,292,40.443213296398895,morphological_dilation,3,2
0X2F11637431660144.avi,40,1262,930,332,35.6989247311828,morphological_dilation,3,2
0X2F11637431660144.avi,52,732,480,252,52.5,morphological_dilation,3,2
0X2F15468C912C8E60.avi,1,2028,1628,400,24.57002457002457,morphological_dilation,3,2
0X2F15468C912C8E60.avi,18,1250,922,328,35.57483731019523,morphological_dilation,3,2
0X2F15D09454E8628C.avi,130,2704,2220,484,21.8018018018018,morphological_dilation,3,2
0X2F15D09454E8628C.avi,146,1663,1247,416,33.360064153969525,morphological_dilation,3,2
0X2F178A2E89C73B5.avi,112,1649,1289,360,27.928626842513577,morphological_dilation,3,2
0X2F178A2E89C73B5.avi,128,1350,1026,324,31.57894736842105,morphological_dilation,3,2
0X2F1E80FB8078C3E8.avi,168,2866,2342,524,22.37403928266439,morphological_dilation,3,2
0X2F1E80FB8078C3E8.avi,189,2008,1530,478,31.241830065359476,morphological_dilation,3,2
0X2F1EFBACA8FA6CB5.avi,22,2199,1795,404,22.506963788300833,morphological_dilation,3,2
0X2F1EFBACA8FA6CB5.avi,32,1811,1443,368,25.502425502425503,morphological_dilation,3,2
0X2F21A058E2B8304A.avi,123,1621,1253,368,29.36951316839585,morphological_dilation,3,2
0X2F21A058E2B8304A.avi,132,1046,754,292,38.726790450928384,morphological_dilation,3,2
0X2F290311A5574772.avi,46,1768,1376,392,28.488372093023255,morphological_dilation,3,2
0X2F290311A5574772.avi,62,1136,802,334,41.64588528678304,morphological_dilation,3,2
0X2F29E8E7691D0E32.avi,57,1444,1076,368,34.20074349442379,morphological_dilation,3,2
0X2F29E8E7691D0E32.avi,74,931,603,328,54.39469320066335,morphological_dilation,3,2
0X2F2A34E211A5A1FE.avi,0,2762,2278,484,21.24670763827919,morphological_dilation,3,2
0X2F2A34E211A5A1FE.avi,16,1924,1500,424,28.26666666666667,morphological_dilation,3,2
0X2F3141F00A232601.avi,117,1773,1385,388,28.014440433212997,morphological_dilation,3,2
0X2F3141F00A232601.avi,133,1381,1036,345,33.3011583011583,morphological_dilation,3,2
0X2F32F1458812322B.avi,38,1610,1254,356,28.38915470494418,morphological_dilation,3,2
0X2F32F1458812322B.avi,55,999,691,308,44.57308248914617,morphological_dilation,3,2
0X2F332BC4ACA747A0.avi,40,1628,1240,388,31.290322580645164,morphological_dilation,3,2
0X2F332BC4ACA747A0.avi,55,956,636,320,50.314465408805034,morphological_dilation,3,2
0X2F35B6AE58B2D4A4.avi,34,2981,2509,472,18.812275807094462,morphological_dilation,3,2
0X2F35B6AE58B2D4A4.avi,46,1677,1306,371,28.407350689127103,morphological_dilation,3,2
0X2F38FFD4351DB77B.avi,91,2831,2335,496,21.241970021413277,morphological_dilation,3,2
0X2F38FFD4351DB77B.avi,105,1795,1391,404,29.043853342918762,morphological_dilation,3,2
0X2F3A223D2AC5A8C9.avi,91,2195,1775,420,23.661971830985916,morphological_dilation,3,2
0X2F3A223D2AC5A8C9.avi,106,1892,1516,376,24.80211081794195,morphological_dilation,3,2
0X2F3ABF4B8389713F.avi,51,1418,1070,348,32.52336448598131,morphological_dilation,3,2
0X2F3ABF4B8389713F.avi,71,890,610,280,45.90163934426229,morphological_dilation,3,2
0X2F3CE7185C80B272.avi,46,2149,1750,399,22.8,morphological_dilation,3,2
0X2F3CE7185C80B272.avi,65,1504,1164,340,29.20962199312715,morphological_dilation,3,2
0X2F3DCD66E67791C0.avi,45,1238,922,316,34.273318872017356,morphological_dilation,3,2
0X2F3DCD66E67791C0.avi,64,826,550,276,50.18181818181818,morphological_dilation,3,2
0X2F405D88DA52F20D.avi,2,3514,2966,548,18.476062036412678,morphological_dilation,3,2
0X2F405D88DA52F20D.avi,19,2376,1888,488,25.847457627118644,morphological_dilation,3,2
0X2F51B5A594D13CC4.avi,53,2119,1675,444,26.507462686567163,morphological_dilation,3,2
0X2F51B5A594D13CC4.avi,71,1214,870,344,39.54022988505747,morphological_dilation,3,2
0X2F5250C07A31A531.avi,73,1359,1007,352,34.955312810327705,morphological_dilation,3,2
0X2F5250C07A31A531.avi,86,906,618,288,46.601941747572816,morphological_dilation,3,2
0X2F55C5011B932EE5.avi,104,2323,1915,408,21.305483028720626,morphological_dilation,3,2
0X2F55C5011B932EE5.avi,124,1455,1115,340,30.493273542600896,morphological_dilation,3,2
0X2F57AD6F6A61BD37.avi,179,1735,1351,384,28.423390081421168,morphological_dilation,3,2
0X2F57AD6F6A61BD37.avi,198,1038,705,333,47.23404255319149,morphological_dilation,3,2
0X2F57AF57EBACCEB.avi,85,2791,2295,496,21.612200435729847,morphological_dilation,3,2
0X2F57AF57EBACCEB.avi,104,1511,1127,384,34.07275953859805,morphological_dilation,3,2
0X2F588214D2744257.avi,49,1551,1195,356,29.7907949790795,morphological_dilation,3,2
0X2F588214D2744257.avi,70,926,618,308,49.83818770226537,morphological_dilation,3,2
0X2F59305E0FDCC775.avi,43,1349,1045,304,29.09090909090909,morphological_dilation,3,2
0X2F59305E0FDCC775.avi,59,916,644,272,42.2360248447205,morphological_dilation,3,2
0X2F5B2D5DBDD28F66.avi,5,2947,2471,476,19.263456090651555,morphological_dilation,3,2
0X2F5B2D5DBDD28F66.avi,16,2563,2111,452,21.411653244907626,morphological_dilation,3,2
0X2F60720EDEDB2B84.avi,51,1290,954,336,35.22012578616352,morphological_dilation,3,2
0X2F60720EDEDB2B84.avi,72,855,565,290,51.32743362831859,morphological_dilation,3,2
0X2F65820B1076710D.avi,46,2603,2123,480,22.609514837494114,morphological_dilation,3,2
0X2F65820B1076710D.avi,74,2106,1670,436,26.107784431137727,morphological_dilation,3,2
0X2F694951F67DF1B1.avi,37,1454,1114,340,30.520646319569124,morphological_dilation,3,2
0X2F694951F67DF1B1.avi,51,903,635,268,42.204724409448815,morphological_dilation,3,2
0X2F6973744CFA87D7.avi,40,3005,2529,476,18.8216686437327,morphological_dilation,3,2
0X2F6973744CFA87D7.avi,62,2706,2250,456,20.266666666666666,morphological_dilation,3,2
0X2F6DD3F418E35400.avi,31,1439,1083,356,32.87165281625116,morphological_dilation,3,2
0X2F6DD3F418E35400.avi,44,977,657,320,48.7062404870624,morphological_dilation,3,2
0X2F71399035F475FB.avi,105,1048,740,308,41.62162162162162,morphological_dilation,3,2
0X2F71399035F475FB.avi,122,697,441,256,58.049886621315196,morphological_dilation,3,2
0X2F73A1716262CBE0.avi,103,1896,1516,380,25.065963060686013,morphological_dilation,3,2
0X2F73A1716262CBE0.avi,120,1214,890,324,36.40449438202247,morphological_dilation,3,2
0X2F763FE2C438D16.avi,59,1934,1534,400,26.07561929595828,morphological_dilation,3,2
0X2F763FE2C438D16.avi,81,1296,976,320,32.78688524590164,morphological_dilation,3,2
0X2F778DF5E4DA96AD.avi,57,1493,1153,340,29.488291413703383,morphological_dilation,3,2
0X2F778DF5E4DA96AD.avi,71,915,634,281,44.321766561514195,morphological_dilation,3,2
0X2F7B172A664C6989.avi,57,754,491,263,53.56415478615071,morphological_dilation,3,2
0X2F7B172A664C6989.avi,79,1134,834,300,35.97122302158273,morphological_dilation,3,2
0X2F7E24BFBA3AA884.avi,41,1894,1482,412,27.800269905533064,morphological_dilation,3,2
0X2F7E24BFBA3AA884.avi,58,1115,811,304,37.4845869297164,morphological_dilation,3,2
0X2F7EF90430E9370C.avi,31,1547,1191,356,29.890848026868177,morphological_dilation,3,2
0X2F7EF90430E9370C.avi,40,913,649,264,40.67796610169492,morphological_dilation,3,2
0X2F80BA0880335F5B.avi,86,2629,2129,500,23.485204321277596,morphological_dilation,3,2
0X2F80BA0880335F5B.avi,105,1368,955,413,43.24607329842932,morphological_dilation,3,2
0X2F8172CBAC91EBCE.avi,147,1603,1235,368,29.797570850202433,morphological_dilation,3,2
0X2F8172CBAC91EBCE.avi,158,953,661,292,44.175491679273826,morphological_dilation,3,2
0X2F82938DF2A52427.avi,1,1742,1343,399,29.709605361131796,morphological_dilation,3,2
0X2F82938DF2A52427.avi,20,1136,794,342,43.07304785894207,morphological_dilation,3,2
0X2F839D43FB3ABB20.avi,55,1760,1372,388,28.279883381924197,morphological_dilation,3,2
0X2F839D43FB3ABB20.avi,69,1023,723,300,41.49377593360996,morphological_dilation,3,2
0X2F86CEC86F015C5D.avi,47,1572,1208,364,30.132450331125828,morphological_dilation,3,2
0X2F86CEC86F015C5D.avi,64,1080,768,312,40.625,morphological_dilation,3,2
0X2F874518FF81C895.avi,42,1461,1107,354,31.978319783197833,morphological_dilation,3,2
0X2F874518FF81C895.avi,55,895,604,291,48.17880794701987,morphological_dilation,3,2
0X2F8B4FE7F10C9FA1.avi,65,1797,1401,396,28.26552462526767,morphological_dilation,3,2
0X2F8B4FE7F10C9FA1.avi,83,1125,805,320,39.75155279503105,morphological_dilation,3,2
0X2F9151F662C9CD76.avi,82,1098,794,304,38.287153652392945,morphological_dilation,3,2
0X2F9151F662C9CD76.avi,95,666,426,240,56.33802816901409,morphological_dilation,3,2
0X2F92E6A93BE81557.avi,39,2110,1694,416,24.557260920897285,morphological_dilation,3,2
0X2F92E6A93BE81557.avi,49,1297,953,344,36.09653725078699,morphological_dilation,3,2
0X2F99E4F6D932876F.avi,47,1169,825,344,41.6969696969697,morphological_dilation,3,2
0X2F99E4F6D932876F.avi,60,795,479,316,65.97077244258872,morphological_dilation,3,2
0X2F9E2329B851C361.avi,30,1449,1085,364,33.5483870967742,morphological_dilation,3,2
0X2F9E2329B851C361.avi,44,958,646,312,48.297213622291025,morphological_dilation,3,2
0X2F9F41180785BAB1.avi,45,3244,2724,520,19.08957415565345,morphological_dilation,3,2
0X2F9F41180785BAB1.avi,63,2838,2350,488,20.76595744680851,morphological_dilation,3,2
0X2FA10595E74036E6.avi,78,2010,1570,440,28.02547770700637,morphological_dilation,3,2
0X2FA10595E74036E6.avi,96,1153,805,348,43.22981366459627,morphological_dilation,3,2
0X2FA3584A1A60A7BE.avi,110,1467,1103,364,33.00090661831369,morphological_dilation,3,2
0X2FA3584A1A60A7BE.avi,126,995,675,320,47.40740740740741,morphological_dilation,3,2
0X2FA3FF89B166D768.avi,30,1892,1504,388,25.79787234042553,morphological_dilation,3,2
0X2FA3FF89B166D768.avi,44,1709,1333,376,28.207051762940733,morphological_dilation,3,2
0X2FA600708C8C76CA.avi,97,1646,1282,364,28.39313572542902,morphological_dilation,3,2
0X2FA600708C8C76CA.avi,110,1133,797,336,42.15809284818068,morphological_dilation,3,2
0X2FA6F6D940DD7CEC.avi,70,1892,1516,376,24.80211081794195,morphological_dilation,3,2
0X2FA6F6D940DD7CEC.avi,87,1182,859,323,37.60186263096624,morphological_dilation,3,2
0X2FA86741F726D47C.avi,39,2669,2201,468,21.263062244434348,morphological_dilation,3,2
0X2FA86741F726D47C.avi,59,1663,1279,384,30.023455824863177,morphological_dilation,3,2
0X2FA98A8EA1D32AE4.avi,40,925,641,284,44.30577223088923,morphological_dilation,3,2
0X2FA98A8EA1D32AE4.avi,48,588,364,224,61.53846153846154,morphological_dilation,3,2
0X2FAA908FAA937E75.avi,100,1585,1209,376,31.100082712985937,morphological_dilation,3,2
0X2FAA908FAA937E75.avi,117,990,678,312,46.017699115044245,morphological_dilation,3,2
0X2FAAC59C895C5441.avi,112,1296,949,347,36.56480505795574,morphological_dilation,3,2
0X2FAAC59C895C5441.avi,127,863,577,286,49.566724436741765,morphological_dilation,3,2
0X2FAB42A57418EC49.avi,110,1782,1382,400,28.94356005788712,morphological_dilation,3,2
0X2FAB42A57418EC49.avi,132,1169,821,348,42.38733252131547,morphological_dilation,3,2
0X2FAD587DA2A84649.avi,51,2395,1919,476,24.804585721730067,morphological_dilation,3,2
0X2FAD587DA2A84649.avi,71,1347,979,368,37.58937691521961,morphological_dilation,3,2
0X2FADE9E508CBEBBB.avi,140,2311,1871,440,23.516835916622128,morphological_dilation,3,2
0X2FADE9E508CBEBBB.avi,164,1406,1046,360,34.41682600382409,morphological_dilation,3,2
0X2FAFDA5737784951.avi,82,1664,1280,384,30.0,morphological_dilation,3,2
0X2FAFDA5737784951.avi,100,1358,1018,340,33.39882121807465,morphological_dilation,3,2
0X2FB094DB8A50D559.avi,97,1772,1384,388,28.034682080924856,morphological_dilation,3,2
0X2FB094DB8A50D559.avi,112,1184,872,312,35.77981651376147,morphological_dilation,3,2
0X2FB0B822B78A2E22.avi,57,1754,1374,380,27.65647743813683,morphological_dilation,3,2
0X2FB0B822B78A2E22.avi,71,1120,804,316,39.30348258706468,morphological_dilation,3,2
0X2FB2FF3DCA860716.avi,73,1262,930,332,35.6989247311828,morphological_dilation,3,2
0X2FB2FF3DCA860716.avi,86,815,531,284,53.483992467043315,morphological_dilation,3,2
0X2FB599E81FD49B1F.avi,39,2079,1679,400,23.823704586063133,morphological_dilation,3,2
0X2FB599E81FD49B1F.avi,59,1585,1233,352,28.548256285482566,morphological_dilation,3,2
0X2FB96B1F06BA9765.avi,92,1279,943,336,35.63096500530223,morphological_dilation,3,2
0X2FB96B1F06BA9765.avi,112,812,536,276,51.49253731343284,morphological_dilation,3,2
0X2FBC0AB4967074E9.avi,39,2231,1795,436,24.289693593314762,morphological_dilation,3,2
0X2FBC0AB4967074E9.avi,53,1392,1024,368,35.9375,morphological_dilation,3,2
0X2FCB95682388D5A3.avi,45,1352,1020,332,32.549019607843135,morphological_dilation,3,2
0X2FCB95682388D5A3.avi,61,843,567,276,48.67724867724868,morphological_dilation,3,2
0X2FCD60103356EECD.avi,48,1327,995,332,33.36683417085427,morphological_dilation,3,2
0X2FCD60103356EECD.avi,64,789,521,268,51.439539347408825,morphological_dilation,3,2
0X2FCD96B6D495DDCB.avi,38,1749,1373,376,27.385287691187184,morphological_dilation,3,2
0X2FCD96B6D495DDCB.avi,51,1490,1130,360,31.858407079646017,morphological_dilation,3,2
0X2FCF352447197479.avi,0,1835,1435,400,27.874564459930312,morphological_dilation,3,2
0X2FCF352447197479.avi,22,1217,873,344,39.404352806414664,morphological_dilation,3,2
0X2FCF4A3A64516275.avi,61,1447,1103,344,31.18766999093382,morphological_dilation,3,2
0X2FCF4A3A64516275.avi,79,794,526,268,50.950570342205324,morphological_dilation,3,2
0X2FCF6321B94208F9.avi,77,2453,2017,436,21.616261774913237,morphological_dilation,3,2
0X2FCF6321B94208F9.avi,95,1447,1123,324,28.851291184327692,morphological_dilation,3,2
0X2FCF84F7FD763713.avi,2,1871,1471,400,27.192386131883072,morphological_dilation,3,2
0X2FCF84F7FD763713.avi,16,906,606,300,49.504950495049506,morphological_dilation,3,2
0X2FD13114B6B7BA39.avi,53,1882,1494,388,25.970548862115127,morphological_dilation,3,2
0X2FD13114B6B7BA39.avi,72,1017,737,280,37.99185888738128,morphological_dilation,3,2
0X2FD727869D3D7132.avi,50,1667,1303,364,27.93553338449731,morphological_dilation,3,2
0X2FD727869D3D7132.avi,69,1055,747,308,41.231593038821956,morphological_dilation,3,2
0X2FDDCD0EE2DAB2E0.avi,124,1996,1580,416,26.329113924050635,morphological_dilation,3,2
0X2FDDCD0EE2DAB2E0.avi,144,1165,837,328,39.18757467144564,morphological_dilation,3,2
0X2FDECA4EA592C887.avi,60,3578,3034,544,17.93012524719842,morphological_dilation,3,2
0X2FDECA4EA592C887.avi,79,2187,1759,428,24.332006822057988,morphological_dilation,3,2
0X2FDF24DB8EF1CE4D.avi,100,1337,997,340,34.10230692076229,morphological_dilation,3,2
0X2FDF24DB8EF1CE4D.avi,112,736,460,276,60.0,morphological_dilation,3,2
0X2FE7BCA20D009E39.avi,61,1895,1463,432,29.52836637047163,morphological_dilation,3,2
0X2FE7BCA20D009E39.avi,77,1130,771,359,46.56290531776913,morphological_dilation,3,2
0X2FE828B7456FE840.avi,53,2352,1912,440,23.01255230125523,morphological_dilation,3,2
0X2FE828B7456FE840.avi,83,1861,1453,408,28.07983482450103,morphological_dilation,3,2
0X2FE99C7939456141.avi,51,1574,1230,344,27.967479674796746,morphological_dilation,3,2
0X2FE99C7939456141.avi,68,1280,936,344,36.75213675213676,morphological_dilation,3,2
0X2FEC1EA391B6A3BB.avi,109,1734,1354,380,28.064992614475624,morphological_dilation,3,2
0X2FEC1EA391B6A3BB.avi,125,1259,935,324,34.652406417112296,morphological_dilation,3,2
0X2FF0C9AF0BDAE066.avi,51,2285,1865,420,22.5201072386059,morphological_dilation,3,2
0X2FF0C9AF0BDAE066.avi,69,1340,1008,332,32.93650793650794,morphological_dilation,3,2
0X2FF33D4035E666DB.avi,50,1511,1152,359,31.163194444444443,morphological_dilation,3,2
0X2FF33D4035E666DB.avi,68,878,597,281,47.06867671691792,morphological_dilation,3,2
0X2FFB2D1F3A52F4AF.avi,41,1755,1355,400,29.520295202952028,morphological_dilation,3,2
0X2FFB2D1F3A52F4AF.avi,49,1142,818,324,39.60880195599022,morphological_dilation,3,2
0X2FFB8AB1CBB7C3D.avi,47,2345,1913,432,22.582331416623106,morphological_dilation,3,2
0X2FFB8AB1CBB7C3D.avi,65,1681,1317,364,27.638572513287773,morphological_dilation,3,2
0X2FFF24580B67B985.avi,76,1876,1492,384,25.737265415549597,morphological_dilation,3,2
0X2FFF24580B67B985.avi,92,1635,1283,352,27.435697583788,morphological_dilation,3,2
0X2FFF4396044B9599.avi,134,1985,1585,400,25.236593059936908,morphological_dilation,3,2
0X2FFF4396044B9599.avi,148,1372,1020,352,34.509803921568626,morphological_dilation,3,2
0X2FFFF8FC560376F0.avi,47,2336,1889,447,23.66331392271043,morphological_dilation,3,2
0X2FFFF8FC560376F0.avi,64,1567,1191,376,31.57010915197313,morphological_dilation,3,2
0X30031EC6E173237B.avi,154,1906,1498,408,27.236315086782376,morphological_dilation,3,2
0X30031EC6E173237B.avi,171,1100,796,304,38.19095477386934,morphological_dilation,3,2
0X30095431B14EB3DF.avi,19,1852,1432,420,29.329608938547487,morphological_dilation,3,2
0X30095431B14EB3DF.avi,46,2866,2350,516,21.95744680851064,morphological_dilation,3,2
0X300AA381A5509008.avi,66,1639,1275,364,28.549019607843135,morphological_dilation,3,2
0X300AA381A5509008.avi,86,1001,709,292,41.18476727785614,morphological_dilation,3,2
0X300D3D8177BE07A6.avi,106,2042,1634,408,24.96940024479804,morphological_dilation,3,2
0X300D3D8177BE07A6.avi,122,1271,951,320,33.64879074658255,morphological_dilation,3,2
0X300EB440D348F45.avi,83,1460,1093,367,33.57731015553522,morphological_dilation,3,2
0X300EB440D348F45.avi,95,878,570,308,54.03508771929825,morphological_dilation,3,2
0X3011B1FF13AA6C42.avi,80,3239,2719,520,19.12467819051122,morphological_dilation,3,2
0X3011B1FF13AA6C42.avi,114,1952,1540,412,26.75324675324675,morphological_dilation,3,2
0X30162222B586A328.avi,100,2691,2208,483,21.875,morphological_dilation,3,2
0X30162222B586A328.avi,116,1462,1063,399,37.53527751646284,morphological_dilation,3,2
0X3016B7ECCCEAE02C.avi,98,2007,1583,424,26.784586228679725,morphological_dilation,3,2
0X3016B7ECCCEAE02C.avi,118,1363,1011,352,34.817012858555884,morphological_dilation,3,2
0X30191C05574D0257.avi,123,1984,1576,408,25.888324873096447,morphological_dilation,3,2
0X30191C05574D0257.avi,140,1170,854,316,37.00234192037471,morphological_dilation,3,2
0X3023ECB2216511F0.avi,50,1838,1438,400,27.816411682892905,morphological_dilation,3,2
0X3023ECB2216511F0.avi,66,1152,848,304,35.84905660377358,morphological_dilation,3,2
0X302567FE70174845.avi,4,1832,1428,404,28.291316526610643,morphological_dilation,3,2
0X302567FE70174845.avi,18,1069,745,324,43.48993288590604,morphological_dilation,3,2
0X30274DCF9BBA567F.avi,73,1691,1327,364,27.43029389600603,morphological_dilation,3,2
0X30274DCF9BBA567F.avi,92,997,692,305,44.07514450867052,morphological_dilation,3,2
0X3027FD45B2C26E6B.avi,100,1203,899,304,33.815350389321466,morphological_dilation,3,2
0X3027FD45B2C26E6B.avi,119,792,524,268,51.14503816793893,morphological_dilation,3,2
0X302819E258912025.avi,53,1470,1118,352,31.48479427549195,morphological_dilation,3,2
0X302819E258912025.avi,75,904,628,276,43.94904458598726,morphological_dilation,3,2
0X302995669B66A122.avi,102,1951,1571,380,24.188415022278804,morphological_dilation,3,2
0X302995669B66A122.avi,120,1586,1238,348,28.109854604200322,morphological_dilation,3,2
0X3029C3C640B5EFD9.avi,93,3380,2868,512,17.85216178521618,morphological_dilation,3,2
0X3029C3C640B5EFD9.avi,109,1904,1500,404,26.93333333333333,morphological_dilation,3,2
0X302B5A67D2FD528F.avi,30,2578,2114,464,21.948912015137182,morphological_dilation,3,2
0X302B5A67D2FD528F.avi,42,1471,1103,368,33.36355394378966,morphological_dilation,3,2
0X302DC89F8DBB4E72.avi,38,1566,1202,364,30.282861896838604,morphological_dilation,3,2
0X302DC89F8DBB4E72.avi,52,1021,721,300,41.60887656033287,morphological_dilation,3,2
0X3031FD2072E91F1F.avi,57,1792,1408,384,27.27272727272727,morphological_dilation,3,2
0X3031FD2072E91F1F.avi,73,1098,802,296,36.907730673316706,morphological_dilation,3,2
0X303266C9753A9221.avi,88,2227,1807,420,23.242944106253457,morphological_dilation,3,2
0X303266C9753A9221.avi,104,1431,1060,371,35.0,morphological_dilation,3,2
0X3032DD7D5F77DC37.avi,159,1963,1547,416,26.89075630252101,morphological_dilation,3,2
0X3032DD7D5F77DC37.avi,176,1017,646,371,57.43034055727554,morphological_dilation,3,2
0X303781B228664E4.avi,47,1309,995,314,31.55778894472362,morphological_dilation,3,2
0X303781B228664E4.avi,68,1142,846,296,34.988179669030735,morphological_dilation,3,2
0X3038AF85DAEA33AF.avi,114,1428,1092,336,30.76923076923077,morphological_dilation,3,2
0X3038AF85DAEA33AF.avi,135,900,624,276,44.230769230769226,morphological_dilation,3,2
0X303B6560E7903370.avi,49,1971,1579,392,24.825839138695375,morphological_dilation,3,2
0X303B6560E7903370.avi,68,1221,905,316,34.91712707182321,morphological_dilation,3,2
0X303FBC993DCFFA5A.avi,74,856,580,276,47.58620689655172,morphological_dilation,3,2
0X303FBC993DCFFA5A.avi,90,565,341,224,65.6891495601173,morphological_dilation,3,2
0X304072964F9FED96.avi,104,2991,2475,516,20.84848484848485,morphological_dilation,3,2
0X304072964F9FED96.avi,122,2207,1763,444,25.184344866704482,morphological_dilation,3,2
0X30478F96BBD1A142.avi,80,3210,2678,532,19.865571321882,morphological_dilation,3,2
0X30478F96BBD1A142.avi,96,2903,2377,526,22.12873369793858,morphological_dilation,3,2
0X3047DAECF3BF4F35.avi,63,2496,2034,462,22.71386430678466,morphological_dilation,3,2
0X3047DAECF3BF4F35.avi,80,1457,1090,367,33.6697247706422,morphological_dilation,3,2
0X30498000742D4D19.avi,42,2457,2010,447,22.238805970149254,morphological_dilation,3,2
0X30498000742D4D19.avi,57,1531,1167,364,31.191088260497,morphological_dilation,3,2
0X304BECC72FD64162.avi,50,1271,943,328,34.78260869565217,morphological_dilation,3,2
0X304BECC72FD64162.avi,70,798,538,260,48.3271375464684,morphological_dilation,3,2
0X304F73AE14FCAAEE.avi,49,1402,1038,364,35.067437379576106,morphological_dilation,3,2
0X304F73AE14FCAAEE.avi,65,861,549,312,56.830601092896174,morphological_dilation,3,2
0X304FEB38430F6379.avi,46,1411,1079,332,30.76923076923077,morphological_dilation,3,2
0X304FEB38430F6379.avi,63,883,612,271,44.28104575163398,morphological_dilation,3,2
0X305357FDBA449A7E.avi,42,3389,2865,524,18.289703315881326,morphological_dilation,3,2
0X305357FDBA449A7E.avi,58,2945,2453,492,20.05707297187118,morphological_dilation,3,2
0X3057B68614333EF5.avi,53,1835,1423,412,28.952916373858045,morphological_dilation,3,2
0X3057B68614333EF5.avi,69,1312,944,368,38.983050847457626,morphological_dilation,3,2
0X305A08AAFCD0F1B.avi,74,1869,1462,407,27.838577291381668,morphological_dilation,3,2
0X305A08AAFCD0F1B.avi,85,1478,1119,359,32.0822162645219,morphological_dilation,3,2
0X305C73A65134962D.avi,73,1794,1402,392,27.960057061340944,morphological_dilation,3,2
0X305C73A65134962D.avi,89,1561,1197,364,30.409356725146196,morphological_dilation,3,2
0X305DA6109DF57F3E.avi,46,3050,2570,480,18.67704280155642,morphological_dilation,3,2
0X305DA6109DF57F3E.avi,66,1970,1582,388,24.52591656131479,morphological_dilation,3,2
0X306001BA85006E21.avi,4,1075,791,284,35.9039190897598,morphological_dilation,3,2
0X306001BA85006E21.avi,16,741,493,248,50.30425963488844,morphological_dilation,3,2
0X306089480560F2CB.avi,71,2163,1743,420,24.096385542168676,morphological_dilation,3,2
0X306089480560F2CB.avi,92,1576,1216,360,29.605263157894733,morphological_dilation,3,2
0X30623CFE5E3AD181.avi,86,2892,2396,496,20.70116861435726,morphological_dilation,3,2
0X30623CFE5E3AD181.avi,101,1863,1443,420,29.10602910602911,morphological_dilation,3,2
0X3062BAD834AAB2A3.avi,81,1068,780,288,36.92307692307693,morphological_dilation,3,2
0X3062BAD834AAB2A3.avi,94,742,490,252,51.42857142857142,morphological_dilation,3,2
0X3064D2C12E6718AD.avi,7,1490,1138,352,30.931458699472756,morphological_dilation,3,2
0X3064D2C12E6718AD.avi,16,1162,858,304,35.43123543123543,morphological_dilation,3,2
0X3064DF4DEEA10F77.avi,108,1810,1406,404,28.733997155049785,morphological_dilation,3,2
0X3064DF4DEEA10F77.avi,133,1299,910,389,42.747252747252745,morphological_dilation,3,2
0X306F42A51FFEB3CD.avi,102,2036,1616,420,25.99009900990099,morphological_dilation,3,2
0X306F42A51FFEB3CD.avi,111,1384,1020,364,35.68627450980392,morphological_dilation,3,2
0X3070B9FC19EEA1A8.avi,31,1268,956,312,32.63598326359833,morphological_dilation,3,2
0X3070B9FC19EEA1A8.avi,45,1085,789,296,37.51584283903676,morphological_dilation,3,2
0X3073CB032B344F83.avi,0,2531,2072,459,22.152509652509654,morphological_dilation,3,2
0X3073CB032B344F83.avi,17,1832,1444,388,26.869806094182824,morphological_dilation,3,2
0X3074A91A06F3DF4F.avi,40,1759,1367,392,28.675932699341622,morphological_dilation,3,2
0X3074A91A06F3DF4F.avi,56,1056,756,300,39.682539682539684,morphological_dilation,3,2
0X3077040EC90D916D.avi,56,1728,1340,388,28.955223880597014,morphological_dilation,3,2
0X3077040EC90D916D.avi,76,1222,887,335,37.767756482525364,morphological_dilation,3,2
0X30789B87116B381C.avi,108,2187,1767,420,23.769100169779286,morphological_dilation,3,2
0X30789B87116B381C.avi,122,1202,886,316,35.66591422121896,morphological_dilation,3,2
0X307C147F99088E0E.avi,100,1419,1079,340,31.510658016682115,morphological_dilation,3,2
0X307C147F99088E0E.avi,115,868,604,264,43.70860927152318,morphological_dilation,3,2
0X3086B124F7E9C217.avi,43,2028,1632,396,24.264705882352942,morphological_dilation,3,2
0X3086B124F7E9C217.avi,61,1602,1246,356,28.57142857142857,morphological_dilation,3,2
0X30875E172CAE1B6E.avi,37,1246,918,328,35.72984749455338,morphological_dilation,3,2
0X30875E172CAE1B6E.avi,51,685,410,275,67.07317073170732,morphological_dilation,3,2
0X308F6D2FF3555209.avi,197,1347,1019,328,32.18842001962708,morphological_dilation,3,2
0X308F6D2FF3555209.avi,210,792,532,260,48.87218045112782,morphological_dilation,3,2
0X3091FF4E0AE5D57C.avi,96,1624,1248,376,30.128205128205128,morphological_dilation,3,2
0X3091FF4E0AE5D57C.avi,113,1177,845,332,39.289940828402365,morphological_dilation,3,2
0X309525C0BF6240C0.avi,49,2155,1715,440,25.65597667638484,morphological_dilation,3,2
0X309525C0BF6240C0.avi,64,1224,876,348,39.726027397260275,morphological_dilation,3,2
0X3096BB5F01A3E901.avi,227,2502,2034,468,23.008849557522122,morphological_dilation,3,2
0X3096BB5F01A3E901.avi,251,1568,1180,388,32.88135593220339,morphological_dilation,3,2
0X309AD0F57E1C81B2.avi,0,2886,2406,480,19.950124688279303,morphological_dilation,3,2
0X309AD0F57E1C81B2.avi,24,1817,1417,400,28.228652081863093,morphological_dilation,3,2
0X309C2F4CC7C29F55.avi,40,1385,1057,328,31.031220435193944,morphological_dilation,3,2
0X309C2F4CC7C29F55.avi,50,846,577,269,46.62045060658579,morphological_dilation,3,2
0X309E151E82DD9D94.avi,89,1658,1294,364,28.129829984544045,morphological_dilation,3,2
0X309E151E82DD9D94.avi,105,1085,785,300,38.21656050955414,morphological_dilation,3,2
0X30A216CE9B22EF5.avi,102,2168,1676,492,29.355608591885442,morphological_dilation,3,2
0X30A216CE9B22EF5.avi,130,1212,758,454,59.894459102902374,morphological_dilation,3,2
0X30A55286F1F00DD9.avi,120,1726,1358,368,27.098674521354933,morphological_dilation,3,2
0X30A55286F1F00DD9.avi,136,1030,730,300,41.0958904109589,morphological_dilation,3,2
0X30A9476068D69B16.avi,47,1686,1334,352,26.38680659670165,morphological_dilation,3,2
0X30A9476068D69B16.avi,58,1123,827,296,35.79201934703748,morphological_dilation,3,2
0X30ADD91111F35C41.avi,40,3438,2918,520,17.82042494859493,morphological_dilation,3,2
0X30ADD91111F35C41.avi,57,2386,1938,448,23.11661506707946,morphological_dilation,3,2
0X30AFF793AC29BD2B.avi,81,1363,1023,340,33.235581622678396,morphological_dilation,3,2
0X30AFF793AC29BD2B.avi,94,1021,729,292,40.054869684499316,morphological_dilation,3,2
0X30B39D3B28B492C0.avi,55,1609,1269,340,26.792750197005518,morphological_dilation,3,2
0X30B39D3B28B492C0.avi,74,973,705,268,38.01418439716312,morphological_dilation,3,2
0X30B3AAE38D19F95A.avi,1,1517,1181,336,28.450465707027945,morphological_dilation,3,2
0X30B3AAE38D19F95A.avi,12,986,700,286,40.85714285714286,morphological_dilation,3,2
0X30B768205DDFE981.avi,151,1224,904,320,35.39823008849557,morphological_dilation,3,2
0X30B768205DDFE981.avi,163,785,520,265,50.96153846153846,morphological_dilation,3,2
0X30B78D6996933B74.avi,71,2046,1618,428,26.45241038318912,morphological_dilation,3,2
0X30B78D6996933B74.avi,86,1141,789,352,44.61343472750317,morphological_dilation,3,2
0X30BABD45D8570AD3.avi,41,896,620,276,44.516129032258064,morphological_dilation,3,2
0X30BABD45D8570AD3.avi,57,726,478,248,51.88284518828452,morphological_dilation,3,2
0X30BFDB06375733D1.avi,3,1158,844,314,37.203791469194314,morphological_dilation,3,2
0X30BFDB06375733D1.avi,18,928,639,289,45.22691705790297,morphological_dilation,3,2
0X30BFEEB4102D358F.avi,58,1399,1063,336,31.60865475070555,morphological_dilation,3,2
0X30BFEEB4102D358F.avi,75,866,602,264,43.85382059800664,morphological_dilation,3,2
0X30C23954381AEB00.avi,93,1520,1162,358,30.808950086058516,morphological_dilation,3,2
0X30C23954381AEB00.avi,108,1258,933,325,34.83386923901393,morphological_dilation,3,2
0X30C6E212959E3A90.avi,50,2628,2161,467,21.61036557149468,morphological_dilation,3,2
0X30C6E212959E3A90.avi,70,1783,1379,404,29.296591733139955,morphological_dilation,3,2
0X30CAEB4DADB146B.avi,90,1826,1427,399,27.960756832515766,morphological_dilation,3,2
0X30CAEB4DADB146B.avi,107,1228,892,336,37.66816143497758,morphological_dilation,3,2
0X30CB7DA75CA8487B.avi,96,3372,2816,556,19.744318181818183,morphological_dilation,3,2
0X30CB7DA75CA8487B.avi,109,2067,1583,484,30.574857864813644,morphological_dilation,3,2
0X30D3622EBC82AC5F.avi,105,1968,1557,411,26.39691714836224,morphological_dilation,3,2
0X30D3622EBC82AC5F.avi,120,1066,762,304,39.89501312335958,morphological_dilation,3,2
0X30D3A903D183E50E.avi,48,1782,1374,408,29.694323144104807,morphological_dilation,3,2
0X30D3A903D183E50E.avi,64,1107,783,324,41.37931034482759,morphological_dilation,3,2
0X30D3D4670D1960CB.avi,48,1610,1234,376,30.47001620745543,morphological_dilation,3,2
0X30D3D4670D1960CB.avi,62,964,624,340,54.48717948717948,morphological_dilation,3,2
0X30D49694BD3BE8E1.avi,0,3223,2719,504,18.536226553880102,morphological_dilation,3,2
0X30D49694BD3BE8E1.avi,19,2755,2291,464,20.253164556962027,morphological_dilation,3,2
0X30DC735C9465A19B.avi,41,1225,905,320,35.35911602209944,morphological_dilation,3,2
0X30DC735C9465A19B.avi,54,731,491,240,48.87983706720978,morphological_dilation,3,2
0X30DD2E0EFB94A0C3.avi,29,1333,1005,328,32.63681592039801,morphological_dilation,3,2
0X30DD2E0EFB94A0C3.avi,44,768,495,273,55.15151515151515,morphological_dilation,3,2
0X30DD64890676EF7D.avi,66,1297,960,337,35.104166666666664,morphological_dilation,3,2
0X30DD64890676EF7D.avi,85,792,481,311,64.65696465696466,morphological_dilation,3,2
0X30DF42C999969D67.avi,41,1197,893,304,34.04255319148936,morphological_dilation,3,2
0X30DF42C999969D67.avi,50,1039,763,276,36.17300131061599,morphological_dilation,3,2
0X30E04350F8CE348B.avi,0,1308,992,316,31.85483870967742,morphological_dilation,3,2
0X30E04350F8CE348B.avi,18,753,487,266,54.62012320328542,morphological_dilation,3,2
0X30E33024CE9DF8E9.avi,36,1838,1438,400,27.816411682892905,morphological_dilation,3,2
0X30E33024CE9DF8E9.avi,51,1111,803,308,38.35616438356164,morphological_dilation,3,2
0X30F0CADB380AFD41.avi,57,1949,1521,428,28.139381985535834,morphological_dilation,3,2
0X30F0CADB380AFD41.avi,74,1154,813,341,41.94341943419434,morphological_dilation,3,2
0X30F59532488B7385.avi,62,2919,2419,500,20.669698222405952,morphological_dilation,3,2
0X30F59532488B7385.avi,77,1550,1161,389,33.50559862187769,morphological_dilation,3,2
0X30FC08C8A542EB2F.avi,50,1170,870,300,34.48275862068966,morphological_dilation,3,2
0X30FC08C8A542EB2F.avi,73,823,579,244,42.141623488773746,morphological_dilation,3,2
0X30FEEEFC74A8F437.avi,92,1705,1333,372,27.906976744186046,morphological_dilation,3,2
0X30FEEEFC74A8F437.avi,116,1005,701,304,43.36661911554921,morphological_dilation,3,2
0X310589D4CDC13146.avi,80,1449,1113,336,30.18867924528302,morphological_dilation,3,2
0X310589D4CDC13146.avi,93,1091,787,304,38.6277001270648,morphological_dilation,3,2
0X31066B9B6C089130.avi,1,1677,1313,364,27.722772277227726,morphological_dilation,3,2
0X31066B9B6C089130.avi,24,1063,775,288,37.16129032258065,morphological_dilation,3,2
0X31091C108B79BD8D.avi,52,1413,1045,368,35.21531100478469,morphological_dilation,3,2
0X31091C108B79BD8D.avi,75,928,632,296,46.835443037974684,morphological_dilation,3,2
0X3112D11F241CFEC2.avi,50,1458,1098,360,32.78688524590164,morphological_dilation,3,2
0X3112D11F241CFEC2.avi,68,1022,710,312,43.94366197183099,morphological_dilation,3,2
0X312454CBA4A7D4F2.avi,42,1892,1476,416,28.184281842818425,morphological_dilation,3,2
0X312454CBA4A7D4F2.avi,65,1383,1023,360,35.19061583577713,morphological_dilation,3,2
0X3125B96D71B7821B.avi,68,1524,1172,352,30.034129692832767,morphological_dilation,3,2
0X3125B96D71B7821B.avi,78,881,606,275,45.37953795379538,morphological_dilation,3,2
0X312D452CAA7E64C1.avi,0,1605,1245,360,28.915662650602407,morphological_dilation,3,2
0X312D452CAA7E64C1.avi,14,1118,800,318,39.75,morphological_dilation,3,2
0X312EF19F60FD492.avi,0,1725,1329,396,29.79683972911964,morphological_dilation,3,2
0X312EF19F60FD492.avi,18,1149,813,336,41.32841328413284,morphological_dilation,3,2
0X312EF87AE19B3E5.avi,48,1841,1465,376,25.665529010238906,morphological_dilation,3,2
0X312EF87AE19B3E5.avi,68,1252,932,320,34.33476394849785,morphological_dilation,3,2
0X3135870672917B2E.avi,46,2109,1686,423,25.088967971530252,morphological_dilation,3,2
0X3135870672917B2E.avi,61,1206,854,352,41.21779859484778,morphological_dilation,3,2
0X31393277CDB5A7CC.avi,48,2093,1681,412,24.509220701963116,morphological_dilation,3,2
0X31393277CDB5A7CC.avi,69,1279,943,336,35.63096500530223,morphological_dilation,3,2
0X313BCE11B5A12F4E.avi,105,1473,1123,350,31.16651825467498,morphological_dilation,3,2
0X313BCE11B5A12F4E.avi,122,1124,800,324,40.5,morphological_dilation,3,2
0X313D7019ACE708FD.avi,61,1642,1290,352,27.286821705426355,morphological_dilation,3,2
0X313D7019ACE708FD.avi,80,1033,749,284,37.917222963951936,morphological_dilation,3,2
0X313E1E99DB1C98DB.avi,147,1291,943,348,36.90349946977731,morphological_dilation,3,2
0X313E1E99DB1C98DB.avi,161,814,534,280,52.43445692883895,morphological_dilation,3,2
0X314192FBA6E19068.avi,18,1991,1579,412,26.092463584547183,morphological_dilation,3,2
0X314192FBA6E19068.avi,40,2580,2101,479,22.798667301285104,morphological_dilation,3,2
0X31454136B3094167.avi,73,1004,696,308,44.252873563218394,morphological_dilation,3,2
0X31454136B3094167.avi,89,580,364,216,59.34065934065934,morphological_dilation,3,2
0X314D25279BC64DCC.avi,50,2420,1964,456,23.217922606924642,morphological_dilation,3,2
0X314D25279BC64DCC.avi,68,1477,1113,364,32.70440251572327,morphological_dilation,3,2
0X3153B66CE568125A.avi,92,1381,1033,348,33.68828654404646,morphological_dilation,3,2
0X3153B66CE568125A.avi,107,942,642,300,46.728971962616825,morphological_dilation,3,2
0X3154AED0655FDFA.avi,112,1826,1426,400,28.050490883590463,morphological_dilation,3,2
0X3154AED0655FDFA.avi,128,1095,779,316,40.564826700898585,morphological_dilation,3,2
0X31561CB66585395A.avi,2,3269,2708,561,20.716395864106353,morphological_dilation,3,2
0X31561CB66585395A.avi,22,1912,1468,444,30.24523160762943,morphological_dilation,3,2
0X31564EE859AF143C.avi,67,1275,959,316,32.95099061522419,morphological_dilation,3,2
0X31564EE859AF143C.avi,79,916,644,272,42.2360248447205,morphological_dilation,3,2
0X3157875A82E09BD4.avi,102,2473,2009,464,23.09606769537083,morphological_dilation,3,2
0X3157875A82E09BD4.avi,123,2078,1627,451,27.719729563614017,morphological_dilation,3,2
0X3157CB3AA918DBE4.avi,171,1968,1560,408,26.153846153846157,morphological_dilation,3,2
0X3157CB3AA918DBE4.avi,191,1309,969,340,35.08771929824561,morphological_dilation,3,2
0X3157CB9999A6EAA7.avi,79,2318,1894,424,22.38648363252376,morphological_dilation,3,2
0X3157CB9999A6EAA7.avi,94,1723,1343,380,28.294862248696944,morphological_dilation,3,2
0X31609610BF62EABF.avi,62,1897,1505,392,26.046511627906977,morphological_dilation,3,2
0X31609610BF62EABF.avi,88,1201,889,312,35.09561304836895,morphological_dilation,3,2
0X31612E3EF6C6CE3C.avi,63,2296,1860,436,23.440860215053764,morphological_dilation,3,2
0X31612E3EF6C6CE3C.avi,81,1549,1177,372,31.60577740016992,morphological_dilation,3,2
0X316B2586E85BB7B4.avi,100,2698,2230,468,20.986547085201792,morphological_dilation,3,2
0X316B2586E85BB7B4.avi,117,2378,1938,440,22.703818369453042,morphological_dilation,3,2
0X316DE42557C8197.avi,90,2272,1836,436,23.74727668845316,morphological_dilation,3,2
0X316DE42557C8197.avi,107,1519,1163,356,30.61049011177988,morphological_dilation,3,2
0X31728075F994A2C9.avi,34,2854,2362,492,20.829805249788315,morphological_dilation,3,2
0X31728075F994A2C9.avi,50,1667,1259,408,32.40667196187451,morphological_dilation,3,2
0X31765EFF76DA69F2.avi,162,1511,1151,360,31.277150304083406,morphological_dilation,3,2
0X31765EFF76DA69F2.avi,184,940,656,284,43.292682926829265,morphological_dilation,3,2
0X317B80B024DEF142.avi,33,1465,1113,352,31.626235399820306,morphological_dilation,3,2
0X317B80B024DEF142.avi,50,1073,763,310,40.62909567496724,morphological_dilation,3,2
0X317E4342CFF4F82C.avi,67,1450,1106,344,31.103074141048825,morphological_dilation,3,2
0X317E4342CFF4F82C.avi,85,971,679,292,43.004418262150224,morphological_dilation,3,2
0X317E86FC42ABB6C4.avi,52,2604,2124,480,22.598870056497177,morphological_dilation,3,2
0X317E86FC42ABB6C4.avi,68,1642,1262,380,30.11093502377179,morphological_dilation,3,2
0X317F9211C2AFCAA8.avi,62,2018,1606,412,25.653798256537986,morphological_dilation,3,2
0X317F9211C2AFCAA8.avi,84,1244,896,348,38.839285714285715,morphological_dilation,3,2
0X3180E8CFE4B3CE1B.avi,57,1801,1393,408,29.289303661162958,morphological_dilation,3,2
0X3180E8CFE4B3CE1B.avi,75,1021,705,316,44.82269503546099,morphological_dilation,3,2
0X3182DE90EDD4C06A.avi,35,2042,1597,445,27.86474639949906,morphological_dilation,3,2
0X3182DE90EDD4C06A.avi,49,1279,907,372,41.01433296582139,morphological_dilation,3,2
0X3184922BBFE6CAA7.avi,47,2051,1667,384,23.035392921415717,morphological_dilation,3,2
0X3184922BBFE6CAA7.avi,69,1323,1001,322,32.16783216783217,morphological_dilation,3,2
0X318678A29B2FB80F.avi,95,2102,1694,408,24.08500590318772,morphological_dilation,3,2
0X318678A29B2FB80F.avi,118,1171,871,300,34.443168771526985,morphological_dilation,3,2
0X3186FFAF6AEAC0E0.avi,74,1954,1514,440,29.06208718626156,morphological_dilation,3,2
0X3186FFAF6AEAC0E0.avi,87,1240,888,352,39.63963963963964,morphological_dilation,3,2
0X31875024C412A9E.avi,37,2285,1837,448,24.387588459444746,morphological_dilation,3,2
0X31875024C412A9E.avi,47,1199,855,344,40.23391812865497,morphological_dilation,3,2
0X318B72F1FF654675.avi,37,2757,2261,496,21.93719593100398,morphological_dilation,3,2
0X318B72F1FF654675.avi,53,1805,1361,444,32.62307127112417,morphological_dilation,3,2
0X318BF49FD37428B3.avi,127,1495,1143,352,30.796150481189848,morphological_dilation,3,2
0X318BF49FD37428B3.avi,147,1057,753,304,40.37184594953519,morphological_dilation,3,2
0X31919E16542CBF1D.avi,42,1875,1487,388,26.09280430396772,morphological_dilation,3,2
0X31919E16542CBF1D.avi,55,1129,805,324,40.24844720496895,morphological_dilation,3,2
0X3191F7851F57ECC5.avi,44,2489,2041,448,21.950024497795198,morphological_dilation,3,2
0X3191F7851F57ECC5.avi,57,1524,1140,384,33.68421052631579,morphological_dilation,3,2
0X3193A277D6B5C956.avi,49,2532,2080,452,21.73076923076923,morphological_dilation,3,2
0X3193A277D6B5C956.avi,68,1803,1391,412,29.618979151689434,morphological_dilation,3,2
0X3196BBF36C80C73B.avi,45,2761,2273,488,21.469423669159703,morphological_dilation,3,2
0X3196BBF36C80C73B.avi,64,1579,1211,368,30.388109000825764,morphological_dilation,3,2
0X31A6794877687D25.avi,101,2014,1622,392,24.167694204685574,morphological_dilation,3,2
0X31A6794877687D25.avi,120,1228,920,308,33.47826086956522,morphological_dilation,3,2
0X31A818859E10C195.avi,94,1516,1168,348,29.794520547945208,morphological_dilation,3,2
0X31A818859E10C195.avi,115,802,554,248,44.765342960288805,morphological_dilation,3,2
0X31AC494B44342BAE.avi,45,2584,2128,456,21.428571428571427,morphological_dilation,3,2
0X31AC494B44342BAE.avi,58,1452,1108,344,31.046931407942242,morphological_dilation,3,2
0X31B076E2421E08E4.avi,47,1137,825,312,37.81818181818182,morphological_dilation,3,2
0X31B076E2421E08E4.avi,67,695,399,296,74.18546365914787,morphological_dilation,3,2
0X31B3F20AC08B5491.avi,22,2002,1630,372,22.822085889570552,morphological_dilation,3,2
0X31B3F20AC08B5491.avi,87,1756,1408,348,24.71590909090909,morphological_dilation,3,2
0X31B6E6B67B97806A.avi,133,2043,1648,395,23.968446601941746,morphological_dilation,3,2
0X31B6E6B67B97806A.avi,148,1540,1196,344,28.762541806020064,morphological_dilation,3,2
0X31C2B92D52D9835B.avi,40,2784,2296,488,21.254355400696863,morphological_dilation,3,2
0X31C2B92D52D9835B.avi,58,1966,1538,428,27.828348504551364,morphological_dilation,3,2
0X31C63F2F632AFE59.avi,118,1878,1482,396,26.720647773279353,morphological_dilation,3,2
0X31C63F2F632AFE59.avi,135,1176,844,332,39.33649289099526,morphological_dilation,3,2
0X31C69C4046D1289B.avi,117,1735,1351,384,28.423390081421168,morphological_dilation,3,2
0X31C69C4046D1289B.avi,129,1126,822,304,36.982968369829685,morphological_dilation,3,2
0X31C71452F1441C6E.avi,0,1634,1270,364,28.661417322834648,morphological_dilation,3,2
0X31C71452F1441C6E.avi,14,1219,903,316,34.99446290143965,morphological_dilation,3,2
0X31C7FC69D6C348EA.avi,52,1002,702,300,42.73504273504273,morphological_dilation,3,2
0X31C7FC69D6C348EA.avi,66,912,612,300,49.01960784313725,morphological_dilation,3,2
0X31D148279BA1B88D.avi,45,1603,1243,360,28.962188254223655,morphological_dilation,3,2
0X31D148279BA1B88D.avi,67,965,693,272,39.24963924963925,morphological_dilation,3,2
0X31D2ECB813466DEF.avi,0,1944,1560,384,24.615384615384617,morphological_dilation,3,2
0X31D2ECB813466DEF.avi,18,1385,1049,336,32.030505243088655,morphological_dilation,3,2
0X31D2ED1154B10621.avi,109,2135,1727,408,23.624782860451653,morphological_dilation,3,2
0X31D2ED1154B10621.avi,126,1322,975,347,35.58974358974359,morphological_dilation,3,2
0X31D3AE2E06F1566E.avi,87,1825,1445,380,26.297577854671278,morphological_dilation,3,2
0X31D3AE2E06F1566E.avi,101,1278,950,328,34.526315789473685,morphological_dilation,3,2
0X31D48B2763D0524F.avi,54,1770,1398,372,26.609442060085836,morphological_dilation,3,2
0X31D48B2763D0524F.avi,69,1121,809,312,38.56613102595797,morphological_dilation,3,2
0X31D5F0DB04CEBE74.avi,55,1185,873,312,35.738831615120276,morphological_dilation,3,2
0X31D5F0DB04CEBE74.avi,69,741,485,256,52.78350515463918,morphological_dilation,3,2
0X31D873405F58E85E.avi,111,1846,1427,419,29.36229852838122,morphological_dilation,3,2
0X31D873405F58E85E.avi,127,1074,744,330,44.354838709677416,morphological_dilation,3,2
0X31E20056D742A8B3.avi,88,2678,2162,516,23.866790009250693,morphological_dilation,3,2
0X31E20056D742A8B3.avi,102,1631,1239,392,31.63841807909605,morphological_dilation,3,2
0X31E24F0580C988DC.avi,49,1830,1430,400,27.972027972027973,morphological_dilation,3,2
0X31E24F0580C988DC.avi,65,1080,768,312,40.625,morphological_dilation,3,2
0X31E2CCEE26A37C66.avi,47,2261,1821,440,24.162548050521693,morphological_dilation,3,2
0X31E2CCEE26A37C66.avi,68,1398,1030,368,35.728155339805824,morphological_dilation,3,2
0X31E539C27D120BDE.avi,124,1194,882,312,35.374149659863946,morphological_dilation,3,2
0X31E539C27D120BDE.avi,141,963,687,276,40.174672489082965,morphological_dilation,3,2
0X31E7130E8CEF4E12.avi,74,2731,2263,468,20.680512593901902,morphological_dilation,3,2
0X31E7130E8CEF4E12.avi,91,1772,1388,384,27.6657060518732,morphological_dilation,3,2
0X31EE1F0D632DEED0.avi,43,1663,1275,388,30.43137254901961,morphological_dilation,3,2
0X31EE1F0D632DEED0.avi,66,992,660,332,50.303030303030305,morphological_dilation,3,2
0X31F4E5CAC0DE0D41.avi,62,1838,1446,392,27.10926694329184,morphological_dilation,3,2
0X31F4E5CAC0DE0D41.avi,84,1225,892,333,37.33183856502242,morphological_dilation,3,2
0X31F9215CE617A607.avi,47,1715,1339,376,28.0806572068708,morphological_dilation,3,2
0X31F9215CE617A607.avi,64,1056,740,316,42.7027027027027,morphological_dilation,3,2
0X31FBF37FB7668A25.avi,103,1794,1406,388,27.59601706970128,morphological_dilation,3,2
0X31FBF37FB7668A25.avi,126,1150,822,328,39.90267639902677,morphological_dilation,3,2
0X31FCB82628884EF3.avi,47,1432,1090,342,31.376146788990827,morphological_dilation,3,2
0X31FCB82628884EF3.avi,62,1000,708,292,41.24293785310734,morphological_dilation,3,2
0X31FCC04D7162E128.avi,44,2047,1635,412,25.198776758409785,morphological_dilation,3,2
0X31FCC04D7162E128.avi,59,1320,980,340,34.69387755102041,morphological_dilation,3,2
0X32045C0F3B6461A0.avi,59,1328,980,348,35.51020408163265,morphological_dilation,3,2
0X32045C0F3B6461A0.avi,72,878,582,296,50.85910652920962,morphological_dilation,3,2
0X3206DD7C0738E9DD.avi,39,1632,1242,390,31.40096618357488,morphological_dilation,3,2
0X3206DD7C0738E9DD.avi,50,1185,840,345,41.07142857142857,morphological_dilation,3,2
0X320A26606B6ADA37.avi,97,2209,1777,432,24.310635903207654,morphological_dilation,3,2
0X320A26606B6ADA37.avi,115,1452,1088,364,33.455882352941174,morphological_dilation,3,2
0X320AD06F26E9FD6C.avi,47,2419,1975,444,22.481012658227847,morphological_dilation,3,2
0X320AD06F26E9FD6C.avi,67,1487,1119,368,32.88650580875782,morphological_dilation,3,2
0X321008E037A779B8.avi,126,2033,1641,392,23.8878732480195,morphological_dilation,3,2
0X321008E037A779B8.avi,147,1778,1410,368,26.099290780141843,morphological_dilation,3,2
0X3210E8ECEF2256E7.avi,112,1653,1277,376,29.444009397024274,morphological_dilation,3,2
0X3210E8ECEF2256E7.avi,130,963,652,311,47.69938650306749,morphological_dilation,3,2
0X32117E92121B16F3.avi,192,1118,802,316,39.40149625935162,morphological_dilation,3,2
0X32117E92121B16F3.avi,208,783,503,280,55.666003976143145,morphological_dilation,3,2
0X321656F897378A94.avi,40,2333,1853,480,25.903939557474366,morphological_dilation,3,2
0X321656F897378A94.avi,54,1648,1239,409,33.01049233252623,morphological_dilation,3,2
0X321A0EF32BCBC550.avi,61,1964,1544,420,27.202072538860104,morphological_dilation,3,2
0X321A0EF32BCBC550.avi,77,1144,824,320,38.83495145631068,morphological_dilation,3,2
0X321D8D51EFB9BA5C.avi,0,1486,1162,324,27.882960413080895,morphological_dilation,3,2
0X321D8D51EFB9BA5C.avi,17,966,686,280,40.816326530612244,morphological_dilation,3,2
0X321EBCC21FE8C856.avi,74,1286,958,328,34.23799582463465,morphological_dilation,3,2
0X321EBCC21FE8C856.avi,93,877,593,284,47.89207419898819,morphological_dilation,3,2
0X322499B7AF82988E.avi,58,1922,1514,408,26.948480845442536,morphological_dilation,3,2
0X322499B7AF82988E.avi,69,1490,1138,352,30.931458699472756,morphological_dilation,3,2
0X3224EE34E8450170.avi,74,1342,1010,332,32.87128712871287,morphological_dilation,3,2
0X3224EE34E8450170.avi,88,900,620,280,45.16129032258064,morphological_dilation,3,2
0X3226DADAA3C82456.avi,50,1855,1431,424,29.629629629629626,morphological_dilation,3,2
0X3226DADAA3C82456.avi,55,1172,820,352,42.926829268292686,morphological_dilation,3,2
0X322927F6CCD46338.avi,86,2022,1594,428,26.85069008782936,morphological_dilation,3,2
0X322927F6CCD46338.avi,105,1401,1034,367,35.49323017408123,morphological_dilation,3,2
0X322A355CF59F2B40.avi,42,1597,1249,348,27.862289831865496,morphological_dilation,3,2
0X322A355CF59F2B40.avi,59,1018,734,284,38.69209809264305,morphological_dilation,3,2
0X322AD1DF704CA51.avi,50,1898,1510,388,25.695364238410594,morphological_dilation,3,2
0X322AD1DF704CA51.avi,66,1238,910,328,36.043956043956044,morphological_dilation,3,2
0X322C61C9E15C0DDB.avi,72,2063,1643,420,25.562994522215458,morphological_dilation,3,2
0X322C61C9E15C0DDB.avi,88,1835,1435,400,27.874564459930312,morphological_dilation,3,2
0X32312BC4DF1CD8A3.avi,61,2567,2111,456,21.60113690194221,morphological_dilation,3,2
0X32312BC4DF1CD8A3.avi,77,2182,1750,432,24.685714285714287,morphological_dilation,3,2
0X32340D2C15869C0A.avi,48,2947,2435,512,21.026694045174537,morphological_dilation,3,2
0X32340D2C15869C0A.avi,66,1862,1438,424,29.48539638386648,morphological_dilation,3,2
0X3237F0FD286478F9.avi,90,1515,1159,356,30.71613459879206,morphological_dilation,3,2
0X3237F0FD286478F9.avi,113,968,660,308,46.666666666666664,morphological_dilation,3,2
0X32397CFF9BBD05C3.avi,122,1749,1361,388,28.508449669360765,morphological_dilation,3,2
0X32397CFF9BBD05C3.avi,138,1198,872,326,37.38532110091743,morphological_dilation,3,2
0X323BF010EA16C00C.avi,82,1915,1503,412,27.41184298070526,morphological_dilation,3,2
0X323BF010EA16C00C.avi,96,1197,869,328,37.7445339470656,morphological_dilation,3,2
0X323C358CAEAB7E3B.avi,125,1461,1117,344,30.796777081468218,morphological_dilation,3,2
0X323C358CAEAB7E3B.avi,143,852,565,287,50.796460176991154,morphological_dilation,3,2
0X3249BC61F85F145F.avi,60,1613,1209,404,33.41604631927213,morphological_dilation,3,2
0X3249BC61F85F145F.avi,79,1110,750,360,48.0,morphological_dilation,3,2
0X324A55CC446CDAC2.avi,0,1611,1247,364,29.190056134723335,morphological_dilation,3,2
0X324A55CC446CDAC2.avi,13,1215,895,320,35.754189944134076,morphological_dilation,3,2
0X324B3671E0084467.avi,48,1798,1426,372,26.08695652173913,morphological_dilation,3,2
0X324B3671E0084467.avi,65,1256,936,320,34.18803418803419,morphological_dilation,3,2
0X324D566949BA5E4A.avi,54,1505,1125,380,33.77777777777778,morphological_dilation,3,2
0X324D566949BA5E4A.avi,63,953,621,332,53.4621578099839,morphological_dilation,3,2
0X324D5ED9263EE7D0.avi,83,1406,1062,344,32.39171374764595,morphological_dilation,3,2
0X324D5ED9263EE7D0.avi,105,1084,776,308,39.69072164948454,morphological_dilation,3,2
0X3255DC6631CBE0EE.avi,86,1611,1251,360,28.776978417266186,morphological_dilation,3,2
0X3255DC6631CBE0EE.avi,101,1264,936,328,35.04273504273504,morphological_dilation,3,2
0X325E7B3148ED7759.avi,89,1339,991,348,35.11604439959637,morphological_dilation,3,2
0X325E7B3148ED7759.avi,108,827,555,272,49.009009009009006,morphological_dilation,3,2
0X325F7A4C97D4DBAF.avi,72,2686,2226,460,20.664869721473494,morphological_dilation,3,2
0X325F7A4C97D4DBAF.avi,89,2110,1694,416,24.557260920897285,morphological_dilation,3,2
0X3263F90D7E0EC197.avi,43,2166,1738,428,24.62600690448792,morphological_dilation,3,2
0X3263F90D7E0EC197.avi,71,1183,851,332,39.01292596944771,morphological_dilation,3,2
0X326722FDA159FB67.avi,47,1794,1406,388,27.59601706970128,morphological_dilation,3,2
0X326722FDA159FB67.avi,63,1164,848,316,37.264150943396224,morphological_dilation,3,2
0X32692F7C7ED077C5.avi,46,2900,2400,500,20.833333333333336,morphological_dilation,3,2
0X32692F7C7ED077C5.avi,57,2568,2096,472,22.519083969465647,morphological_dilation,3,2
0X3269691452F4F42A.avi,106,1876,1325,551,41.58490566037736,morphological_dilation,3,2
0X3269691452F4F42A.avi,144,2038,1642,396,24.116930572472594,morphological_dilation,3,2
0X326ABE058F8ACB8D.avi,110,2786,2322,464,19.982773471145563,morphological_dilation,3,2
0X326ABE058F8ACB8D.avi,127,1884,1461,423,28.952772073921974,morphological_dilation,3,2
0X3275A62B32E854D5.avi,82,2059,1651,408,24.71229557843731,morphological_dilation,3,2
0X3275A62B32E854D5.avi,100,1272,940,332,35.319148936170215,morphological_dilation,3,2
0X32793DD199C99CEA.avi,57,1604,1224,380,31.045751633986928,morphological_dilation,3,2
0X32793DD199C99CEA.avi,74,1303,951,352,37.013669821240796,morphological_dilation,3,2
0X3285FE374F563092.avi,0,1830,1436,394,27.437325905292482,morphological_dilation,3,2
0X3285FE374F563092.avi,15,1458,1097,361,32.90793072014585,morphological_dilation,3,2
0X3289775294422CD9.avi,102,1966,1562,404,25.86427656850192,morphological_dilation,3,2
0X3289775294422CD9.avi,119,1640,1276,364,28.526645768025077,morphological_dilation,3,2
0X328A9B4F2821F941.avi,115,2154,1702,452,26.556991774383075,morphological_dilation,3,2
0X328A9B4F2821F941.avi,132,1178,820,358,43.65853658536585,morphological_dilation,3,2
0X328BD28D092FCAC4.avi,42,1791,1407,384,27.292110874200425,morphological_dilation,3,2
0X328BD28D092FCAC4.avi,54,1104,780,324,41.53846153846154,morphological_dilation,3,2
0X328E6B9F2BE3343F.avi,3,1664,1288,376,29.19254658385093,morphological_dilation,3,2
0X328E6B9F2BE3343F.avi,16,1107,807,300,37.174721189591075,morphological_dilation,3,2
0X329210815212AA6A.avi,43,1581,1203,378,31.421446384039903,morphological_dilation,3,2
0X329210815212AA6A.avi,55,1246,902,344,38.13747228381374,morphological_dilation,3,2
0X3296B7D992D8EF77.avi,44,1195,891,304,34.11896745230079,morphological_dilation,3,2
0X3296B7D992D8EF77.avi,60,1005,721,284,39.389736477115115,morphological_dilation,3,2
0X32A27346773DADC8.avi,61,1768,1364,404,29.61876832844575,morphological_dilation,3,2
0X32A27346773DADC8.avi,84,1249,877,372,42.41733181299886,morphological_dilation,3,2
0X32A3B50290C0920B.avi,2,1759,1365,394,28.86446886446886,morphological_dilation,3,2
0X32A3B50290C0920B.avi,19,1064,742,322,43.39622641509434,morphological_dilation,3,2
0X32A7E7D83FC9AB4D.avi,0,1788,1416,372,26.27118644067797,morphological_dilation,3,2
0X32A7E7D83FC9AB4D.avi,15,1156,860,296,34.418604651162795,morphological_dilation,3,2
0X32A800B7CCBE3258.avi,59,1844,1460,384,26.301369863013697,morphological_dilation,3,2
0X32A800B7CCBE3258.avi,82,1218,906,312,34.437086092715234,morphological_dilation,3,2
0X32AEF2B955391F03.avi,54,1898,1498,400,26.702269692923895,morphological_dilation,3,2
0X32AEF2B955391F03.avi,67,1619,1247,372,29.83159582999198,morphological_dilation,3,2
0X32AFF6A0BED73A67.avi,104,1190,850,340,40.0,morphological_dilation,3,2
0X32AFF6A0BED73A67.avi,118,768,483,285,59.006211180124225,morphological_dilation,3,2
0X32BA30438E83A84.avi,40,1978,1566,412,26.309067688378036,morphological_dilation,3,2
0X32BA30438E83A84.avi,55,1109,801,308,38.45193508114856,morphological_dilation,3,2
0X32BC15EF20DA1BD9.avi,95,2426,1966,460,23.397761953204476,morphological_dilation,3,2
0X32BC15EF20DA1BD9.avi,106,1778,1363,415,30.447542186353633,morphological_dilation,3,2
0X32BD73DC6E258DB.avi,153,1832,1448,384,26.519337016574585,morphological_dilation,3,2
0X32BD73DC6E258DB.avi,165,1207,875,332,37.94285714285714,morphological_dilation,3,2
0X32C032EAEE7813E7.avi,100,1522,1146,376,32.809773123909245,morphological_dilation,3,2
0X32C032EAEE7813E7.avi,116,970,654,316,48.318042813455655,morphological_dilation,3,2
0X32C32159B97474E4.avi,86,1745,1369,376,27.465303140978815,morphological_dilation,3,2
0X32C32159B97474E4.avi,103,1216,908,308,33.92070484581498,morphological_dilation,3,2
0X32D38BB19B226A8C.avi,52,1848,1448,400,27.624309392265197,morphological_dilation,3,2
0X32D38BB19B226A8C.avi,65,1189,853,336,39.390386869871044,morphological_dilation,3,2
0X32D4DA8EABE4418C.avi,48,2069,1633,436,26.699326393141458,morphological_dilation,3,2
0X32D4DA8EABE4418C.avi,64,1276,920,356,38.69565217391304,morphological_dilation,3,2
0X32DB42B7457ECACB.avi,117,1896,1508,388,25.72944297082228,morphological_dilation,3,2
0X32DB42B7457ECACB.avi,141,1266,946,320,33.82663847780127,morphological_dilation,3,2
0X32DC806BF959BA14.avi,104,1558,1206,352,29.187396351575458,morphological_dilation,3,2
0X32DC806BF959BA14.avi,125,1137,833,304,36.49459783913566,morphological_dilation,3,2
0X32E508370DC978B.avi,39,2661,2153,508,23.59498374361356,morphological_dilation,3,2
0X32E508370DC978B.avi,55,2037,1593,444,27.87193973634652,morphological_dilation,3,2
0X32E79594A10EDF5F.avi,95,1485,1113,372,33.42318059299191,morphological_dilation,3,2
0X32E79594A10EDF5F.avi,107,1212,868,344,39.63133640552996,morphological_dilation,3,2
0X32EE41A1B84B6A14.avi,49,2158,1738,420,24.165707710011507,morphological_dilation,3,2
0X32EE41A1B84B6A14.avi,65,1300,972,328,33.744855967078195,morphological_dilation,3,2
0X32EEB965CE009046.avi,114,1610,1240,370,29.838709677419356,morphological_dilation,3,2
0X32EEB965CE009046.avi,128,993,705,288,40.85106382978723,morphological_dilation,3,2
0X32EFE97394069284.avi,73,2551,2087,464,22.232870148538574,morphological_dilation,3,2
0X32EFE97394069284.avi,91,1478,1114,364,32.675044883303414,morphological_dilation,3,2
0X32F2F0DB38AB8F0E.avi,39,2222,1750,472,26.971428571428575,morphological_dilation,3,2
0X32F2F0DB38AB8F0E.avi,57,1687,1267,420,33.14917127071823,morphological_dilation,3,2
0X32F6A3D09D55F15.avi,89,3155,2627,528,20.098972211648267,morphological_dilation,3,2
0X32F6A3D09D55F15.avi,106,1842,1422,420,29.535864978902953,morphological_dilation,3,2
0X32F8AD6F7FAA5FA1.avi,41,2695,2235,460,20.581655480984338,morphological_dilation,3,2
0X32F8AD6F7FAA5FA1.avi,61,1883,1491,392,26.291079812206576,morphological_dilation,3,2
0X32FC6DD96FD01C1E.avi,78,1772,1388,384,27.6657060518732,morphological_dilation,3,2
0X32FC6DD96FD01C1E.avi,100,1099,783,316,40.357598978288635,morphological_dilation,3,2
0X32FDD6BF12B089E1.avi,26,1492,1128,364,32.269503546099294,morphological_dilation,3,2
0X32FDD6BF12B089E1.avi,37,904,607,297,48.92915980230643,morphological_dilation,3,2
0X32FFE959DFD8A7FA.avi,39,2871,2395,476,19.87473903966597,morphological_dilation,3,2
0X32FFE959DFD8A7FA.avi,51,1677,1285,392,30.505836575875488,morphological_dilation,3,2
0X330D6A7AA5B79576.avi,47,1214,901,313,34.73917869034406,morphological_dilation,3,2
0X330D6A7AA5B79576.avi,67,698,458,240,52.40174672489083,morphological_dilation,3,2
0X330E6856301BBF9A.avi,2,2469,2033,436,21.446138711264144,morphological_dilation,3,2
0X330E6856301BBF9A.avi,20,1498,1158,340,29.360967184801385,morphological_dilation,3,2
0X33102FE7080DF430.avi,184,1814,1415,399,28.19787985865724,morphological_dilation,3,2
0X33102FE7080DF430.avi,205,1242,894,348,38.92617449664429,morphological_dilation,3,2
0X331101FA7F150A51.avi,52,1690,1322,368,27.83661119515885,morphological_dilation,3,2
0X331101FA7F150A51.avi,68,1060,752,308,40.95744680851064,morphological_dilation,3,2
0X33129CC972FD945A.avi,90,1441,1117,324,29.00626678603402,morphological_dilation,3,2
0X33129CC972FD945A.avi,104,976,696,280,40.229885057471265,morphological_dilation,3,2
0X331371BEC12BCA1D.avi,142,2444,2004,440,21.956087824351297,morphological_dilation,3,2
0X331371BEC12BCA1D.avi,157,2107,1683,424,25.193107546048722,morphological_dilation,3,2
0X33155387C61B9F96.avi,121,992,704,288,40.909090909090914,morphological_dilation,3,2
0X33155387C61B9F96.avi,139,617,377,240,63.660477453580896,morphological_dilation,3,2
0X3315BE64B4EFA2E0.avi,1,2060,1649,411,24.9241964827168,morphological_dilation,3,2
0X3315BE64B4EFA2E0.avi,17,1309,941,368,39.10733262486716,morphological_dilation,3,2
0X3317BCA5B123B1DA.avi,45,995,723,272,37.6210235131397,morphological_dilation,3,2
0X3317BCA5B123B1DA.avi,58,998,667,331,49.62518740629685,morphological_dilation,3,2
0X3319F092B34E5C6E.avi,42,1789,1386,403,29.076479076479078,morphological_dilation,3,2
0X3319F092B34E5C6E.avi,56,1104,752,352,46.808510638297875,morphological_dilation,3,2
0X331A9942531AF159.avi,1,1670,1310,360,27.480916030534353,morphological_dilation,3,2
0X331A9942531AF159.avi,17,1105,801,304,37.95255930087391,morphological_dilation,3,2
0X331C177536F2D6A7.avi,37,1604,1232,372,30.1948051948052,morphological_dilation,3,2
0X331C177536F2D6A7.avi,58,1039,729,310,42.524005486968456,morphological_dilation,3,2
0X331E30E9C34D156B.avi,77,1494,1114,380,34.1113105924596,morphological_dilation,3,2
0X331E30E9C34D156B.avi,91,947,643,304,47.27838258164852,morphological_dilation,3,2
0X331E4B6F94DAA79F.avi,44,1816,1424,392,27.52808988764045,morphological_dilation,3,2
0X331E4B6F94DAA79F.avi,61,1079,767,312,40.67796610169492,morphological_dilation,3,2
0X331F3DCBF76715B8.avi,43,1612,1232,380,30.844155844155846,morphological_dilation,3,2
0X331F3DCBF76715B8.avi,58,1059,711,348,48.9451476793249,morphological_dilation,3,2
0X331FA2EFD16DD71F.avi,98,2116,1672,444,26.555023923444978,morphological_dilation,3,2
0X331FA2EFD16DD71F.avi,118,1183,782,401,51.27877237851662,morphological_dilation,3,2
0X3322B56BD6D0A2DA.avi,4,2271,1835,436,23.760217983651227,morphological_dilation,3,2
0X3322B56BD6D0A2DA.avi,17,1488,1104,384,34.78260869565217,morphological_dilation,3,2
0X3322CB5CF2D2DFDC.avi,42,1212,892,320,35.874439461883405,morphological_dilation,3,2
0X3322CB5CF2D2DFDC.avi,61,731,459,272,59.25925925925925,morphological_dilation,3,2
0X332303C99316EA31.avi,116,1568,1192,376,31.543624161073826,morphological_dilation,3,2
0X332303C99316EA31.avi,132,986,682,304,44.57478005865102,morphological_dilation,3,2
0X3323D09B5F9FD9E2.avi,104,1823,1395,428,30.681003584229387,morphological_dilation,3,2
0X3323D09B5F9FD9E2.avi,120,1126,786,340,43.25699745547074,morphological_dilation,3,2
0X33270551FC06E368.avi,186,1531,1163,368,31.64230438521066,morphological_dilation,3,2
0X33270551FC06E368.avi,202,918,642,276,42.99065420560748,morphological_dilation,3,2
0X3327607103BF5410.avi,0,3995,3415,580,16.98389458272328,morphological_dilation,3,2
0X3327607103BF5410.avi,19,2290,1838,452,24.591947769314473,morphological_dilation,3,2
0X332B4C68C60E40D4.avi,60,1743,1355,388,28.634686346863468,morphological_dilation,3,2
0X332B4C68C60E40D4.avi,81,1210,866,344,39.722863741339495,morphological_dilation,3,2
0X3330641518FE2774.avi,47,2213,1785,428,23.977591036414566,morphological_dilation,3,2
0X3330641518FE2774.avi,65,1482,1130,352,31.150442477876105,morphological_dilation,3,2
0X3331B6D11597103D.avi,93,1481,1129,352,31.178033658104514,morphological_dilation,3,2
0X3331B6D11597103D.avi,109,958,670,288,42.98507462686567,morphological_dilation,3,2
0X3331CE57D8978B42.avi,130,1492,1156,336,29.06574394463668,morphological_dilation,3,2
0X3331CE57D8978B42.avi,148,976,692,284,41.040462427745666,morphological_dilation,3,2
0X33343944D242ACF2.avi,107,2266,1826,440,24.096385542168676,morphological_dilation,3,2
0X33343944D242ACF2.avi,122,1613,1241,372,29.975825946817082,morphological_dilation,3,2
0X333986F8FA0EE679.avi,114,2944,2468,476,19.286871961102108,morphological_dilation,3,2
0X333986F8FA0EE679.avi,125,2800,2340,460,19.65811965811966,morphological_dilation,3,2
0X333A6598916DD19.avi,0,2021,1617,404,24.984539270253556,morphological_dilation,3,2
0X333A6598916DD19.avi,5,1170,846,324,38.297872340425535,morphological_dilation,3,2
0X333F90C4D2DB981A.avi,116,2017,1585,432,27.255520504731862,morphological_dilation,3,2
0X333F90C4D2DB981A.avi,132,1489,1097,392,35.73381950774841,morphological_dilation,3,2
0X333FD98F27A8A355.avi,98,1708,1352,356,26.331360946745562,morphological_dilation,3,2
0X333FD98F27A8A355.avi,112,1266,942,324,34.394904458598724,morphological_dilation,3,2
0X3342A007765C4B9D.avi,52,1476,1132,344,30.3886925795053,morphological_dilation,3,2
0X3342A007765C4B9D.avi,68,983,695,288,41.43884892086331,morphological_dilation,3,2
0X334387311D165778.avi,39,2087,1679,408,24.300178677784395,morphological_dilation,3,2
0X334387311D165778.avi,53,1258,914,344,37.63676148796499,morphological_dilation,3,2
0X3344182832A27669.avi,43,1543,1187,356,29.99157540016849,morphological_dilation,3,2
0X3344182832A27669.avi,58,982,686,296,43.14868804664723,morphological_dilation,3,2
0X3345EE0460BEFF23.avi,51,1830,1442,388,26.907073509015255,morphological_dilation,3,2
0X3345EE0460BEFF23.avi,69,1206,878,328,37.357630979498865,morphological_dilation,3,2
0X3345F2E187DBB431.avi,103,1473,1125,348,30.933333333333334,morphological_dilation,3,2
0X3345F2E187DBB431.avi,118,971,683,288,42.16691068814056,morphological_dilation,3,2
0X334B87F0729817FB.avi,0,1579,1211,368,30.388109000825764,morphological_dilation,3,2
0X334B87F0729817FB.avi,16,951,675,276,40.88888888888889,morphological_dilation,3,2
0X334CC02665FB2A7C.avi,168,3029,2533,496,19.581523884721676,morphological_dilation,3,2
0X334CC02665FB2A7C.avi,188,2004,1608,396,24.62686567164179,morphological_dilation,3,2
0X334D7C64AAB53CD.avi,50,3614,3070,544,17.71986970684039,morphological_dilation,3,2
0X334D7C64AAB53CD.avi,71,2204,1756,448,25.512528473804103,morphological_dilation,3,2
0X334F8452094FF33E.avi,53,2148,1732,416,24.018475750577366,morphological_dilation,3,2
0X334F8452094FF33E.avi,73,1399,1059,340,32.10576015108593,morphological_dilation,3,2
0X3351369E8117D69F.avi,35,2160,1728,432,25.0,morphological_dilation,3,2
0X3351369E8117D69F.avi,52,1266,906,360,39.735099337748345,morphological_dilation,3,2
0X335537FEEA365B7F.avi,145,1854,1454,400,27.51031636863824,morphological_dilation,3,2
0X335537FEEA365B7F.avi,171,1161,821,340,41.41291108404385,morphological_dilation,3,2
0X3355C64DA540919A.avi,2,1581,1209,372,30.76923076923077,morphological_dilation,3,2
0X3355C64DA540919A.avi,19,1276,944,332,35.16949152542373,morphological_dilation,3,2
0X335B5FC2607A30BE.avi,37,1522,1166,356,30.53173241852487,morphological_dilation,3,2
0X335B5FC2607A30BE.avi,52,956,680,276,40.588235294117645,morphological_dilation,3,2
0X335BC6AA17BC0556.avi,0,2610,2146,464,21.62162162162162,morphological_dilation,3,2
0X335BC6AA17BC0556.avi,18,1408,1052,356,33.840304182509506,morphological_dilation,3,2
0X3361443607342447.avi,91,2369,1901,468,24.618621778011573,morphological_dilation,3,2
0X3361443607342447.avi,112,1982,1539,443,28.784925276153345,morphological_dilation,3,2
0X33646D65192ECB1B.avi,50,1523,1171,352,30.0597779675491,morphological_dilation,3,2
0X33646D65192ECB1B.avi,66,951,655,296,45.19083969465649,morphological_dilation,3,2
0X33684EDE3D2A8403.avi,53,1243,904,339,37.5,morphological_dilation,3,2
0X33684EDE3D2A8403.avi,70,924,627,297,47.368421052631575,morphological_dilation,3,2
0X336E68E12F89AB87.avi,2,2615,2151,464,21.571362157136214,morphological_dilation,3,2
0X336E68E12F89AB87.avi,15,1642,1250,392,31.36,morphological_dilation,3,2
0X336FEFA48BEDADD9.avi,110,1694,1326,368,27.7526395173454,morphological_dilation,3,2
0X336FEFA48BEDADD9.avi,130,981,709,272,38.3638928067701,morphological_dilation,3,2
0X337135AA2B0C8A89.avi,44,2080,1652,428,25.907990314769975,morphological_dilation,3,2
0X337135AA2B0C8A89.avi,60,1236,900,336,37.333333333333336,morphological_dilation,3,2
0X3372DC50E0B65B09.avi,43,1514,1162,352,30.292598967297764,morphological_dilation,3,2
0X3372DC50E0B65B09.avi,56,1250,950,300,31.57894736842105,morphological_dilation,3,2
0X33763ECB684188DA.avi,85,2694,2214,480,21.680216802168022,morphological_dilation,3,2
0X33763ECB684188DA.avi,105,2101,1677,424,25.28324388789505,morphological_dilation,3,2
0X3377F80F64924FF6.avi,157,1711,1319,392,29.71948445792267,morphological_dilation,3,2
0X3377F80F64924FF6.avi,174,1038,726,312,42.97520661157025,morphological_dilation,3,2
0X3378E1497A371427.avi,79,1593,1229,364,29.617575264442635,morphological_dilation,3,2
0X3378E1497A371427.avi,92,990,692,298,43.0635838150289,morphological_dilation,3,2
0X337BC0A792EAA058.avi,49,1676,1305,371,28.42911877394636,morphological_dilation,3,2
0X337BC0A792EAA058.avi,62,1082,762,320,41.99475065616798,morphological_dilation,3,2
0X337C7EAD926FC8D1.avi,87,1298,958,340,35.49060542797495,morphological_dilation,3,2
0X337C7EAD926FC8D1.avi,107,891,607,284,46.787479406919275,morphological_dilation,3,2
0X33801E24EDECD5DE.avi,112,2227,1777,450,25.323579065841308,morphological_dilation,3,2
0X33801E24EDECD5DE.avi,130,1358,990,368,37.17171717171717,morphological_dilation,3,2
0X3380B75705B84B6A.avi,89,2353,1905,448,23.517060367454068,morphological_dilation,3,2
0X3380B75705B84B6A.avi,104,1443,1083,360,33.2409972299169,morphological_dilation,3,2
0X3386474C986AC6E0.avi,57,5688,5021,667,13.28420633339972,morphological_dilation,3,2
0X3386474C986AC6E0.avi,68,3389,2829,560,19.794980558501237,morphological_dilation,3,2
0X338A79C8EE1DC1EE.avi,129,2179,1755,424,24.15954415954416,morphological_dilation,3,2
0X338A79C8EE1DC1EE.avi,144,1297,957,340,35.52769070010449,morphological_dilation,3,2
0X338B2143E28692C3.avi,55,1818,1422,396,27.848101265822784,morphological_dilation,3,2
0X338B2143E28692C3.avi,76,1127,815,312,38.282208588957054,morphological_dilation,3,2
0X3392A216139E5076.avi,109,2085,1685,400,23.738872403560833,morphological_dilation,3,2
0X3392A216139E5076.avi,127,1316,988,328,33.198380566801625,morphological_dilation,3,2
0X3394222B4D42120E.avi,42,1906,1506,400,26.560424966799467,morphological_dilation,3,2
0X3394222B4D42120E.avi,64,1490,1150,340,29.565217391304348,morphological_dilation,3,2
0X3395476F5A327AEC.avi,41,2060,1656,404,24.396135265700483,morphological_dilation,3,2
0X3395476F5A327AEC.avi,58,1214,894,320,35.79418344519016,morphological_dilation,3,2
0X339CE86F29AF16AC.avi,0,2602,2154,448,20.798514391829155,morphological_dilation,3,2
0X339CE86F29AF16AC.avi,20,1947,1543,404,26.182760855476346,morphological_dilation,3,2
0X339EDBDA0782AA12.avi,92,2415,1987,428,21.540010065425264,morphological_dilation,3,2
0X339EDBDA0782AA12.avi,111,1485,1133,352,31.06796116504854,morphological_dilation,3,2
0X339F99A07CA3DDE6.avi,83,1394,1050,344,32.761904761904766,morphological_dilation,3,2
0X339F99A07CA3DDE6.avi,100,862,582,280,48.10996563573883,morphological_dilation,3,2
0X33A5EAE97F02CAC5.avi,5,2062,1607,455,28.313627878033603,morphological_dilation,3,2
0X33A5EAE97F02CAC5.avi,27,1346,974,372,38.19301848049281,morphological_dilation,3,2
0X33A69D89DA1BF30B.avi,51,3126,2614,512,19.58684009181331,morphological_dilation,3,2
0X33A69D89DA1BF30B.avi,74,2569,2101,468,22.275107091861017,morphological_dilation,3,2
0X33AF76D527A55F61.avi,4,1879,1479,400,27.045300878972277,morphological_dilation,3,2
0X33AF76D527A55F61.avi,16,1117,777,340,43.758043758043755,morphological_dilation,3,2
0X33B2731B3D69C2E8.avi,56,1380,1060,320,30.18867924528302,morphological_dilation,3,2
0X33B2731B3D69C2E8.avi,70,822,555,267,48.10810810810811,morphological_dilation,3,2
0X33B47388D301E9B9.avi,45,1502,1134,368,32.451499118165785,morphological_dilation,3,2
0X33B47388D301E9B9.avi,61,1026,718,308,42.89693593314763,morphological_dilation,3,2
0X33B931135755C02D.avi,101,2244,1756,488,27.790432801822323,morphological_dilation,3,2
0X33B931135755C02D.avi,118,1382,1018,364,35.75638506876228,morphological_dilation,3,2
0X33BB0E79E1949B78.avi,39,1659,1267,392,30.939226519337016,morphological_dilation,3,2
0X33BB0E79E1949B78.avi,53,1019,715,304,42.51748251748252,morphological_dilation,3,2
0X33BECF6DE6E8D68B.avi,79,2313,1881,432,22.966507177033492,morphological_dilation,3,2
0X33BECF6DE6E8D68B.avi,100,1695,1288,407,31.599378881987576,morphological_dilation,3,2
0X33BF00D55528C824.avi,9,1051,747,304,40.69611780455154,morphological_dilation,3,2
0X33BF00D55528C824.avi,20,652,392,260,66.3265306122449,morphological_dilation,3,2
0X33BF24BE8114D6EF.avi,57,3043,2551,492,19.286554292434342,morphological_dilation,3,2
0X33BF24BE8114D6EF.avi,73,1762,1374,388,28.238719068413392,morphological_dilation,3,2
0X33C02A3FE1E3BB60.avi,93,2212,1768,444,25.1131221719457,morphological_dilation,3,2
0X33C02A3FE1E3BB60.avi,116,1423,1051,372,35.39486203615604,morphological_dilation,3,2
0X33C06F70A505E8A4.avi,50,1861,1481,380,25.65833896016205,morphological_dilation,3,2
0X33C06F70A505E8A4.avi,70,1177,865,312,36.06936416184971,morphological_dilation,3,2
0X33C1CE560C2A94F7.avi,103,2432,1980,452,22.828282828282827,morphological_dilation,3,2
0X33C1CE560C2A94F7.avi,119,1607,1207,400,33.140016570008285,morphological_dilation,3,2
0X33C3D95C20A0D931.avi,24,1179,875,304,34.74285714285714,morphological_dilation,3,2
0X33C3D95C20A0D931.avi,38,832,580,252,43.44827586206896,morphological_dilation,3,2
0X33C5FAF146604827.avi,29,1083,767,316,41.19947848761408,morphological_dilation,3,2
0X33C5FAF146604827.avi,41,675,391,284,72.63427109974424,morphological_dilation,3,2
0X33C791E1689C2726.avi,85,1872,1435,437,30.452961672473865,morphological_dilation,3,2
0X33C791E1689C2726.avi,103,1112,768,344,44.79166666666667,morphological_dilation,3,2
0X33CB7178EBFA4CC8.avi,69,1281,969,312,32.19814241486068,morphological_dilation,3,2
0X33CB7178EBFA4CC8.avi,79,906,630,276,43.80952380952381,morphological_dilation,3,2
0X33CE722927824933.avi,36,1795,1391,404,29.043853342918762,morphological_dilation,3,2
0X33CE722927824933.avi,52,1065,749,316,42.18958611481976,morphological_dilation,3,2
0X33D18DF74CDD4C2A.avi,116,1133,813,320,39.36039360393604,morphological_dilation,3,2
0X33D18DF74CDD4C2A.avi,132,783,503,280,55.666003976143145,morphological_dilation,3,2
0X33D2E42B24A37393.avi,48,4279,3671,608,16.56224461999455,morphological_dilation,3,2
0X33D2E42B24A37393.avi,63,2391,1923,468,24.336973478939157,morphological_dilation,3,2
0X33D4E36501CE4BB3.avi,128,1783,1399,384,27.448177269478197,morphological_dilation,3,2
0X33D4E36501CE4BB3.avi,145,1178,862,316,36.65893271461717,morphological_dilation,3,2
0X33D4F7277E4B9E25.avi,129,3312,2824,488,17.280453257790366,morphological_dilation,3,2
0X33D4F7277E4B9E25.avi,148,2186,1782,404,22.671156004489337,morphological_dilation,3,2
0X33D5FF46E1A2274.avi,48,1355,992,363,36.59274193548387,morphological_dilation,3,2
0X33D5FF46E1A2274.avi,62,818,458,360,78.60262008733623,morphological_dilation,3,2
0X33D6C37E2BE30F7C.avi,48,1812,1428,384,26.89075630252101,morphological_dilation,3,2
0X33D6C37E2BE30F7C.avi,68,1264,928,336,36.206896551724135,morphological_dilation,3,2
0X33D87F30AE9C9DB6.avi,54,1761,1369,392,28.634039444850256,morphological_dilation,3,2
0X33D87F30AE9C9DB6.avi,70,1207,883,324,36.693091732729336,morphological_dilation,3,2
0X33DC70DA3600D15D.avi,71,3568,3028,540,17.8335535006605,morphological_dilation,3,2
0X33DC70DA3600D15D.avi,82,2962,2470,492,19.91902834008097,morphological_dilation,3,2
0X33DC75C67339384A.avi,132,1919,1543,376,24.36811406351264,morphological_dilation,3,2
0X33DC75C67339384A.avi,146,1089,797,292,36.637390213299874,morphological_dilation,3,2
0X33DF960A6BD847AD.avi,81,2932,2424,508,20.957095709570957,morphological_dilation,3,2
0X33DF960A6BD847AD.avi,102,2139,1696,443,26.120283018867923,morphological_dilation,3,2
0X33E0EF504880E70C.avi,101,1985,1589,396,24.921334172435493,morphological_dilation,3,2
0X33E0EF504880E70C.avi,120,1237,906,331,36.53421633554083,morphological_dilation,3,2
0X33E127FCB951ED9C.avi,42,1645,1273,372,29.222309505106047,morphological_dilation,3,2
0X33E127FCB951ED9C.avi,51,879,591,288,48.73096446700508,morphological_dilation,3,2
0X33E4547677604CF2.avi,35,2054,1662,392,23.586040914560773,morphological_dilation,3,2
0X33E4547677604CF2.avi,52,1672,1316,356,27.0516717325228,morphological_dilation,3,2
0X33E9BEA41552C6F3.avi,103,1561,1217,344,28.26622843056697,morphological_dilation,3,2
0X33E9BEA41552C6F3.avi,113,946,653,293,44.86983154670751,morphological_dilation,3,2
0X33EA067E1BF77EFA.avi,78,1761,1385,376,27.148014440433215,morphological_dilation,3,2
0X33EA067E1BF77EFA.avi,94,1163,851,312,36.66274970622796,morphological_dilation,3,2
0X33EA3705CEBB74DA.avi,177,2663,2189,474,21.65372316126085,morphological_dilation,3,2
0X33EA3705CEBB74DA.avi,198,1924,1512,412,27.24867724867725,morphological_dilation,3,2
0X33EAE0F44B7618C1.avi,42,1896,1484,412,27.762803234501348,morphological_dilation,3,2
0X33EAE0F44B7618C1.avi,62,1416,1064,352,33.08270676691729,morphological_dilation,3,2
0X33EBABBCE09F2DAE.avi,34,1244,932,312,33.47639484978541,morphological_dilation,3,2
0X33EBABBCE09F2DAE.avi,53,840,572,268,46.85314685314685,morphological_dilation,3,2
0X33EC93EAFBBD0C5E.avi,68,960,676,284,42.01183431952663,morphological_dilation,3,2
0X33EC93EAFBBD0C5E.avi,79,545,299,246,82.2742474916388,morphological_dilation,3,2
0X33ED9A0B02AAACFA.avi,86,1516,1184,332,28.040540540540544,morphological_dilation,3,2
0X33ED9A0B02AAACFA.avi,101,915,631,284,45.00792393026941,morphological_dilation,3,2
0X33EE0DCD5DC58B4C.avi,93,1727,1359,368,27.078734363502576,morphological_dilation,3,2
0X33EE0DCD5DC58B4C.avi,109,971,683,288,42.16691068814056,morphological_dilation,3,2
0X33EF85BEFE8A25A1.avi,186,1431,1075,356,33.116279069767444,morphological_dilation,3,2
0X33EF85BEFE8A25A1.avi,198,761,469,292,62.26012793176972,morphological_dilation,3,2
0X33EFAD3CC44F65D2.avi,153,1826,1442,384,26.629680998613036,morphological_dilation,3,2
0X33EFAD3CC44F65D2.avi,170,1267,943,324,34.35843054082714,morphological_dilation,3,2
0X33F1D582C99188E6.avi,46,2319,1859,460,24.744486282947822,morphological_dilation,3,2
0X33F1D582C99188E6.avi,65,1693,1297,396,30.53199691595991,morphological_dilation,3,2
0X33F65ADDD00BECF.avi,44,1627,1267,360,28.413575374901338,morphological_dilation,3,2
0X33F65ADDD00BECF.avi,65,1201,893,308,34.49048152295633,morphological_dilation,3,2
0X33F695DCDDB78E64.avi,76,1496,1131,365,32.272325375773654,morphological_dilation,3,2
0X33F695DCDDB78E64.avi,95,856,580,276,47.58620689655172,morphological_dilation,3,2
0X33FAC1D874BC1873.avi,91,1993,1577,416,26.379201014584652,morphological_dilation,3,2
0X33FAC1D874BC1873.avi,105,1734,1336,398,29.790419161676645,morphological_dilation,3,2
0X33FAD88E89C48D24.avi,34,1772,1400,372,26.571428571428573,morphological_dilation,3,2
0X33FAD88E89C48D24.avi,52,1318,974,344,35.318275154004105,morphological_dilation,3,2
0X33FB3B666A158A2B.avi,3,1873,1493,380,25.452109845947756,morphological_dilation,3,2
0X33FB3B666A158A2B.avi,20,1216,908,308,33.92070484581498,morphological_dilation,3,2
0X33FEE43E021DA243.avi,70,1409,1065,344,32.30046948356807,morphological_dilation,3,2
0X33FEE43E021DA243.avi,83,874,582,292,50.171821305841924,morphological_dilation,3,2
0X3402A5D3DB11938E.avi,60,1485,1113,372,33.42318059299191,morphological_dilation,3,2
0X3402A5D3DB11938E.avi,72,1009,697,312,44.76327116212339,morphological_dilation,3,2
0X3402AE2F48D0B71C.avi,29,1094,790,304,38.48101265822785,morphological_dilation,3,2
0X3402AE2F48D0B71C.avi,42,713,461,252,54.66377440347071,morphological_dilation,3,2
0X340364B9261E5FD8.avi,99,3296,2780,516,18.56115107913669,morphological_dilation,3,2
0X340364B9261E5FD8.avi,119,2797,2322,475,20.45650301464255,morphological_dilation,3,2
0X3403D217C07A90BB.avi,0,1995,1611,384,23.83612662942272,morphological_dilation,3,2
0X3403D217C07A90BB.avi,18,1299,987,312,31.61094224924012,morphological_dilation,3,2
0X34093F356D30ECBD.avi,45,2521,2053,468,22.795908426692645,morphological_dilation,3,2
0X34093F356D30ECBD.avi,67,1962,1562,400,25.60819462227913,morphological_dilation,3,2
0X340A15409D548A73.avi,144,1511,1155,356,30.822510822510825,morphological_dilation,3,2
0X340A15409D548A73.avi,157,906,626,280,44.72843450479233,morphological_dilation,3,2
0X340D3CA7C92DC723.avi,32,1541,1189,352,29.60470984020185,morphological_dilation,3,2
0X340D3CA7C92DC723.avi,46,1328,992,336,33.87096774193548,morphological_dilation,3,2
0X341959DF85C5BE6E.avi,71,3564,2994,570,19.03807615230461,morphological_dilation,3,2
0X341959DF85C5BE6E.avi,93,2295,1815,480,26.446280991735538,morphological_dilation,3,2
0X341CD0F8247C3635.avi,29,1498,1150,348,30.26086956521739,morphological_dilation,3,2
0X341CD0F8247C3635.avi,41,959,671,288,42.92101341281669,morphological_dilation,3,2
0X341CE51CF56BDC97.avi,131,1472,1132,340,30.03533568904594,morphological_dilation,3,2
0X341CE51CF56BDC97.avi,144,903,599,304,50.75125208681135,morphological_dilation,3,2
0X341D23C239E4D3D3.avi,90,1607,1247,360,28.869286287089015,morphological_dilation,3,2
0X341D23C239E4D3D3.avi,107,1158,842,316,37.52969121140142,morphological_dilation,3,2
0X341EC20E83B0B356.avi,52,1635,1275,360,28.235294117647058,morphological_dilation,3,2
0X341EC20E83B0B356.avi,67,998,722,276,38.227146814404435,morphological_dilation,3,2
0X3420346582CD97A4.avi,40,1658,1306,352,26.952526799387442,morphological_dilation,3,2
0X3420346582CD97A4.avi,57,1104,804,300,37.3134328358209,morphological_dilation,3,2
0X3422556389DBC33C.avi,69,1647,1279,368,28.77247849882721,morphological_dilation,3,2
0X3422556389DBC33C.avi,86,1186,866,320,36.95150115473441,morphological_dilation,3,2
0X342304BADF69D9F5.avi,68,1632,1264,368,29.11392405063291,morphological_dilation,3,2
0X342304BADF69D9F5.avi,87,1098,790,308,38.9873417721519,morphological_dilation,3,2
0X342642887C3B635A.avi,45,2195,1775,420,23.661971830985916,morphological_dilation,3,2
0X342642887C3B635A.avi,69,1870,1494,376,25.167336010709505,morphological_dilation,3,2
0X3427B817F8246DC0.avi,126,2027,1611,416,25.822470515207947,morphological_dilation,3,2
0X3427B817F8246DC0.avi,141,1235,907,328,36.163175303197356,morphological_dilation,3,2
0X342BECBDEC226B4B.avi,82,2821,2318,503,21.69974115616911,morphological_dilation,3,2
0X342BECBDEC226B4B.avi,100,1730,1321,409,30.96139288417865,morphological_dilation,3,2
0X342C33B7EFB51C1F.avi,50,1405,1049,356,33.93708293612965,morphological_dilation,3,2
0X342C33B7EFB51C1F.avi,66,799,517,282,54.54545454545454,morphological_dilation,3,2
0X34307A6B78240F3C.avi,41,1559,1167,392,33.59040274207369,morphological_dilation,3,2
0X34307A6B78240F3C.avi,55,935,627,308,49.122807017543856,morphological_dilation,3,2
0X34346DB8538E9C00.avi,83,2093,1689,404,23.919478981645945,morphological_dilation,3,2
0X34346DB8538E9C00.avi,99,1405,1061,344,32.42224316682375,morphological_dilation,3,2
0X34371B72F2CA944B.avi,34,3114,2606,508,19.493476592478896,morphological_dilation,3,2
0X34371B72F2CA944B.avi,50,2583,2115,468,22.127659574468083,morphological_dilation,3,2
0X343BE9ED06FDDBF.avi,116,2550,2070,480,23.18840579710145,morphological_dilation,3,2
0X343BE9ED06FDDBF.avi,139,1397,1041,356,34.197886647454375,morphological_dilation,3,2
0X343BF4FF40F55526.avi,51,2253,1785,468,26.218487394957986,morphological_dilation,3,2
0X343BF4FF40F55526.avi,65,1329,961,368,38.29344432882414,morphological_dilation,3,2
0X343CD94989ABD688.avi,78,2170,1738,432,24.856156501726122,morphological_dilation,3,2
0X343CD94989ABD688.avi,91,1335,983,352,35.8087487283825,morphological_dilation,3,2
0X343CEAA877051407.avi,34,1850,1466,384,26.193724420190996,morphological_dilation,3,2
0X343CEAA877051407.avi,43,1199,863,336,38.93395133256084,morphological_dilation,3,2
0X3440ECCBC0B8B0B8.avi,48,1405,1069,336,31.431244153414404,morphological_dilation,3,2
0X3440ECCBC0B8B0B8.avi,62,896,616,280,45.45454545454545,morphological_dilation,3,2
0X3446892185071673.avi,2,4663,4035,628,15.563816604708796,morphological_dilation,3,2
0X3446892185071673.avi,23,2733,2245,488,21.73719376391982,morphological_dilation,3,2
0X344A1BA4E101C1A3.avi,93,1813,1421,392,27.586206896551722,morphological_dilation,3,2
0X344A1BA4E101C1A3.avi,109,1275,939,336,35.78274760383386,morphological_dilation,3,2
0X344B9B92809DFB2.avi,134,1439,1095,344,31.41552511415525,morphological_dilation,3,2
0X344B9B92809DFB2.avi,152,996,700,296,42.285714285714285,morphological_dilation,3,2
0X3450FE8B316FA595.avi,57,1711,1323,388,29.327286470143616,morphological_dilation,3,2
0X3450FE8B316FA595.avi,78,1053,725,328,45.241379310344826,morphological_dilation,3,2
0X34517C9565F4887A.avi,94,1778,1390,388,27.913669064748202,morphological_dilation,3,2
0X34517C9565F4887A.avi,116,1168,836,332,39.71291866028708,morphological_dilation,3,2
0X3452E6F46D1EED03.avi,63,1511,1151,360,31.277150304083406,morphological_dilation,3,2
0X3452E6F46D1EED03.avi,77,1269,921,348,37.785016286644954,morphological_dilation,3,2
0X345C12B577CFF6AF.avi,46,2216,1804,412,22.838137472283815,morphological_dilation,3,2
0X345C12B577CFF6AF.avi,66,1445,1093,352,32.20494053064959,morphological_dilation,3,2
0X345D4E0B1B2EBAA1.avi,61,1120,796,324,40.7035175879397,morphological_dilation,3,2
0X345D4E0B1B2EBAA1.avi,75,515,273,242,88.64468864468864,morphological_dilation,3,2
0X346296E160818655.avi,3,1393,1043,350,33.557046979865774,morphological_dilation,3,2
0X346296E160818655.avi,16,817,533,284,53.283302063789876,morphological_dilation,3,2
0X34681486F5F5BA04.avi,49,1963,1571,392,24.95225970719287,morphological_dilation,3,2
0X34681486F5F5BA04.avi,68,1112,796,316,39.698492462311556,morphological_dilation,3,2
0X3468566357AA7782.avi,92,1644,1272,372,29.245283018867923,morphological_dilation,3,2
0X3468566357AA7782.avi,110,958,678,280,41.29793510324484,morphological_dilation,3,2
0X346A7A8994D823E6.avi,95,3099,2599,500,19.23816852635629,morphological_dilation,3,2
0X346A7A8994D823E6.avi,113,2320,1854,466,25.13484358144552,morphological_dilation,3,2
0X346C93EAA0D34D61.avi,105,1797,1421,376,26.460239268121043,morphological_dilation,3,2
0X346C93EAA0D34D61.avi,118,1489,1135,354,31.18942731277533,morphological_dilation,3,2
0X3473A41F60063EDA.avi,119,2097,1709,388,22.70333528379169,morphological_dilation,3,2
0X3473A41F60063EDA.avi,140,1813,1449,364,25.120772946859905,morphological_dilation,3,2
0X34741F168806C3CA.avi,77,2113,1682,431,25.62425683709869,morphological_dilation,3,2
0X34741F168806C3CA.avi,92,1276,960,316,32.916666666666664,morphological_dilation,3,2
0X3475D2DF28CA8EFA.avi,33,2392,1948,444,22.79260780287474,morphological_dilation,3,2
0X3475D2DF28CA8EFA.avi,49,2047,1643,404,24.589166159464394,morphological_dilation,3,2
0X347C08CBDD9C7630.avi,54,1551,1179,372,31.552162849872772,morphological_dilation,3,2
0X347C08CBDD9C7630.avi,71,921,613,308,50.24469820554649,morphological_dilation,3,2
0X348035818233D5AE.avi,85,3218,2714,504,18.570375829034635,morphological_dilation,3,2
0X348035818233D5AE.avi,103,2718,2230,488,21.883408071748878,morphological_dilation,3,2
0X3483EE5D8D715915.avi,103,1441,1085,356,32.8110599078341,morphological_dilation,3,2
0X3483EE5D8D715915.avi,120,1153,821,332,40.43848964677223,morphological_dilation,3,2
0X3485FF30A440873D.avi,44,2753,2285,468,20.48140043763676,morphological_dilation,3,2
0X3485FF30A440873D.avi,62,1777,1381,396,28.674873280231715,morphological_dilation,3,2
0X3486DE177009C0A7.avi,32,2798,2334,464,19.880034275921165,morphological_dilation,3,2
0X3486DE177009C0A7.avi,48,2484,2024,460,22.727272727272727,morphological_dilation,3,2
0X3488FD340222E032.avi,38,1568,1204,364,30.23255813953488,morphological_dilation,3,2
0X3488FD340222E032.avi,54,1015,715,300,41.95804195804196,morphological_dilation,3,2
0X348C1A7ED9165514.avi,28,1227,901,326,36.18201997780244,morphological_dilation,3,2
0X348C1A7ED9165514.avi,36,763,491,272,55.397148676171085,morphological_dilation,3,2
0X348C4CEA595CD540.avi,150,2105,1681,424,25.223081499107675,morphological_dilation,3,2
0X348C4CEA595CD540.avi,165,1239,899,340,37.81979977753059,morphological_dilation,3,2
0X3491A2D8671884AA.avi,86,1859,1463,396,27.06766917293233,morphological_dilation,3,2
0X3491A2D8671884AA.avi,101,1113,797,316,39.6486825595985,morphological_dilation,3,2
0X349290B231655FCF.avi,1,2017,1633,384,23.515003061849356,morphological_dilation,3,2
0X349290B231655FCF.avi,14,1519,1179,340,28.83799830364716,morphological_dilation,3,2
0X34937EEA012BAFAC.avi,45,1428,1072,356,33.2089552238806,morphological_dilation,3,2
0X34937EEA012BAFAC.avi,59,979,663,316,47.66214177978884,morphological_dilation,3,2
0X3496FC2940AE309C.avi,195,1531,1155,376,32.55411255411255,morphological_dilation,3,2
0X3496FC2940AE309C.avi,212,944,640,304,47.5,morphological_dilation,3,2
0X349B5DCF9294D081.avi,57,1774,1406,368,26.173541963015644,morphological_dilation,3,2
0X349B5DCF9294D081.avi,75,1102,786,316,40.20356234096692,morphological_dilation,3,2
0X34A2487BD238406D.avi,39,1750,1375,375,27.27272727272727,morphological_dilation,3,2
0X34A2487BD238406D.avi,55,1205,885,320,36.15819209039548,morphological_dilation,3,2
0X34A36626F45738E3.avi,2,3186,2662,524,19.684447783621337,morphological_dilation,3,2
0X34A36626F45738E3.avi,16,2232,1778,454,25.534308211473565,morphological_dilation,3,2
0X34A57B49B7505FF0.avi,89,1290,958,332,34.65553235908142,morphological_dilation,3,2
0X34A57B49B7505FF0.avi,104,762,502,260,51.79282868525896,morphological_dilation,3,2
0X34A86702D598B94.avi,0,1299,983,316,32.146490335707014,morphological_dilation,3,2
0X34A86702D598B94.avi,15,1098,806,292,36.22828784119106,morphological_dilation,3,2
0X34A9A9AC83DB199A.avi,28,1901,1517,384,25.313117996044827,morphological_dilation,3,2
0X34A9A9AC83DB199A.avi,41,1453,1117,336,30.08057296329454,morphological_dilation,3,2
0X34AFA7E543D8DB5B.avi,45,2470,2026,444,21.915103652517274,morphological_dilation,3,2
0X34AFA7E543D8DB5B.avi,65,1596,1240,356,28.70967741935484,morphological_dilation,3,2
0X34B0D3390808FB87.avi,56,1707,1347,360,26.7260579064588,morphological_dilation,3,2
0X34B0D3390808FB87.avi,73,1018,730,288,39.45205479452055,morphological_dilation,3,2
0X34B3A7DE20686478.avi,96,3004,2516,488,19.395866454689983,morphological_dilation,3,2
0X34B3A7DE20686478.avi,116,1874,1462,412,28.18057455540356,morphological_dilation,3,2
0X34B82B9BE9BD2A62.avi,50,1409,1057,352,33.30179754020814,morphological_dilation,3,2
0X34B82B9BE9BD2A62.avi,69,864,584,280,47.94520547945205,morphological_dilation,3,2
0X34BF7E5793966642.avi,64,1741,1377,364,26.434277414669573,morphological_dilation,3,2
0X34BF7E5793966642.avi,82,1142,834,308,36.930455635491604,morphological_dilation,3,2
0X34C0948C7AE2C568.avi,58,1956,1568,388,24.744897959183675,morphological_dilation,3,2
0X34C0948C7AE2C568.avi,73,1399,1067,332,31.115276476101215,morphological_dilation,3,2
0X34C0B1836A741427.avi,62,1162,830,332,40.0,morphological_dilation,3,2
0X34C0B1836A741427.avi,78,687,414,273,65.94202898550725,morphological_dilation,3,2
0X34C1E0788687F5F.avi,99,1518,1162,356,30.6368330464716,morphological_dilation,3,2
0X34C1E0788687F5F.avi,113,906,622,284,45.659163987138264,morphological_dilation,3,2
0X34C21BF64815FE24.avi,48,1747,1359,388,28.550404709345106,morphological_dilation,3,2
0X34C21BF64815FE24.avi,64,1328,980,348,35.51020408163265,morphological_dilation,3,2
0X34C28111C4C125E0.avi,39,1249,941,308,32.731137088204036,morphological_dilation,3,2
0X34C28111C4C125E0.avi,55,837,573,264,46.07329842931937,morphological_dilation,3,2
0X34C6D880282612DE.avi,6,1301,981,320,32.61977573904179,morphological_dilation,3,2
0X34C6D880282612DE.avi,20,1042,746,296,39.67828418230563,morphological_dilation,3,2
0X34C6E0BADBD81AF9.avi,49,2053,1638,415,25.335775335775335,morphological_dilation,3,2
0X34C6E0BADBD81AF9.avi,63,1431,1063,368,34.61900282220132,morphological_dilation,3,2
0X34D027E4D5B771F7.avi,48,1629,1273,356,27.965435978004717,morphological_dilation,3,2
0X34D027E4D5B771F7.avi,66,1112,792,320,40.4040404040404,morphological_dilation,3,2
0X34D68DB928DCDFD8.avi,53,2224,1772,452,25.5079006772009,morphological_dilation,3,2
0X34D68DB928DCDFD8.avi,66,1974,1538,436,28.348504551365412,morphological_dilation,3,2
0X34D6A77674B8E6F2.avi,83,1400,1056,344,32.57575757575758,morphological_dilation,3,2
0X34D6A77674B8E6F2.avi,97,890,625,265,42.4,morphological_dilation,3,2
0X34DFB8411A045F86.avi,167,1818,1414,404,28.57142857142857,morphological_dilation,3,2
0X34DFB8411A045F86.avi,184,1100,770,330,42.857142857142854,morphological_dilation,3,2
0X34E161E07008834A.avi,101,1947,1515,432,28.51485148514851,morphological_dilation,3,2
0X34E161E07008834A.avi,116,1208,856,352,41.1214953271028,morphological_dilation,3,2
0X34E300A9A15F96BB.avi,89,2326,1878,448,23.85516506922258,morphological_dilation,3,2
0X34E300A9A15F96BB.avi,105,1575,1203,372,30.92269326683292,morphological_dilation,3,2
0X34EB3569B7B1A4DA.avi,86,1447,1079,368,34.10565338276182,morphological_dilation,3,2
0X34EB3569B7B1A4DA.avi,99,817,545,272,49.908256880733944,morphological_dilation,3,2
0X34F1AECC373BB68E.avi,39,1650,1290,360,27.906976744186046,morphological_dilation,3,2
0X34F1AECC373BB68E.avi,51,988,692,296,42.77456647398844,morphological_dilation,3,2
0X34F2CEE849DC9CBF.avi,123,2419,1947,472,24.242424242424242,morphological_dilation,3,2
0X34F2CEE849DC9CBF.avi,139,1613,1212,401,33.085808580858085,morphological_dilation,3,2
0X34F41D6E5B689307.avi,56,1885,1485,400,26.936026936026934,morphological_dilation,3,2
0X34F41D6E5B689307.avi,71,1211,883,328,37.14609286523216,morphological_dilation,3,2
0X34F5DA86B3B45492.avi,123,1417,1085,332,30.599078341013826,morphological_dilation,3,2
0X34F5DA86B3B45492.avi,142,843,591,252,42.63959390862944,morphological_dilation,3,2
0X34F7CF2069479824.avi,32,2222,1806,416,23.034330011074196,morphological_dilation,3,2
0X34F7CF2069479824.avi,47,1939,1563,376,24.056301983365323,morphological_dilation,3,2
0X34FF0D4A53F3B1A7.avi,60,1518,1150,368,32.0,morphological_dilation,3,2
0X34FF0D4A53F3B1A7.avi,77,941,632,309,48.892405063291136,morphological_dilation,3,2
0X3500E28504F6F202.avi,48,1760,1392,368,26.436781609195403,morphological_dilation,3,2
0X3500E28504F6F202.avi,66,1144,852,292,34.27230046948357,morphological_dilation,3,2
0X3503A92D7637451.avi,44,1917,1501,416,27.71485676215856,morphological_dilation,3,2
0X3503A92D7637451.avi,61,1577,1196,381,31.8561872909699,morphological_dilation,3,2
0X35042F01545BC7FB.avi,86,1714,1354,360,26.587887740029544,morphological_dilation,3,2
0X35042F01545BC7FB.avi,103,1216,900,316,35.11111111111111,morphological_dilation,3,2
0X350970D6E6E3E907.avi,71,2010,1588,422,26.574307304785894,morphological_dilation,3,2
0X350970D6E6E3E907.avi,89,1270,914,356,38.949671772428886,morphological_dilation,3,2
0X350C03638EC233F6.avi,39,1934,1502,432,28.761651131824234,morphological_dilation,3,2
0X350C03638EC233F6.avi,54,1472,1080,392,36.2962962962963,morphological_dilation,3,2
0X350E5D4955052AFA.avi,43,2103,1699,404,23.77869334902884,morphological_dilation,3,2
0X350E5D4955052AFA.avi,62,1907,1523,384,25.21339461588969,morphological_dilation,3,2
0X350F6E738A333B5F.avi,155,1907,1515,392,25.874587458745875,morphological_dilation,3,2
0X350F6E738A333B5F.avi,175,1496,1132,364,32.15547703180212,morphological_dilation,3,2
0X3511A5055ECF66F0.avi,54,1470,1114,356,31.956912028725316,morphological_dilation,3,2
0X3511A5055ECF66F0.avi,73,849,577,272,47.14038128249567,morphological_dilation,3,2
0X35132DA02086E6C9.avi,100,2467,1984,483,24.344758064516128,morphological_dilation,3,2
0X35132DA02086E6C9.avi,121,1599,1205,394,32.697095435684645,morphological_dilation,3,2
0X3514BFDF02AF7035.avi,38,2920,2420,500,20.66115702479339,morphological_dilation,3,2
0X3514BFDF02AF7035.avi,55,2361,1921,440,22.90473711608537,morphological_dilation,3,2
0X3515B5074318C90A.avi,106,1174,844,330,39.09952606635071,morphological_dilation,3,2
0X3515B5074318C90A.avi,123,843,561,282,50.26737967914438,morphological_dilation,3,2
0X3517BDDF3F6BBF6.avi,34,2088,1688,400,23.696682464454977,morphological_dilation,3,2
0X3517BDDF3F6BBF6.avi,54,1178,850,328,38.588235294117645,morphological_dilation,3,2
0X351A2752679C0517.avi,76,3383,2839,544,19.16167664670659,morphological_dilation,3,2
0X351A2752679C0517.avi,95,2010,1566,444,28.35249042145594,morphological_dilation,3,2
0X351BBD25D2E2FD44.avi,96,3492,2936,556,18.93732970027248,morphological_dilation,3,2
0X351BBD25D2E2FD44.avi,120,2707,2219,488,21.99188823794502,morphological_dilation,3,2
0X351E0C8099E00647.avi,91,1755,1383,372,26.89804772234273,morphological_dilation,3,2
0X351E0C8099E00647.avi,104,1019,723,296,40.94052558782849,morphological_dilation,3,2
0X3524E64F44633A40.avi,41,1409,1057,352,33.30179754020814,morphological_dilation,3,2
0X3524E64F44633A40.avi,55,806,515,291,56.50485436893204,morphological_dilation,3,2
0X3527A0143356B7F5.avi,114,1611,1223,388,31.725265739983648,morphological_dilation,3,2
0X3527A0143356B7F5.avi,132,1177,861,316,36.70150987224158,morphological_dilation,3,2
0X352BAE1138127A5A.avi,149,1387,1051,336,31.969552806850622,morphological_dilation,3,2
0X352BAE1138127A5A.avi,161,858,594,264,44.44444444444444,morphological_dilation,3,2
0X352D7150FCBFA7C1.avi,46,1142,850,292,34.35294117647059,morphological_dilation,3,2
0X352D7150FCBFA7C1.avi,58,1362,1038,324,31.213872832369944,morphological_dilation,3,2
0X353238043903CF38.avi,84,1708,1320,388,29.393939393939394,morphological_dilation,3,2
0X353238043903CF38.avi,99,1031,735,296,40.27210884353741,morphological_dilation,3,2
0X3535658F5484B40F.avi,50,1451,1099,352,32.02911737943585,morphological_dilation,3,2
0X3535658F5484B40F.avi,62,879,595,284,47.73109243697479,morphological_dilation,3,2
0X353B18E085493A52.avi,34,1320,992,328,33.064516129032256,morphological_dilation,3,2
0X353B18E085493A52.avi,49,909,631,278,44.057052297939784,morphological_dilation,3,2
0X353EA59FF849AC98.avi,51,1349,1021,328,32.12536728697356,morphological_dilation,3,2
0X353EA59FF849AC98.avi,67,835,567,268,47.266313932980594,morphological_dilation,3,2
0X3545F8A008B34ED0.avi,58,1521,1161,360,31.007751937984494,morphological_dilation,3,2
0X3545F8A008B34ED0.avi,66,1019,708,311,43.92655367231638,morphological_dilation,3,2
0X3549E46B61BE286D.avi,129,1423,1064,359,33.7406015037594,morphological_dilation,3,2
0X3549E46B61BE286D.avi,144,938,654,284,43.425076452599384,morphological_dilation,3,2
0X354B37A25C64276F.avi,31,3599,2653,946,35.657745947983415,morphological_dilation,3,2
0X354B37A25C64276F.avi,38,3485,2709,776,28.645256552233295,morphological_dilation,3,2
0X354BA7E7B96988A6.avi,45,1808,1416,392,27.683615819209038,morphological_dilation,3,2
0X354BA7E7B96988A6.avi,62,1010,706,304,43.05949008498583,morphological_dilation,3,2
0X354F4B874AED071B.avi,166,2322,1898,424,22.339304531085354,morphological_dilation,3,2
0X354F4B874AED071B.avi,186,1435,1091,344,31.53070577451879,morphological_dilation,3,2
0X3555337FE7F02344.avi,83,1877,1497,380,25.384101536406146,morphological_dilation,3,2
0X3555337FE7F02344.avi,96,1609,1245,364,29.23694779116466,morphological_dilation,3,2
0X3559536AF7F794B5.avi,167,2167,1731,436,25.18775274407857,morphological_dilation,3,2
0X3559536AF7F794B5.avi,184,1344,988,356,36.032388663967616,morphological_dilation,3,2
0X355CFB6583C8DFAD.avi,37,1401,1073,328,30.568499534016773,morphological_dilation,3,2
0X355CFB6583C8DFAD.avi,51,851,583,268,45.96912521440824,morphological_dilation,3,2
0X35607DFD91E00F2B.avi,44,2489,1958,531,27.119509703779364,morphological_dilation,3,2
0X35607DFD91E00F2B.avi,60,1738,1191,547,45.927791771620484,morphological_dilation,3,2
0X3562C155F79822B7.avi,130,1219,899,320,35.595105672969964,morphological_dilation,3,2
0X3562C155F79822B7.avi,149,826,550,276,50.18181818181818,morphological_dilation,3,2
0X3562CBA08DC6E30F.avi,79,2736,2252,484,21.49200710479574,morphological_dilation,3,2
0X3562CBA08DC6E30F.avi,101,1606,1214,392,32.28995057660626,morphological_dilation,3,2
0X35656E25278C4CCC.avi,110,1567,1195,372,31.12970711297071,morphological_dilation,3,2
0X35656E25278C4CCC.avi,123,918,622,296,47.58842443729904,morphological_dilation,3,2
0X356662E85B788616.avi,42,1420,1064,356,33.45864661654135,morphological_dilation,3,2
0X356662E85B788616.avi,57,930,642,288,44.85981308411215,morphological_dilation,3,2
0X356731D116D6F9A0.avi,40,1611,1243,368,29.605792437650848,morphological_dilation,3,2
0X356731D116D6F9A0.avi,55,1082,766,316,41.253263707571804,morphological_dilation,3,2
0X3569758159E76E83.avi,151,2110,1718,392,22.81722933643772,morphological_dilation,3,2
0X3569758159E76E83.avi,174,1712,1352,360,26.627218934911244,morphological_dilation,3,2
0X356A6FCC675F2E7D.avi,2,1780,1397,383,27.415891195418755,morphological_dilation,3,2
0X356A6FCC675F2E7D.avi,18,1116,802,314,39.15211970074813,morphological_dilation,3,2
0X356CFAC4B58D6D04.avi,64,1789,1393,396,28.427853553481697,morphological_dilation,3,2
0X356CFAC4B58D6D04.avi,84,1126,794,332,41.81360201511335,morphological_dilation,3,2
0X35701918728819DC.avi,118,1621,1237,384,31.042845594179468,morphological_dilation,3,2
0X35701918728819DC.avi,138,1025,705,320,45.39007092198582,morphological_dilation,3,2
0X3571562B40FB6BF6.avi,37,1682,1298,384,29.583975346687215,morphological_dilation,3,2
0X3571562B40FB6BF6.avi,57,1012,712,300,42.13483146067416,morphological_dilation,3,2
0X3572B6AE5C661529.avi,20,2200,1768,432,24.43438914027149,morphological_dilation,3,2
0X3572B6AE5C661529.avi,30,1771,1399,372,26.590421729807005,morphological_dilation,3,2
0X3574D795ECA3735.avi,29,1374,1026,348,33.91812865497076,morphological_dilation,3,2
0X3574D795ECA3735.avi,43,866,574,292,50.87108013937283,morphological_dilation,3,2
0X357717818F4DA337.avi,5,1556,1184,372,31.41891891891892,morphological_dilation,3,2
0X357717818F4DA337.avi,24,1308,964,344,35.684647302904565,morphological_dilation,3,2
0X3579BDBD3E3E2AF3.avi,73,1097,805,292,36.27329192546584,morphological_dilation,3,2
0X3579BDBD3E3E2AF3.avi,87,690,450,240,53.333333333333336,morphological_dilation,3,2
0X357D90B1EE59CC94.avi,122,2703,2243,460,20.50824788230049,morphological_dilation,3,2
0X357D90B1EE59CC94.avi,161,1737,1371,366,26.695842450765866,morphological_dilation,3,2
0X3585426448E631FA.avi,35,1333,993,340,34.239677744209466,morphological_dilation,3,2
0X3585426448E631FA.avi,53,901,617,284,46.029173419773095,morphological_dilation,3,2
0X3587945D9CB88758.avi,131,2339,1915,424,22.140992167101828,morphological_dilation,3,2
0X3587945D9CB88758.avi,149,1541,1189,352,29.60470984020185,morphological_dilation,3,2
0X3587F21A9977747D.avi,59,1393,1033,360,34.84995159728945,morphological_dilation,3,2
0X3587F21A9977747D.avi,67,828,548,280,51.09489051094891,morphological_dilation,3,2
0X358A9CDF953254F2.avi,76,1784,1392,392,28.160919540229884,morphological_dilation,3,2
0X358A9CDF953254F2.avi,91,1305,962,343,35.65488565488565,morphological_dilation,3,2
0X358D5974FC807D32.avi,125,1756,1377,379,27.523602033405954,morphological_dilation,3,2
0X358D5974FC807D32.avi,143,1264,924,340,36.79653679653679,morphological_dilation,3,2
0X358EBA0C393EA18.avi,0,1684,1300,384,29.53846153846154,morphological_dilation,3,2
0X358EBA0C393EA18.avi,16,1024,712,312,43.82022471910113,morphological_dilation,3,2
0X3590CC9889D55995.avi,15,2262,1854,408,22.006472491909385,morphological_dilation,3,2
0X3590CC9889D55995.avi,28,1436,1094,342,31.26142595978062,morphological_dilation,3,2
0X35935529AAE83D83.avi,2,1616,1244,372,29.903536977491964,morphological_dilation,3,2
0X35935529AAE83D83.avi,12,1363,1027,336,32.716650438169424,morphological_dilation,3,2
0X35943DCDA257FB3F.avi,53,2602,2142,460,21.475256769374415,morphological_dilation,3,2
0X35943DCDA257FB3F.avi,71,1676,1292,384,29.721362229102166,morphological_dilation,3,2
0X35995BE8BB3A6D42.avi,2,1785,1425,360,25.263157894736842,morphological_dilation,3,2
0X35995BE8BB3A6D42.avi,21,1061,765,296,38.692810457516345,morphological_dilation,3,2
0X359C6A18604089D0.avi,59,915,635,280,44.09448818897638,morphological_dilation,3,2
0X359C6A18604089D0.avi,80,647,411,236,57.420924574209245,morphological_dilation,3,2
0X35A2E30EB9BB238F.avi,0,1885,1481,404,27.278865631330184,morphological_dilation,3,2
0X35A2E30EB9BB238F.avi,16,1129,821,308,37.51522533495737,morphological_dilation,3,2
0X35A57DE1135380CA.avi,87,1733,1353,380,28.085735402808577,morphological_dilation,3,2
0X35A57DE1135380CA.avi,105,970,682,288,42.22873900293255,morphological_dilation,3,2
0X35A5E9C9075E56EE.avi,44,1781,1174,607,51.70357751277683,morphological_dilation,3,2
0X35A5E9C9075E56EE.avi,91,1416,1024,392,38.28125,morphological_dilation,3,2
0X35A78A31D8EC3E08.avi,226,1838,1466,372,25.375170532060025,morphological_dilation,3,2
0X35A78A31D8EC3E08.avi,244,1334,1006,328,32.60437375745527,morphological_dilation,3,2
0X35AA6B2F5D6AEF85.avi,70,1634,1274,360,28.257456828885402,morphological_dilation,3,2
0X35AA6B2F5D6AEF85.avi,82,1047,747,300,40.16064257028113,morphological_dilation,3,2
0X35B6193459F647D0.avi,53,2049,1641,408,24.862888482632542,morphological_dilation,3,2
0X35B6193459F647D0.avi,73,1386,1050,336,32.0,morphological_dilation,3,2
0X35BC863BEC069E1E.avi,29,1724,1340,384,28.65671641791045,morphological_dilation,3,2
0X35BC863BEC069E1E.avi,42,1226,890,336,37.752808988764045,morphological_dilation,3,2
0X35C02A1D71E0F261.avi,95,1423,1093,330,30.19213174748399,morphological_dilation,3,2
0X35C02A1D71E0F261.avi,117,946,670,276,41.19402985074627,morphological_dilation,3,2
0X35CF87872963F067.avi,47,2835,2332,503,21.569468267581478,morphological_dilation,3,2
0X35CF87872963F067.avi,68,2068,1604,464,28.92768079800499,morphological_dilation,3,2
0X35D71675B11A8F12.avi,78,2806,2283,523,22.90845378887429,morphological_dilation,3,2
0X35D71675B11A8F12.avi,97,1648,1244,404,32.475884244372985,morphological_dilation,3,2
0X35DBF818D1E47758.avi,72,2272,1848,424,22.943722943722943,morphological_dilation,3,2
0X35DBF818D1E47758.avi,88,1387,1047,340,32.473734479465136,morphological_dilation,3,2
0X35DE4C4E8984305E.avi,2,1480,1124,356,31.672597864768683,morphological_dilation,3,2
0X35DE4C4E8984305E.avi,20,1038,710,328,46.19718309859155,morphological_dilation,3,2
0X35DE851D8AB0DF91.avi,36,1660,1284,376,29.283489096573206,morphological_dilation,3,2
0X35DE851D8AB0DF91.avi,57,1118,798,320,40.100250626566414,morphological_dilation,3,2
0X35DFFC5BC8995375.avi,51,2226,1815,411,22.644628099173552,morphological_dilation,3,2
0X35DFFC5BC8995375.avi,71,1405,1056,349,33.04924242424242,morphological_dilation,3,2
0X35ED1628AC7789FC.avi,107,2684,2208,476,21.557971014492754,morphological_dilation,3,2
0X35ED1628AC7789FC.avi,122,1732,1348,384,28.486646884272997,morphological_dilation,3,2
0X35F13DAF9D23F2E0.avi,49,1595,1227,368,29.991850040749796,morphological_dilation,3,2
0X35F13DAF9D23F2E0.avi,66,1157,841,316,37.5743162901308,morphological_dilation,3,2
0X35F221108BCA1A20.avi,45,2895,2371,524,22.10037958667229,morphological_dilation,3,2
0X35F221108BCA1A20.avi,59,1676,1272,404,31.761006289308174,morphological_dilation,3,2
0X35F5B1F089772D09.avi,77,1905,1517,388,25.576796308503624,morphological_dilation,3,2
0X35F5B1F089772D09.avi,90,1260,948,312,32.91139240506329,morphological_dilation,3,2
0X35FEF9072E3537BB.avi,182,2132,1676,456,27.20763723150358,morphological_dilation,3,2
0X35FEF9072E3537BB.avi,200,1397,1013,384,37.90720631786772,morphological_dilation,3,2
0X3600E5DB8324B05C.avi,43,1064,772,292,37.82383419689119,morphological_dilation,3,2
0X3600E5DB8324B05C.avi,65,740,496,244,49.193548387096776,morphological_dilation,3,2
0X36029F349497FD71.avi,72,2028,1620,408,25.185185185185183,morphological_dilation,3,2
0X36029F349497FD71.avi,88,1348,1004,344,34.26294820717131,morphological_dilation,3,2
0X3606D9A467E6CE63.avi,39,1519,1167,352,30.162810625535563,morphological_dilation,3,2
0X3606D9A467E6CE63.avi,54,1079,775,304,39.225806451612904,morphological_dilation,3,2
0X3619CA422F4061D1.avi,54,1845,1445,400,27.68166089965398,morphological_dilation,3,2
0X3619CA422F4061D1.avi,70,1136,820,316,38.53658536585366,morphological_dilation,3,2
0X3619FBB48260A469.avi,51,1805,1409,396,28.105039034776436,morphological_dilation,3,2
0X3619FBB48260A469.avi,71,1144,824,320,38.83495145631068,morphological_dilation,3,2
0X361BB885534EDDC4.avi,56,1487,1124,363,32.295373665480426,morphological_dilation,3,2
0X361BB885534EDDC4.avi,75,903,596,307,51.51006711409396,morphological_dilation,3,2
0X361CC0F1626A8FC6.avi,78,1551,1191,360,30.22670025188917,morphological_dilation,3,2
0X361CC0F1626A8FC6.avi,93,897,605,292,48.264462809917354,morphological_dilation,3,2
0X361DB800810D49EC.avi,143,2493,2049,444,21.669106881405565,morphological_dilation,3,2
0X361DB800810D49EC.avi,164,1512,1148,364,31.70731707317073,morphological_dilation,3,2
0X36212648EAFF0B89.avi,1,1120,796,324,40.7035175879397,morphological_dilation,3,2
0X36212648EAFF0B89.avi,13,855,567,288,50.79365079365079,morphological_dilation,3,2
0X36225F52C1D2A015.avi,4,1579,1191,388,32.57766582703611,morphological_dilation,3,2
0X36225F52C1D2A015.avi,22,1349,983,366,37.23296032553408,morphological_dilation,3,2
0X36250F8B6C5C2DCD.avi,57,1137,833,304,36.49459783913566,morphological_dilation,3,2
0X36250F8B6C5C2DCD.avi,71,688,437,251,57.43707093821511,morphological_dilation,3,2
0X36273BA043E4849E.avi,35,2643,2147,496,23.102002794597112,morphological_dilation,3,2
0X36273BA043E4849E.avi,47,1475,1065,410,38.497652582159624,morphological_dilation,3,2
0X362AF0DB0ECE89E9.avi,65,2167,1727,440,25.477707006369428,morphological_dilation,3,2
0X362AF0DB0ECE89E9.avi,77,1598,1206,392,32.50414593698176,morphological_dilation,3,2
0X362FD3C18A57E4AC.avi,0,2054,1638,416,25.396825396825395,morphological_dilation,3,2
0X362FD3C18A57E4AC.avi,19,1156,840,316,37.61904761904762,morphological_dilation,3,2
0X363F29275ABC04D0.avi,52,1832,1456,376,25.82417582417583,morphological_dilation,3,2
0X363F29275ABC04D0.avi,71,1199,879,320,36.40500568828214,morphological_dilation,3,2
0X3641C89EB2887277.avi,104,1419,1099,320,29.117379435850772,morphological_dilation,3,2
0X3641C89EB2887277.avi,123,850,586,264,45.051194539249146,morphological_dilation,3,2
0X3649FD731DF1B5B2.avi,50,865,585,280,47.863247863247864,morphological_dilation,3,2
0X3649FD731DF1B5B2.avi,68,645,392,253,64.54081632653062,morphological_dilation,3,2
0X364A30E94BB38C.avi,0,3173,2653,520,19.60045231813042,morphological_dilation,3,2
0X364A30E94BB38C.avi,18,1857,1437,420,29.227557411273487,morphological_dilation,3,2
0X364DAFDC16D92240.avi,90,1673,1307,366,28.003060443764344,morphological_dilation,3,2
0X364DAFDC16D92240.avi,107,1527,1191,336,28.211586901763226,morphological_dilation,3,2
0X3651598B0EB0AE89.avi,43,1831,1455,376,25.841924398625434,morphological_dilation,3,2
0X3651598B0EB0AE89.avi,58,1550,1198,352,29.382303839732888,morphological_dilation,3,2
0X36558A226D3C4158.avi,100,3590,3050,540,17.704918032786885,morphological_dilation,3,2
0X36558A226D3C4158.avi,117,2168,1728,440,25.462962962962965,morphological_dilation,3,2
0X36560A1C88E0899A.avi,99,2883,2383,500,20.9819555182543,morphological_dilation,3,2
0X36560A1C88E0899A.avi,120,2025,1573,452,28.73490146217419,morphological_dilation,3,2
0X365705882E795EBB.avi,74,1427,1081,346,32.00740055504163,morphological_dilation,3,2
0X365705882E795EBB.avi,91,1037,737,300,40.70556309362279,morphological_dilation,3,2
0X3658AEF1BA5BFF33.avi,31,3135,2615,520,19.88527724665392,morphological_dilation,3,2
0X3658AEF1BA5BFF33.avi,48,1784,1346,438,32.5408618127786,morphological_dilation,3,2
0X3659F7222EFAEE84.avi,61,1965,1565,400,25.559105431309902,morphological_dilation,3,2
0X3659F7222EFAEE84.avi,81,1305,973,332,34.1212744090442,morphological_dilation,3,2
0X365B2E9FB5F6E9A0.avi,70,2504,2056,448,21.78988326848249,morphological_dilation,3,2
0X365B2E9FB5F6E9A0.avi,87,2161,1757,404,22.993739328400682,morphological_dilation,3,2
0X365CD11BB171403B.avi,36,1258,938,320,34.11513859275053,morphological_dilation,3,2
0X365CD11BB171403B.avi,50,884,616,268,43.506493506493506,morphological_dilation,3,2
0X365F36B9859AED91.avi,63,1617,1245,372,29.87951807228916,morphological_dilation,3,2
0X365F36B9859AED91.avi,75,1070,766,304,39.686684073107045,morphological_dilation,3,2
0X3662921D976FA535.avi,83,1247,924,323,34.95670995670996,morphological_dilation,3,2
0X3662921D976FA535.avi,102,766,517,249,48.16247582205029,morphological_dilation,3,2
0X3664FA96FA937A15.avi,0,1980,1568,412,26.27551020408163,morphological_dilation,3,2
0X3664FA96FA937A15.avi,15,1221,868,353,40.668202764976954,morphological_dilation,3,2
0X3668D2C590A028AD.avi,71,2754,2262,492,21.750663129973475,morphological_dilation,3,2
0X3668D2C590A028AD.avi,88,1728,1316,412,31.30699088145897,morphological_dilation,3,2
0X36694614F119F8BF.avi,112,2249,1805,444,24.598337950138504,morphological_dilation,3,2
0X36694614F119F8BF.avi,128,1489,1141,348,30.499561787905343,morphological_dilation,3,2
0X366AD377E4A81FBE.avi,3,1515,1092,423,38.73626373626374,morphological_dilation,3,2
0X366AD377E4A81FBE.avi,51,1524,1184,340,28.716216216216218,morphological_dilation,3,2
0X366D3126835759B6.avi,97,1689,1305,384,29.42528735632184,morphological_dilation,3,2
0X366D3126835759B6.avi,112,1136,812,324,39.90147783251231,morphological_dilation,3,2
0X367085DDC2E90657.avi,58,1897,1501,396,26.382411725516324,morphological_dilation,3,2
0X367085DDC2E90657.avi,114,1971,1388,583,42.002881844380404,morphological_dilation,3,2
0X36715FD73D74BF39.avi,93,3307,2787,520,18.65805525654826,morphological_dilation,3,2
0X36715FD73D74BF39.avi,108,2556,2096,460,21.946564885496183,morphological_dilation,3,2
0X3677ED237A9338F4.avi,47,1670,1298,372,28.65947611710323,morphological_dilation,3,2
0X3677ED237A9338F4.avi,64,1048,748,300,40.106951871657756,morphological_dilation,3,2
0X3679A40BE82295C8.avi,50,5181,4517,664,14.700022138587556,morphological_dilation,3,2
0X3679A40BE82295C8.avi,63,3223,2655,568,21.393596986817325,morphological_dilation,3,2
0X367B540BD67522AF.avi,74,1180,876,304,34.70319634703196,morphological_dilation,3,2
0X367B540BD67522AF.avi,87,641,410,231,56.34146341463414,morphological_dilation,3,2
0X367CFA84878244FA.avi,82,1499,1135,364,32.0704845814978,morphological_dilation,3,2
0X367CFA84878244FA.avi,93,859,575,284,49.391304347826086,morphological_dilation,3,2
0X367EF3C5E490D06D.avi,81,1502,1166,336,28.81646655231561,morphological_dilation,3,2
0X367EF3C5E490D06D.avi,99,930,658,272,41.33738601823708,morphological_dilation,3,2
0X3680802CE73F0111.avi,137,2424,1992,432,21.686746987951807,morphological_dilation,3,2
0X3680802CE73F0111.avi,163,2024,1607,417,25.94897324206596,morphological_dilation,3,2
0X36820DBFCD583F25.avi,63,2015,1607,408,25.3889234598631,morphological_dilation,3,2
0X36820DBFCD583F25.avi,84,1310,982,328,33.401221995926676,morphological_dilation,3,2
0X36843785539A004C.avi,103,2380,1948,432,22.176591375770023,morphological_dilation,3,2
0X36843785539A004C.avi,122,2743,2275,468,20.57142857142857,morphological_dilation,3,2
0X36854BD13E2D4031.avi,71,1459,1115,344,30.852017937219735,morphological_dilation,3,2
0X36854BD13E2D4031.avi,82,979,695,284,40.86330935251799,morphological_dilation,3,2
0X36855520AF004067.avi,120,2698,2210,488,22.081447963800905,morphological_dilation,3,2
0X36855520AF004067.avi,137,1783,1371,412,30.051057622173595,morphological_dilation,3,2
0X368A36C92FFEC550.avi,52,2747,2252,495,21.98046181172291,morphological_dilation,3,2
0X368A36C92FFEC550.avi,71,1539,1155,384,33.246753246753244,morphological_dilation,3,2
0X368C8C18EE91FFC2.avi,160,1375,1045,330,31.57894736842105,morphological_dilation,3,2
0X368C8C18EE91FFC2.avi,173,776,528,248,46.96969696969697,morphological_dilation,3,2
0X368E8CE3FB0A3F96.avi,79,2057,1657,400,24.140012070006033,morphological_dilation,3,2
0X368E8CE3FB0A3F96.avi,102,1491,1145,346,30.21834061135371,morphological_dilation,3,2
0X368FA2713959D710.avi,35,1978,1538,440,28.608582574772434,morphological_dilation,3,2
0X368FA2713959D710.avi,44,1182,818,364,44.49877750611247,morphological_dilation,3,2
0X369097280CAAF1E6.avi,52,3183,2687,496,18.459248232229253,morphological_dilation,3,2
0X369097280CAAF1E6.avi,76,2223,1779,444,24.957841483979763,morphological_dilation,3,2
0X3690E1CA5E40ABD6.avi,48,791,543,248,45.67219152854512,morphological_dilation,3,2
0X3690E1CA5E40ABD6.avi,65,449,249,200,80.32128514056225,morphological_dilation,3,2
0X3693781992586497.avi,39,3911,3109,802,25.7960759086523,morphological_dilation,3,2
0X3693781992586497.avi,47,3629,2937,692,23.56145726932244,morphological_dilation,3,2
0X3693F13626B9A3E1.avi,49,1349,1021,328,32.12536728697356,morphological_dilation,3,2
0X3693F13626B9A3E1.avi,69,998,718,280,38.99721448467967,morphological_dilation,3,2
0X3694A8837AC5F707.avi,103,1447,1091,356,32.630614115490374,morphological_dilation,3,2
0X3694A8837AC5F707.avi,120,836,566,270,47.70318021201413,morphological_dilation,3,2
0X3697C1B485A4B66C.avi,79,1955,1547,408,26.373626373626376,morphological_dilation,3,2
0X3697C1B485A4B66C.avi,98,1388,1034,354,34.23597678916828,morphological_dilation,3,2
0X36980E4A755BAB70.avi,104,1967,1579,388,24.572514249525014,morphological_dilation,3,2
0X36980E4A755BAB70.avi,118,1633,1265,368,29.09090909090909,morphological_dilation,3,2
0X369B8F063DDD3DDE.avi,17,1780,1400,380,27.142857142857142,morphological_dilation,3,2
0X369B8F063DDD3DDE.avi,31,1493,1123,370,32.94746215494212,morphological_dilation,3,2
0X369D9859BEDE11F6.avi,42,1430,1091,339,31.072410632447294,morphological_dilation,3,2
0X369D9859BEDE11F6.avi,58,955,667,288,43.1784107946027,morphological_dilation,3,2
0X369F4745D75C926A.avi,153,1506,1146,360,31.413612565445025,morphological_dilation,3,2
0X369F4745D75C926A.avi,174,864,584,280,47.94520547945205,morphological_dilation,3,2
0X36A70C2755257C5F.avi,135,1309,981,328,33.43527013251784,morphological_dilation,3,2
0X36A70C2755257C5F.avi,153,851,579,272,46.97754749568221,morphological_dilation,3,2
0X36AD89AAE3FAF892.avi,3,1329,1001,328,32.76723276723277,morphological_dilation,3,2
0X36AD89AAE3FAF892.avi,20,870,594,276,46.464646464646464,morphological_dilation,3,2
0X36ADC50A0EA70B99.avi,0,1722,1342,380,28.315946348733235,morphological_dilation,3,2
0X36ADC50A0EA70B99.avi,17,1056,748,308,41.17647058823529,morphological_dilation,3,2
0X36AE471FEC81D0F8.avi,81,2199,1779,420,23.608768971332207,morphological_dilation,3,2
0X36AE471FEC81D0F8.avi,96,1408,1056,352,33.33333333333333,morphological_dilation,3,2
0X36AEAF74B90CDBD4.avi,45,2693,2213,480,21.69001355625847,morphological_dilation,3,2
0X36AEAF74B90CDBD4.avi,60,1709,1321,388,29.371688115064345,morphological_dilation,3,2
0X36AEF23E46307423.avi,88,2418,1970,448,22.741116751269036,morphological_dilation,3,2
0X36AEF23E46307423.avi,106,1423,1059,364,34.372049102927285,morphological_dilation,3,2
0X36B24AE5ABCC6260.avi,106,1466,1122,344,30.65953654188948,morphological_dilation,3,2
0X36B24AE5ABCC6260.avi,124,903,623,280,44.9438202247191,morphological_dilation,3,2
0X36B33D2B6530F83E.avi,106,1250,938,312,33.26226012793177,morphological_dilation,3,2
0X36B33D2B6530F83E.avi,121,806,538,268,49.814126394052046,morphological_dilation,3,2
0X36B356D92C89CA77.avi,3,1680,1300,380,29.230769230769234,morphological_dilation,3,2
0X36B356D92C89CA77.avi,14,1168,828,340,41.06280193236715,morphological_dilation,3,2
0X36B5FD2DD0218534.avi,61,2129,1689,440,26.050917702782712,morphological_dilation,3,2
0X36B5FD2DD0218534.avi,77,1265,901,364,40.399556048834626,morphological_dilation,3,2
0X36B7933826909A38.avi,59,1614,1238,376,30.37156704361874,morphological_dilation,3,2
0X36B7933826909A38.avi,78,1053,741,312,42.10526315789473,morphological_dilation,3,2
0X36B7C4AB8CD4B69E.avi,45,1593,1202,391,32.529118136439266,morphological_dilation,3,2
0X36B7C4AB8CD4B69E.avi,62,1085,736,349,47.41847826086957,morphological_dilation,3,2
0X36BC020D616A1C3E.avi,69,1964,1556,408,26.221079691516707,morphological_dilation,3,2
0X36BC020D616A1C3E.avi,90,1157,831,326,39.229843561973524,morphological_dilation,3,2
0X36BC2C060ED9295.avi,78,2051,1627,424,26.06023355869699,morphological_dilation,3,2
0X36BC2C060ED9295.avi,100,1312,972,340,34.97942386831276,morphological_dilation,3,2
0X36BD144912D456D8.avi,122,1824,1428,396,27.73109243697479,morphological_dilation,3,2
0X36BD144912D456D8.avi,140,1199,871,328,37.65786452353617,morphological_dilation,3,2
0X36BD2518C9D15985.avi,34,2862,2370,492,20.759493670886076,morphological_dilation,3,2
0X36BD2518C9D15985.avi,50,2577,2113,464,21.959299574065312,morphological_dilation,3,2
0X36C24B4CC763F804.avi,40,3214,2686,528,19.65748324646314,morphological_dilation,3,2
0X36C24B4CC763F804.avi,60,2251,1799,452,25.125069483046136,morphological_dilation,3,2
0X36C3A242D0282A79.avi,45,1593,1229,364,29.617575264442635,morphological_dilation,3,2
0X36C3A242D0282A79.avi,65,944,636,308,48.42767295597484,morphological_dilation,3,2
0X36C4E7ECAA2BCBD9.avi,37,1598,1246,352,28.25040128410915,morphological_dilation,3,2
0X36C4E7ECAA2BCBD9.avi,48,1121,817,304,37.2093023255814,morphological_dilation,3,2
0X36C5A15AC7FC6AAA.avi,58,1467,1123,344,30.632235084594832,morphological_dilation,3,2
0X36C5A15AC7FC6AAA.avi,74,1853,1399,454,32.451751250893494,morphological_dilation,3,2
0X36C5DE35959702C2.avi,168,2188,1732,456,26.32794457274827,morphological_dilation,3,2
0X36C5DE35959702C2.avi,185,1344,984,360,36.58536585365854,morphological_dilation,3,2
0X36C8D17C4AA7C806.avi,40,1535,1191,344,28.883291351805205,morphological_dilation,3,2
0X36C8D17C4AA7C806.avi,57,1003,711,292,41.068917018284104,morphological_dilation,3,2
0X36CCD2D8878BA51D.avi,85,1621,1257,364,28.957836117740655,morphological_dilation,3,2
0X36CCD2D8878BA51D.avi,98,1031,727,304,41.81568088033013,morphological_dilation,3,2
0X36CFD828F214D7F6.avi,51,1692,1285,407,31.67315175097276,morphological_dilation,3,2
0X36CFD828F214D7F6.avi,65,1043,704,339,48.153409090909086,morphological_dilation,3,2
0X36D558075BB74018.avi,2,1881,1501,380,25.31645569620253,morphological_dilation,3,2
0X36D558075BB74018.avi,19,1344,1016,328,32.28346456692913,morphological_dilation,3,2
0X36D59A17CA2C77AE.avi,119,3105,2601,504,19.377162629757784,morphological_dilation,3,2
0X36D59A17CA2C77AE.avi,143,2005,1605,400,24.922118380062305,morphological_dilation,3,2
0X36DF7F18D6224D8E.avi,130,1467,1125,342,30.4,morphological_dilation,3,2
0X36DF7F18D6224D8E.avi,143,992,696,296,42.5287356321839,morphological_dilation,3,2
0X36DFB3273B20DF4B.avi,102,1487,1123,364,32.41317898486198,morphological_dilation,3,2
0X36DFB3273B20DF4B.avi,110,963,655,308,47.02290076335878,morphological_dilation,3,2
0X36E1B0D2F55F5083.avi,4,1561,1197,364,30.409356725146196,morphological_dilation,3,2
0X36E1B0D2F55F5083.avi,21,1023,699,324,46.3519313304721,morphological_dilation,3,2
0X36E1F0560F36E313.avi,119,1779,1395,384,27.526881720430108,morphological_dilation,3,2
0X36E1F0560F36E313.avi,140,1423,1067,356,33.364573570759134,morphological_dilation,3,2
0X36E4468C9E659B89.avi,2,2282,1862,420,22.55639097744361,morphological_dilation,3,2
0X36E4468C9E659B89.avi,21,1626,1274,352,27.629513343799054,morphological_dilation,3,2
0X36E57BE2B11E4E3E.avi,116,3028,2508,520,20.73365231259968,morphological_dilation,3,2
0X36E57BE2B11E4E3E.avi,128,1911,1463,448,30.62200956937799,morphological_dilation,3,2
0X36E731545F69ECDC.avi,66,1475,1135,340,29.955947136563875,morphological_dilation,3,2
0X36E731545F69ECDC.avi,82,928,656,272,41.46341463414634,morphological_dilation,3,2
0X36EAF76B49E25D66.avi,32,1297,973,324,33.29907502569373,morphological_dilation,3,2
0X36EAF76B49E25D66.avi,43,758,478,280,58.57740585774059,morphological_dilation,3,2
0X36F52C92187D7452.avi,33,1100,808,292,36.13861386138614,morphological_dilation,3,2
0X36F52C92187D7452.avi,47,777,533,244,45.77861163227016,morphological_dilation,3,2
0X36F9A84314FD103C.avi,73,2216,1796,420,23.385300668151448,morphological_dilation,3,2
0X36F9A84314FD103C.avi,94,1482,1140,342,30.0,morphological_dilation,3,2
0X36FB42EDBD9C3623.avi,82,1508,1152,356,30.90277777777778,morphological_dilation,3,2
0X36FB42EDBD9C3623.avi,95,999,695,304,43.7410071942446,morphological_dilation,3,2
0X370587577A29EA9.avi,69,2460,2008,452,22.50996015936255,morphological_dilation,3,2
0X370587577A29EA9.avi,90,1649,1269,380,29.944838455476752,morphological_dilation,3,2
0X37065F92C8742D4B.avi,47,2088,1684,404,23.990498812351543,morphological_dilation,3,2
0X37065F92C8742D4B.avi,62,1248,916,332,36.24454148471616,morphological_dilation,3,2
0X3706CECB0D52DB89.avi,32,1123,827,296,35.79201934703748,morphological_dilation,3,2
0X3706CECB0D52DB89.avi,44,767,512,255,49.8046875,morphological_dilation,3,2
0X370BFF01AB719E61.avi,114,2183,1755,428,24.387464387464387,morphological_dilation,3,2
0X370BFF01AB719E61.avi,132,1323,991,332,33.501513622603426,morphological_dilation,3,2
0X371AEF210253C983.avi,36,2832,2368,464,19.594594594594593,morphological_dilation,3,2
0X371AEF210253C983.avi,49,2386,1966,420,21.363173957273652,morphological_dilation,3,2
0X3721BAB9BF06CE82.avi,45,1871,1467,404,27.539195637355146,morphological_dilation,3,2
0X3721BAB9BF06CE82.avi,61,1259,915,344,37.595628415300546,morphological_dilation,3,2
0X3723344573E75E5.avi,88,1492,1152,340,29.51388888888889,morphological_dilation,3,2
0X3723344573E75E5.avi,104,1089,805,284,35.27950310559006,morphological_dilation,3,2
0X3725F884E49C387C.avi,53,2665,2182,483,22.13565536205316,morphological_dilation,3,2
0X3725F884E49C387C.avi,74,1756,1364,392,28.739002932551323,morphological_dilation,3,2
0X3729DC43901DD07A.avi,53,2890,2368,522,22.04391891891892,morphological_dilation,3,2
0X3729DC43901DD07A.avi,75,1716,1292,424,32.81733746130031,morphological_dilation,3,2
0X37307937DDFA46A9.avi,44,4969,4313,656,15.209830744261534,morphological_dilation,3,2
0X37307937DDFA46A9.avi,61,2756,2268,488,21.516754850088184,morphological_dilation,3,2
0X3732593549EE8E29.avi,121,1860,1464,396,27.049180327868854,morphological_dilation,3,2
0X3732593549EE8E29.avi,140,1159,831,328,39.4705174488568,morphological_dilation,3,2
0X374099556945A9EA.avi,121,6073,5611,462,8.233826412404206,morphological_dilation,3,2
0X374099556945A9EA.avi,132,4498,3878,620,15.987622485817433,morphological_dilation,3,2
0X3748E23FFEA283C6.avi,114,1816,1432,384,26.81564245810056,morphological_dilation,3,2
0X3748E23FFEA283C6.avi,129,1509,1153,356,30.875975715524717,morphological_dilation,3,2
0X3752924AB02EDDE6.avi,88,2182,1754,428,24.401368301026224,morphological_dilation,3,2
0X3752924AB02EDDE6.avi,106,1612,1240,372,30.0,morphological_dilation,3,2
0X3754A0841B209E31.avi,185,2447,2003,444,22.166749875187218,morphological_dilation,3,2
0X3754A0841B209E31.avi,202,1488,1142,346,30.297723292469353,morphological_dilation,3,2
0X37580FDB4D1D140.avi,41,2272,1836,436,23.74727668845316,morphological_dilation,3,2
0X37580FDB4D1D140.avi,56,1185,861,324,37.63066202090592,morphological_dilation,3,2
0X375A84A3AAC32C67.avi,40,2225,1817,408,22.45459548706659,morphological_dilation,3,2
0X375A84A3AAC32C67.avi,59,1620,1268,352,27.760252365930597,morphological_dilation,3,2
0X37671D9D80CCE804.avi,3,2134,1696,438,25.825471698113205,morphological_dilation,3,2
0X37671D9D80CCE804.avi,15,1453,1093,360,32.93687099725526,morphological_dilation,3,2
0X376C845E9F31E90D.avi,16,1156,828,328,39.61352657004831,morphological_dilation,3,2
0X376C845E9F31E90D.avi,38,2210,1778,432,24.296962879640045,morphological_dilation,3,2
0X3771953B5331C326.avi,120,3698,3147,551,17.508738481093104,morphological_dilation,3,2
0X3771953B5331C326.avi,145,2355,1915,440,22.97650130548303,morphological_dilation,3,2
0X3774A913EC0A4ED0.avi,4,1784,1392,392,28.160919540229884,morphological_dilation,3,2
0X3774A913EC0A4ED0.avi,19,1013,713,300,42.07573632538569,morphological_dilation,3,2
0X37761C666D82804F.avi,55,1928,1504,424,28.191489361702125,morphological_dilation,3,2
0X37761C666D82804F.avi,72,1244,876,368,42.00913242009132,morphological_dilation,3,2
0X377A054F49B13FAE.avi,81,1333,1013,320,31.589338598223097,morphological_dilation,3,2
0X377A054F49B13FAE.avi,101,868,608,260,42.76315789473684,morphological_dilation,3,2
0X377F8EF0A95F368.avi,30,1378,1038,340,32.75529865125241,morphological_dilation,3,2
0X377F8EF0A95F368.avi,42,943,671,272,40.536512667660205,morphological_dilation,3,2
0X378127302CF37356.avi,34,1419,1063,356,33.49012229539041,morphological_dilation,3,2
0X378127302CF37356.avi,48,928,612,316,51.633986928104584,morphological_dilation,3,2
0X378691AE5C1F4D1.avi,47,1704,1332,372,27.927927927927925,morphological_dilation,3,2
0X378691AE5C1F4D1.avi,63,1027,739,288,38.971583220568334,morphological_dilation,3,2
0X378710053D7ED204.avi,88,1544,1188,356,29.96632996632997,morphological_dilation,3,2
0X378710053D7ED204.avi,108,965,681,284,41.70337738619677,morphological_dilation,3,2
0X378B60986C2959FC.avi,98,1526,1178,348,29.541595925297116,morphological_dilation,3,2
0X378B60986C2959FC.avi,116,922,642,280,43.613707165109034,morphological_dilation,3,2
0X378B99020DEA60BA.avi,61,2192,1760,432,24.545454545454547,morphological_dilation,3,2
0X378B99020DEA60BA.avi,81,1776,1388,388,27.953890489913547,morphological_dilation,3,2
0X378C9BDA702A27CE.avi,61,1572,1204,368,30.564784053156146,morphological_dilation,3,2
0X378C9BDA702A27CE.avi,77,1030,726,304,41.8732782369146,morphological_dilation,3,2
0X378E08181E0B8BAA.avi,0,3158,2634,524,19.893697798025816,morphological_dilation,3,2
0X378E08181E0B8BAA.avi,17,2500,2040,460,22.54901960784314,morphological_dilation,3,2
0X378F03AA6A00CE87.avi,44,2290,1850,440,23.783783783783786,morphological_dilation,3,2
0X378F03AA6A00CE87.avi,63,1411,1067,344,32.239925023430175,morphological_dilation,3,2
0X3790431EBFD08B20.avi,99,2291,1827,464,25.396825396825395,morphological_dilation,3,2
0X3790431EBFD08B20.avi,113,1407,1015,392,38.62068965517241,morphological_dilation,3,2
0X379177330C90F7EA.avi,45,2675,2207,468,21.205256003624832,morphological_dilation,3,2
0X379177330C90F7EA.avi,66,1975,1563,412,26.35956493921945,morphological_dilation,3,2
0X3793C26A31FEFF54.avi,37,2250,1814,436,24.035281146637267,morphological_dilation,3,2
0X3793C26A31FEFF54.avi,54,1431,1080,351,32.5,morphological_dilation,3,2
0X379702FD21B373CE.avi,80,1879,1447,432,29.854872149274357,morphological_dilation,3,2
0X379702FD21B373CE.avi,89,1109,773,336,43.46701164294955,morphological_dilation,3,2
0X379A4AF7F8D17ACB.avi,42,2495,2027,468,23.088307844104587,morphological_dilation,3,2
0X379A4AF7F8D17ACB.avi,54,1679,1263,416,32.937450514647665,morphological_dilation,3,2
0X379CA9FEA4B8D934.avi,108,1001,709,292,41.18476727785614,morphological_dilation,3,2
0X379CA9FEA4B8D934.avi,118,603,375,228,60.8,morphological_dilation,3,2
0X379D5D1F9907784D.avi,49,1812,1432,380,26.536312849162012,morphological_dilation,3,2
0X379D5D1F9907784D.avi,64,1326,1002,324,32.33532934131736,morphological_dilation,3,2
0X379DAAC5FF13821B.avi,56,1697,1341,356,26.547352721849364,morphological_dilation,3,2
0X379DAAC5FF13821B.avi,72,1115,807,308,38.166047087980175,morphological_dilation,3,2
0X37AA5019490DE956.avi,84,1272,968,304,31.40495867768595,morphological_dilation,3,2
0X37AA5019490DE956.avi,104,974,706,268,37.960339943342774,morphological_dilation,3,2
0X37AA7B612514A839.avi,43,1403,1043,360,34.51581975071908,morphological_dilation,3,2
0X37AA7B612514A839.avi,56,831,558,273,48.924731182795696,morphological_dilation,3,2
0X37B267E780801BBA.avi,95,1395,1039,356,34.26371511068335,morphological_dilation,3,2
0X37B267E780801BBA.avi,108,853,569,284,49.91212653778559,morphological_dilation,3,2
0X37B5700D43C90E67.avi,56,2193,1785,408,22.857142857142858,morphological_dilation,3,2
0X37B5700D43C90E67.avi,69,1992,1600,392,24.5,morphological_dilation,3,2
0X37BFEEF205E5ACA3.avi,121,2943,2467,476,19.294689906769356,morphological_dilation,3,2
0X37BFEEF205E5ACA3.avi,143,1873,1477,396,26.811103588354772,morphological_dilation,3,2
0X37C22AD689BE34F.avi,56,1513,1161,352,30.31869078380706,morphological_dilation,3,2
0X37C22AD689BE34F.avi,74,929,625,304,48.64,morphological_dilation,3,2
0X37C81FB4C90A9A3E.avi,114,1630,1254,376,29.98405103668261,morphological_dilation,3,2
0X37C81FB4C90A9A3E.avi,129,1082,752,330,43.88297872340425,morphological_dilation,3,2
0X37C99A3FE9350BA0.avi,105,3149,2621,528,20.144982830980542,morphological_dilation,3,2
0X37C99A3FE9350BA0.avi,123,1772,1368,404,29.53216374269006,morphological_dilation,3,2
0X37D94E893C4F237C.avi,74,1365,1022,343,33.56164383561644,morphological_dilation,3,2
0X37D94E893C4F237C.avi,87,853,559,294,52.59391771019678,morphological_dilation,3,2
0X37D9FB2652E17FC8.avi,87,3822,3270,552,16.88073394495413,morphological_dilation,3,2
0X37D9FB2652E17FC8.avi,105,3296,2776,520,18.73198847262248,morphological_dilation,3,2
0X37DA9BFFBB4A5DAE.avi,68,1729,1353,376,27.79009608277901,morphological_dilation,3,2
0X37DA9BFFBB4A5DAE.avi,83,1075,763,312,40.89121887287025,morphological_dilation,3,2
0X37E48E1504E3D89.avi,80,2657,2193,464,21.158230734154127,morphological_dilation,3,2
0X37E48E1504E3D89.avi,97,1482,1142,340,29.772329246935204,morphological_dilation,3,2
0X37E6E6434A0C815B.avi,50,1776,1372,404,29.44606413994169,morphological_dilation,3,2
0X37E6E6434A0C815B.avi,68,1081,755,326,43.17880794701986,morphological_dilation,3,2
0X37EB51583A9D8E6C.avi,89,1242,922,320,34.70715835140998,morphological_dilation,3,2
0X37EB51583A9D8E6C.avi,107,797,529,268,50.661625708884685,morphological_dilation,3,2
0X37EED937EE5D531F.avi,87,2907,2427,480,19.77750309023486,morphological_dilation,3,2
0X37EED937EE5D531F.avi,96,2756,2301,455,19.774011299435028,morphological_dilation,3,2
0X37F75947334E0950.avi,50,2371,1915,456,23.812010443864228,morphological_dilation,3,2
0X37F75947334E0950.avi,65,1459,1103,356,32.27561196736174,morphological_dilation,3,2
0X37F9E9981E207C04.avi,75,3932,2757,1175,42.61878853826623,morphological_dilation,3,2
0X37F9E9981E207C04.avi,90,3253,2322,931,40.094745908699394,morphological_dilation,3,2
0X37FF2E02E64FDC8A.avi,93,1824,1448,376,25.96685082872928,morphological_dilation,3,2
0X37FF2E02E64FDC8A.avi,109,1058,762,296,38.84514435695538,morphological_dilation,3,2
0X380404E9F3B02E7F.avi,52,3408,2868,540,18.828451882845187,morphological_dilation,3,2
0X380404E9F3B02E7F.avi,68,2394,1923,471,24.492979719188767,morphological_dilation,3,2
0X380AB851A1F1ECDC.avi,82,1809,1429,380,26.592022393282015,morphological_dilation,3,2
0X380AB851A1F1ECDC.avi,95,1211,875,336,38.4,morphological_dilation,3,2
0X3811B3B600535B08.avi,46,2221,1801,420,23.320377568017765,morphological_dilation,3,2
0X3811B3B600535B08.avi,62,1234,918,316,34.42265795206972,morphological_dilation,3,2
0X38143F4D496E1C01.avi,41,1425,1085,340,31.336405529953915,morphological_dilation,3,2
0X38143F4D496E1C01.avi,60,893,613,280,45.67699836867863,morphological_dilation,3,2
0X38145E7CC30DC7A5.avi,66,1879,1483,396,26.70262980445044,morphological_dilation,3,2
0X38145E7CC30DC7A5.avi,93,1234,906,328,36.20309050772627,morphological_dilation,3,2
0X381609E5A502011E.avi,39,2053,1638,415,25.335775335775335,morphological_dilation,3,2
0X381609E5A502011E.avi,52,1230,902,328,36.36363636363637,morphological_dilation,3,2
0X381864BFF92B7437.avi,49,1989,1549,440,28.405422853453842,morphological_dilation,3,2
0X381864BFF92B7437.avi,67,1160,820,340,41.46341463414634,morphological_dilation,3,2
0X381A1032716BDFE3.avi,58,1876,1492,384,25.737265415549597,morphological_dilation,3,2
0X381A1032716BDFE3.avi,73,1432,1090,342,31.376146788990827,morphological_dilation,3,2
0X381BBECABC1D6FB2.avi,54,3131,2635,496,18.823529411764707,morphological_dilation,3,2
0X381BBECABC1D6FB2.avi,70,2746,2286,460,20.122484689413824,morphological_dilation,3,2
0X381E0029617F214D.avi,109,1462,1107,355,32.068654019873534,morphological_dilation,3,2
0X381E0029617F214D.avi,128,911,624,287,45.993589743589745,morphological_dilation,3,2
0X381F0E140D552666.avi,57,2850,2358,492,20.865139949109416,morphological_dilation,3,2
0X381F0E140D552666.avi,73,1773,1353,420,31.042128603104214,morphological_dilation,3,2
0X3821E9F21EBFFF33.avi,56,1947,1527,420,27.5049115913556,morphological_dilation,3,2
0X3821E9F21EBFFF33.avi,68,1170,818,352,43.03178484107579,morphological_dilation,3,2
0X38254D78E538011D.avi,71,1616,1256,360,28.662420382165603,morphological_dilation,3,2
0X38254D78E538011D.avi,88,1050,754,296,39.257294429708224,morphological_dilation,3,2
0X3825F13C4A46F44C.avi,101,1594,1242,352,28.34138486312399,morphological_dilation,3,2
0X3825F13C4A46F44C.avi,114,1277,949,328,34.562697576396204,morphological_dilation,3,2
0X382685BB75B13E86.avi,39,1796,1408,388,27.556818181818183,morphological_dilation,3,2
0X382685BB75B13E86.avi,56,1079,769,310,40.31209362808843,morphological_dilation,3,2
0X3828251CB7F52FDE.avi,50,1792,1401,391,27.90863668807994,morphological_dilation,3,2
0X3828251CB7F52FDE.avi,65,1007,691,316,45.73082489146165,morphological_dilation,3,2
0X383838D5E679ACFE.avi,115,1502,1134,368,32.451499118165785,morphological_dilation,3,2
0X383838D5E679ACFE.avi,133,1482,985,497,50.45685279187817,morphological_dilation,3,2
0X3838EE835D844578.avi,121,871,591,280,47.377326565143825,morphological_dilation,3,2
0X3838EE835D844578.avi,140,595,351,244,69.51566951566952,morphological_dilation,3,2
0X383AE9D85E471FEC.avi,115,1546,1182,364,30.79526226734349,morphological_dilation,3,2
0X383AE9D85E471FEC.avi,128,1026,710,316,44.50704225352113,morphological_dilation,3,2
0X383C974A8DDF5.avi,56,1474,1138,336,29.525483304042176,morphological_dilation,3,2
0X383C974A8DDF5.avi,73,941,669,272,40.657698056801195,morphological_dilation,3,2
0X3842C50FE6B2F4B1.avi,69,2493,2057,436,21.195916383082157,morphological_dilation,3,2
0X3842C50FE6B2F4B1.avi,83,1682,1310,372,28.396946564885496,morphological_dilation,3,2
0X3845FCDDC728107D.avi,69,2111,1683,428,25.430778371954844,morphological_dilation,3,2
0X3845FCDDC728107D.avi,82,1446,1094,352,32.17550274223035,morphological_dilation,3,2
0X3846391F71AB9B06.avi,133,1516,1160,356,30.689655172413794,morphological_dilation,3,2
0X3846391F71AB9B06.avi,146,1046,730,316,43.28767123287671,morphological_dilation,3,2
0X3847FF474B4D4AEB.avi,61,2533,2049,484,23.621278672523182,morphological_dilation,3,2
0X3847FF474B4D4AEB.avi,83,1596,1192,404,33.89261744966443,morphological_dilation,3,2
0X38491F42504861CA.avi,375,1899,1507,392,26.011944260119442,morphological_dilation,3,2
0X38491F42504861CA.avi,393,1262,930,332,35.6989247311828,morphological_dilation,3,2
0X384933A479F6904F.avi,122,2174,1750,424,24.22857142857143,morphological_dilation,3,2
0X384933A479F6904F.avi,138,1342,998,344,34.46893787575151,morphological_dilation,3,2
0X384A037668246F4E.avi,124,2283,1847,436,23.60584731997834,morphological_dilation,3,2
0X384A037668246F4E.avi,149,1948,1552,396,25.51546391752577,morphological_dilation,3,2
0X384AA2C9A3C82A61.avi,94,1489,1145,344,30.043668122270745,morphological_dilation,3,2
0X384AA2C9A3C82A61.avi,109,1053,749,304,40.58744993324432,morphological_dilation,3,2
0X384B32F8B19D8E0.avi,50,2027,1595,432,27.0846394984326,morphological_dilation,3,2
0X384B32F8B19D8E0.avi,65,1254,898,356,39.643652561247215,morphological_dilation,3,2
0X384FCB5F752D8DCF.avi,93,1361,1013,348,34.35340572556762,morphological_dilation,3,2
0X384FCB5F752D8DCF.avi,114,1008,700,308,44.0,morphological_dilation,3,2
0X385071ADD66846AD.avi,12,1676,1296,380,29.32098765432099,morphological_dilation,3,2
0X385071ADD66846AD.avi,30,1413,1061,352,33.17624882186617,morphological_dilation,3,2
0X385229E934253438.avi,98,4515,3891,624,16.037008481110256,morphological_dilation,3,2
0X385229E934253438.avi,113,2586,2078,508,24.446583253128008,morphological_dilation,3,2
0X3852798141EC72CD.avi,144,1783,1391,392,28.181164629762762,morphological_dilation,3,2
0X3852798141EC72CD.avi,157,1066,746,320,42.89544235924933,morphological_dilation,3,2
0X38553A64F1845D6.avi,110,985,630,355,56.34920634920635,morphological_dilation,3,2
0X38553A64F1845D6.avi,138,1401,1057,344,32.544938505203405,morphological_dilation,3,2
0X3856B31133D591F9.avi,18,1782,1408,374,26.5625,morphological_dilation,3,2
0X3856B31133D591F9.avi,32,1332,1010,322,31.88118811881188,morphological_dilation,3,2
0X385A1BC46A38CB5B.avi,139,2000,1593,407,25.549278091650972,morphological_dilation,3,2
0X385A1BC46A38CB5B.avi,160,1598,1211,387,31.957060280759702,morphological_dilation,3,2
0X385B21C57A42C5A1.avi,53,1704,1296,408,31.48148148148148,morphological_dilation,3,2
0X385B21C57A42C5A1.avi,66,1025,701,324,46.219686162624825,morphological_dilation,3,2
0X385C5071980C3241.avi,59,1632,1252,380,30.35143769968051,morphological_dilation,3,2
0X385C5071980C3241.avi,72,984,674,310,45.99406528189911,morphological_dilation,3,2
0X385F55F9B1A71FD2.avi,1,2131,1711,420,24.54704850964348,morphological_dilation,3,2
0X385F55F9B1A71FD2.avi,16,1167,831,336,40.43321299638989,morphological_dilation,3,2
0X3860318B66CC8557.avi,41,1506,1162,344,29.604130808950085,morphological_dilation,3,2
0X3860318B66CC8557.avi,59,1004,716,288,40.22346368715084,morphological_dilation,3,2
0X38638F441D35402.avi,135,3064,2560,504,19.6875,morphological_dilation,3,2
0X38638F441D35402.avi,155,2318,1864,454,24.356223175965667,morphological_dilation,3,2
0X386444FB91940E3D.avi,65,1726,1330,396,29.774436090225564,morphological_dilation,3,2
0X386444FB91940E3D.avi,89,1101,761,340,44.678055190538764,morphological_dilation,3,2
0X386924A6B430342A.avi,87,1745,1377,368,26.724763979665937,morphological_dilation,3,2
0X386924A6B430342A.avi,103,1336,1004,332,33.067729083665334,morphological_dilation,3,2
0X3869ABCAB47DF8C9.avi,127,1547,1192,355,29.78187919463087,morphological_dilation,3,2
0X3869ABCAB47DF8C9.avi,148,968,668,300,44.91017964071856,morphological_dilation,3,2
0X3869C8E146FBD123.avi,90,3353,2833,520,18.355100600070596,morphological_dilation,3,2
0X3869C8E146FBD123.avi,109,2151,1711,440,25.71595558153127,morphological_dilation,3,2
0X386DAB52217592A2.avi,163,2221,1765,456,25.835694050991503,morphological_dilation,3,2
0X386DAB52217592A2.avi,184,1524,1140,384,33.68421052631579,morphological_dilation,3,2
0X386E38E6214B10A1.avi,50,1803,1375,428,31.127272727272725,morphological_dilation,3,2
0X386E38E6214B10A1.avi,69,1160,808,352,43.56435643564357,morphological_dilation,3,2
0X386E6F14BB2F2D6E.avi,35,1406,1054,352,33.396584440227706,morphological_dilation,3,2
0X386E6F14BB2F2D6E.avi,50,792,520,272,52.307692307692314,morphological_dilation,3,2
0X38715946C362E4A2.avi,38,1755,1379,376,27.26613488034808,morphological_dilation,3,2
0X38715946C362E4A2.avi,52,1466,1118,348,31.12701252236136,morphological_dilation,3,2
0X3875F6FD6EDAC72B.avi,103,1472,1120,352,31.428571428571427,morphological_dilation,3,2
0X3875F6FD6EDAC72B.avi,122,883,591,292,49.407783417935704,morphological_dilation,3,2
0X3879A849BC662476.avi,53,1591,1207,384,31.814415907207955,morphological_dilation,3,2
0X3879A849BC662476.avi,70,970,670,300,44.776119402985074,morphological_dilation,3,2
0X387C1FBF1C6448E6.avi,87,1646,1274,372,29.199372056514918,morphological_dilation,3,2
0X387C1FBF1C6448E6.avi,102,1049,753,296,39.309428950863214,morphological_dilation,3,2
0X387CAAFEB15599D2.avi,39,2878,2390,488,20.418410041841003,morphological_dilation,3,2
0X387CAAFEB15599D2.avi,57,2008,1568,440,28.061224489795915,morphological_dilation,3,2
0X387DC966A4E49FF7.avi,132,1117,780,337,43.205128205128204,morphological_dilation,3,2
0X387DC966A4E49FF7.avi,153,741,453,288,63.576158940397356,morphological_dilation,3,2
0X387F179AFBFB9768.avi,31,1239,907,332,36.60418963616318,morphological_dilation,3,2
0X387F179AFBFB9768.avi,46,760,484,276,57.02479338842975,morphological_dilation,3,2
0X3881278C9B1525BD.avi,54,3166,2654,512,19.291635267520725,morphological_dilation,3,2
0X3881278C9B1525BD.avi,71,2436,1976,460,23.279352226720647,morphological_dilation,3,2
0X3885497D26EE0A1E.avi,52,2595,2136,459,21.48876404494382,morphological_dilation,3,2
0X3885497D26EE0A1E.avi,66,1641,1261,380,30.13481363996828,morphological_dilation,3,2
0X388632531BB30B3C.avi,48,1760,1386,374,26.984126984126984,morphological_dilation,3,2
0X388632531BB30B3C.avi,67,1361,1029,332,32.26433430515063,morphological_dilation,3,2
0X38879CF9F172C79.avi,54,1721,1349,372,27.575982209043737,morphological_dilation,3,2
0X38879CF9F172C79.avi,77,1046,730,316,43.28767123287671,morphological_dilation,3,2
0X389086C8EC0A5181.avi,58,2283,1844,439,23.806941431670282,morphological_dilation,3,2
0X389086C8EC0A5181.avi,82,1494,1118,376,33.631484794275494,morphological_dilation,3,2
0X3892C8528EDF3D78.avi,55,3557,3005,552,18.369384359400996,morphological_dilation,3,2
0X3892C8528EDF3D78.avi,74,2455,1983,472,23.802319717599595,morphological_dilation,3,2
0X3893725E893E66B1.avi,68,2400,1944,456,23.456790123456788,morphological_dilation,3,2
0X3893725E893E66B1.avi,90,1445,1089,356,32.69054178145087,morphological_dilation,3,2
0X389455E41FE5B36.avi,72,3481,2934,547,18.643490115882756,morphological_dilation,3,2
0X389455E41FE5B36.avi,95,2540,2072,468,22.586872586872587,morphological_dilation,3,2
0X389A53F8C76EB122.avi,112,2125,1729,396,22.903412377096586,morphological_dilation,3,2
0X389A53F8C76EB122.avi,124,1565,1221,344,28.173628173628174,morphological_dilation,3,2
0X389AE3058DF8A75A.avi,40,1447,1103,344,31.18766999093382,morphological_dilation,3,2
0X389AE3058DF8A75A.avi,56,986,686,300,43.731778425655975,morphological_dilation,3,2
0X389BA6B21FADB9D8.avi,51,1643,1279,364,28.459734167318217,morphological_dilation,3,2
0X389BA6B21FADB9D8.avi,69,1126,826,300,36.31961259079903,morphological_dilation,3,2
0X389BC2B8D056A031.avi,85,1602,1250,352,28.16,morphological_dilation,3,2
0X389BC2B8D056A031.avi,98,1032,740,292,39.45945945945946,morphological_dilation,3,2
0X389D268AC64FDF16.avi,96,2384,1932,452,23.395445134575567,morphological_dilation,3,2
0X389D268AC64FDF16.avi,109,1749,1365,384,28.13186813186813,morphological_dilation,3,2
0X38A0EAF624F7A247.avi,107,1271,939,332,35.356762513312034,morphological_dilation,3,2
0X38A0EAF624F7A247.avi,124,829,536,293,54.66417910447762,morphological_dilation,3,2
0X38A2BB53562636BB.avi,37,1687,1327,360,27.128862094951018,morphological_dilation,3,2
0X38A2BB53562636BB.avi,54,1430,1094,336,30.712979890310788,morphological_dilation,3,2
0X38A3C665EF3925D1.avi,45,1375,1042,333,31.957773512476006,morphological_dilation,3,2
0X38A3C665EF3925D1.avi,64,827,511,316,61.839530332681015,morphological_dilation,3,2
0X38A74D84490F7CFF.avi,108,1300,976,324,33.19672131147541,morphological_dilation,3,2
0X38A74D84490F7CFF.avi,118,743,495,248,50.101010101010104,morphological_dilation,3,2
0X38AD513F67133C37.avi,170,1773,1377,396,28.75816993464052,morphological_dilation,3,2
0X38AD513F67133C37.avi,185,1205,865,340,39.30635838150289,morphological_dilation,3,2
0X38AF259B8CB9ED38.avi,137,2907,2415,492,20.372670807453417,morphological_dilation,3,2
0X38AF259B8CB9ED38.avi,153,2098,1663,435,26.157546602525557,morphological_dilation,3,2
0X38B128C923F9718F.avi,29,1915,1531,384,25.081645983017637,morphological_dilation,3,2
0X38B128C923F9718F.avi,43,1663,1299,364,28.021555042340264,morphological_dilation,3,2
0X38B537356485B1FB.avi,65,1176,872,304,34.862385321100916,morphological_dilation,3,2
0X38B537356485B1FB.avi,81,753,501,252,50.29940119760479,morphological_dilation,3,2
0X38B6140101279B52.avi,110,1545,1189,356,29.941126997476868,morphological_dilation,3,2
0X38B6140101279B52.avi,128,959,671,288,42.92101341281669,morphological_dilation,3,2
0X38BB67496B74ED43.avi,350,2296,1824,472,25.877192982456144,morphological_dilation,3,2
0X38BB67496B74ED43.avi,383,1328,944,384,40.67796610169492,morphological_dilation,3,2
0X38BD4E9D7BE145D3.avi,49,1625,1265,360,28.458498023715418,morphological_dilation,3,2
0X38BD4E9D7BE145D3.avi,65,1044,732,312,42.62295081967213,morphological_dilation,3,2
0X38BF5A1070D6D922.avi,144,2091,1671,420,25.134649910233392,morphological_dilation,3,2
0X38BF5A1070D6D922.avi,169,1388,1040,348,33.46153846153846,morphological_dilation,3,2
0X38BFE1C170679687.avi,4,3082,2569,513,19.968859478396265,morphological_dilation,3,2
0X38BFE1C170679687.avi,29,1934,1514,420,27.741083223249667,morphological_dilation,3,2
0X38C80D99FBBD1995.avi,129,1664,1296,368,28.39506172839506,morphological_dilation,3,2
0X38C80D99FBBD1995.avi,143,967,687,280,40.756914119359536,morphological_dilation,3,2
0X38CD1C45920A92B.avi,61,1432,1092,340,31.135531135531135,morphological_dilation,3,2
0X38CD1C45920A92B.avi,76,959,667,292,43.77811094452774,morphological_dilation,3,2
0X38CE7A69D1AD269D.avi,59,2117,1649,468,28.380836870830805,morphological_dilation,3,2
0X38CE7A69D1AD269D.avi,75,1218,841,377,44.827586206896555,morphological_dilation,3,2
0X38CFBFF9E0F722F7.avi,0,1903,1491,412,27.632461435278337,morphological_dilation,3,2
0X38CFBFF9E0F722F7.avi,15,1219,860,359,41.74418604651163,morphological_dilation,3,2
0X38D1523C8AC932CB.avi,51,936,632,304,48.10126582278481,morphological_dilation,3,2
0X38D1523C8AC932CB.avi,74,648,380,268,70.52631578947368,morphological_dilation,3,2
0X38D5F0D5CCF21875.avi,114,1481,1137,344,30.255057167985928,morphological_dilation,3,2
0X38D5F0D5CCF21875.avi,131,903,615,288,46.82926829268293,morphological_dilation,3,2
0X38D61BFC461E6880.avi,45,1640,1251,389,31.095123900879294,morphological_dilation,3,2
0X38D61BFC461E6880.avi,61,1165,716,449,62.709497206703915,morphological_dilation,3,2
0X38D723B271A17254.avi,84,2446,1970,476,24.16243654822335,morphological_dilation,3,2
0X38D723B271A17254.avi,102,1488,1101,387,35.14986376021799,morphological_dilation,3,2
0X38D92BC43C1543C0.avi,38,2990,2474,516,20.85691188358933,morphological_dilation,3,2
0X38D92BC43C1543C0.avi,57,1741,1322,419,31.694402420574885,morphological_dilation,3,2
0X38D9D8D3E8CAD64D.avi,96,1835,1439,396,27.51911049339819,morphological_dilation,3,2
0X38D9D8D3E8CAD64D.avi,114,1144,824,320,38.83495145631068,morphological_dilation,3,2
0X38DC5920EB30FD44.avi,45,2596,2148,448,20.85661080074488,morphological_dilation,3,2
0X38DC5920EB30FD44.avi,62,1832,1428,404,28.291316526610643,morphological_dilation,3,2
0X38E23F5101349879.avi,86,1261,953,308,32.3189926547744,morphological_dilation,3,2
0X38E23F5101349879.avi,100,942,674,268,39.762611275964396,morphological_dilation,3,2
0X38E252DBA241D7A7.avi,39,1415,1075,340,31.627906976744185,morphological_dilation,3,2
0X38E252DBA241D7A7.avi,56,930,657,273,41.55251141552511,morphological_dilation,3,2
0X38E98D54857003CA.avi,30,1774,1410,364,25.81560283687943,morphological_dilation,3,2
0X38E98D54857003CA.avi,44,1179,867,312,35.98615916955018,morphological_dilation,3,2
0X38EA1D595376A658.avi,150,2016,1592,424,26.633165829145728,morphological_dilation,3,2
0X38EA1D595376A658.avi,168,1179,820,359,43.78048780487805,morphological_dilation,3,2
0X38EE2A5624ABAE2C.avi,78,1988,1580,408,25.82278481012658,morphological_dilation,3,2
0X38EE2A5624ABAE2C.avi,95,1297,957,340,35.52769070010449,morphological_dilation,3,2
0X38EEE406BC289A52.avi,58,2656,2208,448,20.28985507246377,morphological_dilation,3,2
0X38EEE406BC289A52.avi,76,2356,1936,420,21.694214876033058,morphological_dilation,3,2
0X38F5A46E6132A231.avi,49,2266,1798,468,26.028921023359285,morphological_dilation,3,2
0X38F5A46E6132A231.avi,65,1608,1208,400,33.11258278145696,morphological_dilation,3,2
0X38F6970A7694ECF5.avi,123,1784,1400,384,27.42857142857143,morphological_dilation,3,2
0X38F6970A7694ECF5.avi,143,1075,752,323,42.952127659574465,morphological_dilation,3,2
0X38FA13F5CA0BC79A.avi,150,1054,713,341,47.82608695652174,morphological_dilation,3,2
0X38FA13F5CA0BC79A.avi,166,669,378,291,76.98412698412699,morphological_dilation,3,2
0X38FA5C50E4F65BA.avi,34,1176,876,300,34.24657534246575,morphological_dilation,3,2
0X38FA5C50E4F65BA.avi,49,768,520,248,47.69230769230769,morphological_dilation,3,2
0X38FD38D5BC7288D2.avi,118,1786,1394,392,28.120516499282637,morphological_dilation,3,2
0X38FD38D5BC7288D2.avi,136,1444,1076,368,34.20074349442379,morphological_dilation,3,2
0X3901B0181816DDB2.avi,107,1663,1275,388,30.43137254901961,morphological_dilation,3,2
0X3901B0181816DDB2.avi,116,1153,817,336,41.126070991432066,morphological_dilation,3,2
0X3902A366CE2F62E8.avi,16,655,395,260,65.82278481012658,morphological_dilation,3,2
0X3902A366CE2F62E8.avi,49,1076,760,316,41.578947368421055,morphological_dilation,3,2
0X3902FE711F8B581B.avi,56,1989,1568,421,26.84948979591837,morphological_dilation,3,2
0X3902FE711F8B581B.avi,75,1405,1045,360,34.44976076555024,morphological_dilation,3,2
0X39036C86D46D7EFF.avi,127,1830,1434,396,27.615062761506277,morphological_dilation,3,2
0X39036C86D46D7EFF.avi,145,1127,815,312,38.282208588957054,morphological_dilation,3,2
0X3904CF2713F4604D.avi,119,1488,1128,360,31.914893617021278,morphological_dilation,3,2
0X3904CF2713F4604D.avi,138,1082,778,304,39.0745501285347,morphological_dilation,3,2
0X39051FE34AF2ABF2.avi,80,2368,1936,432,22.31404958677686,morphological_dilation,3,2
0X39051FE34AF2ABF2.avi,106,1356,1016,340,33.46456692913386,morphological_dilation,3,2
0X390A2A0F25666BFB.avi,29,1945,1545,400,25.88996763754045,morphological_dilation,3,2
0X390A2A0F25666BFB.avi,42,1223,883,340,38.50509626274066,morphological_dilation,3,2
0X39123D0EB3886D8.avi,1,1866,1458,408,27.983539094650205,morphological_dilation,3,2
0X39123D0EB3886D8.avi,18,1106,774,332,42.89405684754522,morphological_dilation,3,2
0X39159841194ACD89.avi,79,3032,2516,516,20.5087440381558,morphological_dilation,3,2
0X39159841194ACD89.avi,95,1800,1392,408,29.310344827586203,morphological_dilation,3,2
0X3915AE4881C75F2E.avi,40,1398,1062,336,31.63841807909605,morphological_dilation,3,2
0X3915AE4881C75F2E.avi,55,1190,874,316,36.15560640732266,morphological_dilation,3,2
0X3915EB0A9DE6FDAF.avi,67,2705,2245,460,20.489977728285076,morphological_dilation,3,2
0X3915EB0A9DE6FDAF.avi,96,1940,1544,396,25.647668393782386,morphological_dilation,3,2
0X3917A23D1B120284.avi,32,1218,886,332,37.471783295711056,morphological_dilation,3,2
0X3917A23D1B120284.avi,41,823,535,288,53.83177570093458,morphological_dilation,3,2
0X39207AF594BF77D7.avi,51,3105,2553,552,21.62162162162162,morphological_dilation,3,2
0X39207AF594BF77D7.avi,69,1838,1378,460,33.38171262699564,morphological_dilation,3,2
0X3924FFA1465DC6E8.avi,47,1655,1287,368,28.593628593628594,morphological_dilation,3,2
0X3924FFA1465DC6E8.avi,63,1053,761,292,38.370565045992116,morphological_dilation,3,2
0X3925BB805E197F96.avi,70,2337,1893,444,23.454833597464344,morphological_dilation,3,2
0X3925BB805E197F96.avi,88,1456,1075,381,35.44186046511628,morphological_dilation,3,2
0X392B60853721DCCA.avi,97,2769,2301,468,20.33898305084746,morphological_dilation,3,2
0X392B60853721DCCA.avi,115,1852,1452,400,27.548209366391184,morphological_dilation,3,2
0X392DB57364299195.avi,53,2407,1928,479,24.844398340248965,morphological_dilation,3,2
0X392DB57364299195.avi,74,1459,1058,401,37.901701323251416,morphological_dilation,3,2
0X39316269EC98F850.avi,80,1863,1475,388,26.305084745762713,morphological_dilation,3,2
0X39316269EC98F850.avi,92,1115,791,324,40.960809102402024,morphological_dilation,3,2
0X39348579B2E55470.avi,53,1527,1175,352,29.95744680851064,morphological_dilation,3,2
0X39348579B2E55470.avi,81,952,672,280,41.66666666666667,morphological_dilation,3,2
0X39361D8B4B5EDFE8.avi,5,1980,1584,396,25.0,morphological_dilation,3,2
0X39361D8B4B5EDFE8.avi,17,1354,1014,340,33.53057199211045,morphological_dilation,3,2
0X39386679DE7A85F9.avi,47,1746,1366,380,27.81844802342606,morphological_dilation,3,2
0X39386679DE7A85F9.avi,63,1041,753,288,38.24701195219124,morphological_dilation,3,2
0X39391A4909EE1831.avi,114,2577,2110,467,22.13270142180095,morphological_dilation,3,2
0X39391A4909EE1831.avi,129,1460,1088,372,34.19117647058824,morphological_dilation,3,2
0X39430B9C27CAE73E.avi,52,1637,1265,372,29.40711462450593,morphological_dilation,3,2
0X39430B9C27CAE73E.avi,66,1104,788,316,40.10152284263959,morphological_dilation,3,2
0X3943402607F915DA.avi,76,1575,1235,340,27.530364372469634,morphological_dilation,3,2
0X3943402607F915DA.avi,90,877,621,256,41.22383252818035,morphological_dilation,3,2
0X3957CF1AAADE25C.avi,30,1440,1072,368,34.32835820895522,morphological_dilation,3,2
0X3957CF1AAADE25C.avi,46,955,639,316,49.45226917057903,morphological_dilation,3,2
0X395E507F8ECA4193.avi,120,2417,1937,480,24.780588538977803,morphological_dilation,3,2
0X395E507F8ECA4193.avi,135,1520,1125,395,35.11111111111111,morphological_dilation,3,2
0X396631243C670596.avi,83,1716,1320,396,30.0,morphological_dilation,3,2
0X396631243C670596.avi,104,1158,822,336,40.87591240875913,morphological_dilation,3,2
0X3967483E89F10A1E.avi,50,3136,2600,536,20.615384615384617,morphological_dilation,3,2
0X3967483E89F10A1E.avi,64,1860,1421,439,30.893736805066858,morphological_dilation,3,2
0X39692AE83D7076F8.avi,58,1236,896,340,37.94642857142857,morphological_dilation,3,2
0X39692AE83D7076F8.avi,76,806,505,301,59.603960396039604,morphological_dilation,3,2
0X396B442D42E66666.avi,58,1954,1558,396,25.41720154043646,morphological_dilation,3,2
0X396B442D42E66666.avi,77,1168,848,320,37.735849056603776,morphological_dilation,3,2
0X396ECCF27946B21C.avi,97,1387,1027,360,35.05355404089581,morphological_dilation,3,2
0X396ECCF27946B21C.avi,111,863,583,280,48.02744425385935,morphological_dilation,3,2
0X3972F3D228C6973.avi,115,3610,3062,548,17.89679947746571,morphological_dilation,3,2
0X3972F3D228C6973.avi,133,2298,1834,464,25.29989094874591,morphological_dilation,3,2
0X39785B105916D907.avi,48,2275,1851,424,22.906537007023232,morphological_dilation,3,2
0X39785B105916D907.avi,65,1463,1111,352,31.683168316831683,morphological_dilation,3,2
0X398111BC19E289A6.avi,136,3105,2565,540,21.052631578947366,morphological_dilation,3,2
0X398111BC19E289A6.avi,151,1847,1419,428,30.162085976039464,morphological_dilation,3,2
0X39812AAD22D1087E.avi,2,1832,1464,368,25.136612021857925,morphological_dilation,3,2
0X39812AAD22D1087E.avi,11,1620,1258,362,28.7758346581876,morphological_dilation,3,2
0X398198DD34B47AB6.avi,31,2041,1615,426,26.377708978328172,morphological_dilation,3,2
0X398198DD34B47AB6.avi,42,1324,996,328,32.93172690763052,morphological_dilation,3,2
0X3982C7E5ECE74699.avi,89,2417,1997,420,21.031547320981474,morphological_dilation,3,2
0X3982C7E5ECE74699.avi,106,2010,1606,404,25.155666251556664,morphological_dilation,3,2
0X398379987B3E5DE0.avi,42,2323,1872,451,24.09188034188034,morphological_dilation,3,2
0X398379987B3E5DE0.avi,57,1422,1078,344,31.910946196660483,morphological_dilation,3,2
0X39878B4033C03C7A.avi,89,1922,1511,411,27.200529450694905,morphological_dilation,3,2
0X39878B4033C03C7A.avi,106,1264,906,358,39.51434878587197,morphological_dilation,3,2
0X3988D1B584CBEC93.avi,49,1590,1238,352,28.432956381260098,morphological_dilation,3,2
0X3988D1B584CBEC93.avi,69,1347,1018,329,32.31827111984283,morphological_dilation,3,2
0X398B7A013EC01F9A.avi,64,1196,856,340,39.719626168224295,morphological_dilation,3,2
0X398B7A013EC01F9A.avi,74,735,479,256,53.444676409185796,morphological_dilation,3,2
0X398F29049BB32013.avi,136,1842,1462,380,25.99179206566348,morphological_dilation,3,2
0X398F29049BB32013.avi,146,1378,1044,334,31.992337164750957,morphological_dilation,3,2
0X3991463690B05802.avi,44,2736,2232,504,22.58064516129032,morphological_dilation,3,2
0X3991463690B05802.avi,57,1342,994,348,35.01006036217304,morphological_dilation,3,2
0X39972DF04C904BF8.avi,4,1816,1404,412,29.34472934472934,morphological_dilation,3,2
0X39972DF04C904BF8.avi,20,976,666,310,46.546546546546544,morphological_dilation,3,2
0X399873AFA4B674D6.avi,1,3508,2956,552,18.67388362652233,morphological_dilation,3,2
0X399873AFA4B674D6.avi,13,1863,1423,440,30.920590302178496,morphological_dilation,3,2
0X3999802A1B03A98E.avi,111,3892,3342,550,16.457211250748056,morphological_dilation,3,2
0X3999802A1B03A98E.avi,136,3394,2882,512,17.765440666204025,morphological_dilation,3,2
0X3999AFEE5AF07F42.avi,58,1878,1482,396,26.720647773279353,morphological_dilation,3,2
0X3999AFEE5AF07F42.avi,69,1739,1343,396,29.486224869694716,morphological_dilation,3,2
0X399C53F778C73E41.avi,58,2533,2029,504,24.839822572695912,morphological_dilation,3,2
0X399C53F778C73E41.avi,76,1840,1401,439,31.334760885082087,morphological_dilation,3,2
0X399F9331838E32BE.avi,99,1501,1125,376,33.42222222222222,morphological_dilation,3,2
0X399F9331838E32BE.avi,110,878,566,312,55.12367491166078,morphological_dilation,3,2
0X39A128E3A510782.avi,40,2073,1645,428,26.018237082066868,morphological_dilation,3,2
0X39A128E3A510782.avi,58,1190,842,348,41.33016627078385,morphological_dilation,3,2
0X39A85FA14F06B62D.avi,82,1663,1271,392,30.84185680566483,morphological_dilation,3,2
0X39A85FA14F06B62D.avi,95,1001,684,317,46.345029239766085,morphological_dilation,3,2
0X39AAB4E253F2AEAD.avi,105,1805,1433,372,25.95952547103978,morphological_dilation,3,2
0X39AAB4E253F2AEAD.avi,123,1388,1060,328,30.943396226415093,morphological_dilation,3,2
0X39AB3B74095BAC3D.avi,3,1189,865,324,37.45664739884393,morphological_dilation,3,2
0X39AB3B74095BAC3D.avi,14,894,595,299,50.252100840336134,morphological_dilation,3,2
0X39AE5B2F372542EE.avi,108,1425,1077,348,32.31197771587744,morphological_dilation,3,2
0X39AE5B2F372542EE.avi,122,867,587,280,47.700170357751276,morphological_dilation,3,2
0X39B358EAE5C1A47.avi,50,1657,1265,392,30.988142292490117,morphological_dilation,3,2
0X39B358EAE5C1A47.avi,71,1112,780,332,42.56410256410256,morphological_dilation,3,2
0X39B757B79F8A81FE.avi,102,1928,1537,391,25.439167208848406,morphological_dilation,3,2
0X39B757B79F8A81FE.avi,119,1117,804,313,38.930348258706466,morphological_dilation,3,2
0X39B8C93985E7FC88.avi,86,1965,1541,424,27.514600908500974,morphological_dilation,3,2
0X39B8C93985E7FC88.avi,98,1283,915,368,40.21857923497268,morphological_dilation,3,2
0X39BB31692C2E764B.avi,5,1641,1285,356,27.704280155642024,morphological_dilation,3,2
0X39BB31692C2E764B.avi,15,964,676,288,42.60355029585799,morphological_dilation,3,2
0X39BE5E9C68E021D2.avi,48,2185,1773,412,23.23745064861816,morphological_dilation,3,2
0X39BE5E9C68E021D2.avi,60,1335,1011,324,32.047477744807125,morphological_dilation,3,2
0X39C79919BCB7B445.avi,97,2105,1701,404,23.750734861845974,morphological_dilation,3,2
0X39C79919BCB7B445.avi,113,1371,1027,344,33.49561830574489,morphological_dilation,3,2
0X39CA8CC96A5D5E8B.avi,32,2299,1871,428,22.875467664350616,morphological_dilation,3,2
0X39CA8CC96A5D5E8B.avi,50,1814,1430,384,26.853146853146853,morphological_dilation,3,2
0X39CC8C89DE6060B7.avi,95,1591,1223,368,30.08994276369583,morphological_dilation,3,2
0X39CC8C89DE6060B7.avi,109,1009,701,308,43.93723252496434,morphological_dilation,3,2
0X39CCCA303517758C.avi,49,2394,1930,464,24.041450777202073,morphological_dilation,3,2
0X39CCCA303517758C.avi,61,1455,1079,376,34.84708063021316,morphological_dilation,3,2
0X39CD6157F36F9824.avi,95,2618,2154,464,21.541318477251625,morphological_dilation,3,2
0X39CD6157F36F9824.avi,112,1863,1463,400,27.34107997265892,morphological_dilation,3,2
0X39CF332039C0D5F.avi,62,1522,1170,352,30.085470085470085,morphological_dilation,3,2
0X39CF332039C0D5F.avi,84,963,675,288,42.66666666666667,morphological_dilation,3,2
0X39D01FC74E846311.avi,55,1058,762,296,38.84514435695538,morphological_dilation,3,2
0X39D01FC74E846311.avi,64,681,425,256,60.23529411764705,morphological_dilation,3,2
0X39D0A18C20873B10.avi,64,3317,2795,522,18.676207513416816,morphological_dilation,3,2
0X39D0A18C20873B10.avi,80,1989,1561,428,27.418321588725174,morphological_dilation,3,2
0X39D1558A3C02EC2D.avi,156,1400,1044,356,34.099616858237546,morphological_dilation,3,2
0X39D1558A3C02EC2D.avi,172,894,578,316,54.67128027681662,morphological_dilation,3,2
0X39D4ACDFC707D00C.avi,117,1151,843,308,36.5361803084223,morphological_dilation,3,2
0X39D4ACDFC707D00C.avi,134,783,523,260,49.7131931166348,morphological_dilation,3,2
0X39D64C26334E84BB.avi,36,2152,1732,420,24.249422632794456,morphological_dilation,3,2
0X39D64C26334E84BB.avi,60,1457,1101,356,32.334241598546775,morphological_dilation,3,2
0X39D6D1217FE384B1.avi,51,1793,1409,384,27.253371185237757,morphological_dilation,3,2
0X39D6D1217FE384B1.avi,70,1040,744,296,39.784946236559136,morphological_dilation,3,2
0X39D91890A1999E8.avi,163,1212,912,300,32.89473684210527,morphological_dilation,3,2
0X39D91890A1999E8.avi,182,881,617,264,42.78768233387358,morphological_dilation,3,2
0X39E11EB4ED0DB0B7.avi,84,1627,1271,356,28.009441384736427,morphological_dilation,3,2
0X39E11EB4ED0DB0B7.avi,96,1483,1139,344,30.201931518876208,morphological_dilation,3,2
0X39E19BB2FA344EA3.avi,63,1574,1206,368,30.514096185737976,morphological_dilation,3,2
0X39E19BB2FA344EA3.avi,78,1008,696,312,44.827586206896555,morphological_dilation,3,2
0X39E3FD0C9DB2E14C.avi,57,1660,1292,368,28.482972136222912,morphological_dilation,3,2
0X39E3FD0C9DB2E14C.avi,66,1141,825,316,38.303030303030305,morphological_dilation,3,2
0X39E53D97C96FAAAB.avi,79,2823,2315,508,21.943844492440604,morphological_dilation,3,2
0X39E53D97C96FAAAB.avi,94,1712,1304,408,31.28834355828221,morphological_dilation,3,2
0X39E5EE69D1ABD158.avi,99,1050,754,296,39.257294429708224,morphological_dilation,3,2
0X39E5EE69D1ABD158.avi,107,668,411,257,62.530413625304135,morphological_dilation,3,2
0X39E6A4F87A2B6A88.avi,43,2280,1800,480,26.666666666666668,morphological_dilation,3,2
0X39E6A4F87A2B6A88.avi,57,1781,1361,420,30.85966201322557,morphological_dilation,3,2
0X39E992259898874A.avi,34,1313,989,324,32.76036400404449,morphological_dilation,3,2
0X39E992259898874A.avi,50,915,635,280,44.09448818897638,morphological_dilation,3,2
0X39EF484992C44E9D.avi,91,2140,1704,436,25.586854460093893,morphological_dilation,3,2
0X39EF484992C44E9D.avi,108,1230,894,336,37.58389261744966,morphological_dilation,3,2
0X39F0C16E2A50442A.avi,124,1800,1412,388,27.47875354107649,morphological_dilation,3,2
0X39F0C16E2A50442A.avi,137,1086,790,296,37.46835443037975,morphological_dilation,3,2
0X39F5B35EA80E4D86.avi,80,2281,1869,412,22.043873729266988,morphological_dilation,3,2
0X39F5B35EA80E4D86.avi,95,1433,1073,360,33.550792171481824,morphological_dilation,3,2
0X39F7878941FCCEE3.avi,8,1808,1416,392,27.683615819209038,morphological_dilation,3,2
0X39F7878941FCCEE3.avi,28,1054,734,320,43.596730245231605,morphological_dilation,3,2
0X39F8C168B5299BA6.avi,39,1918,1534,384,25.03259452411995,morphological_dilation,3,2
0X39F8C168B5299BA6.avi,55,1083,769,314,40.83224967490247,morphological_dilation,3,2
0X39FCEE4F2B02701B.avi,0,1111,831,280,33.69434416365824,morphological_dilation,3,2
0X39FCEE4F2B02701B.avi,13,878,634,244,38.48580441640379,morphological_dilation,3,2
0X3A016DA394E94ED8.avi,116,2149,1705,444,26.041055718475075,morphological_dilation,3,2
0X3A016DA394E94ED8.avi,129,1411,1047,364,34.765998089780325,morphological_dilation,3,2
0X3A04B8BB685836CB.avi,42,3865,3285,580,17.65601217656012,morphological_dilation,3,2
0X3A04B8BB685836CB.avi,63,2189,1726,463,26.825028968713788,morphological_dilation,3,2
0X3A04D1EE256B301E.avi,1,1509,1177,332,28.20730671197961,morphological_dilation,3,2
0X3A04D1EE256B301E.avi,14,1001,725,276,38.068965517241374,morphological_dilation,3,2
0X3A067F55DF845A2E.avi,87,1794,1390,404,29.06474820143885,morphological_dilation,3,2
0X3A067F55DF845A2E.avi,103,1259,915,344,37.595628415300546,morphological_dilation,3,2
0X3A0FE82D5FCB1393.avi,43,2961,2437,524,21.501846532622075,morphological_dilation,3,2
0X3A0FE82D5FCB1393.avi,59,1728,1293,435,33.64269141531322,morphological_dilation,3,2
0X3A1243389B03E037.avi,57,2080,1624,456,28.078817733990146,morphological_dilation,3,2
0X3A1243389B03E037.avi,74,1299,907,392,43.2194046306505,morphological_dilation,3,2
0X3A1256ABF660B385.avi,70,2101,1685,416,24.688427299703264,morphological_dilation,3,2
0X3A1256ABF660B385.avi,85,1267,937,330,35.2187833511206,morphological_dilation,3,2
0X3A129451EC32992C.avi,157,1649,1273,376,29.53652788688138,morphological_dilation,3,2
0X3A129451EC32992C.avi,176,1031,705,326,46.241134751773046,morphological_dilation,3,2
0X3A15E907186AA019.avi,49,1159,840,319,37.976190476190474,morphological_dilation,3,2
0X3A15E907186AA019.avi,65,736,461,275,59.65292841648589,morphological_dilation,3,2
0X3A162CB5BE129444.avi,61,2427,1963,464,23.637289862455425,morphological_dilation,3,2
0X3A162CB5BE129444.avi,73,1667,1263,404,31.987331749802056,morphological_dilation,3,2
0X3A170C20A679FBB4.avi,30,2190,1758,432,24.573378839590443,morphological_dilation,3,2
0X3A170C20A679FBB4.avi,41,1531,1159,372,32.09663503019844,morphological_dilation,3,2
0X3A1B3966D331F29B.avi,76,1845,1453,392,26.97866483138334,morphological_dilation,3,2
0X3A1B3966D331F29B.avi,90,1228,908,320,35.24229074889868,morphological_dilation,3,2
0X3A21DB8AEB6B5B20.avi,7,2144,1744,400,22.93577981651376,morphological_dilation,3,2
0X3A21DB8AEB6B5B20.avi,19,1858,1478,380,25.710419485791608,morphological_dilation,3,2
0X3A24403843DE9A9F.avi,158,1530,1182,348,29.441624365482234,morphological_dilation,3,2
0X3A24403843DE9A9F.avi,179,909,637,272,42.700156985871274,morphological_dilation,3,2
0X3A2C0C6E64CD5F3D.avi,55,1763,1379,384,27.846265409717187,morphological_dilation,3,2
0X3A2C0C6E64CD5F3D.avi,70,1129,809,320,39.55500618046972,morphological_dilation,3,2
0X3A2DE690A0917A75.avi,39,1607,1251,356,28.457234212629896,morphological_dilation,3,2
0X3A2DE690A0917A75.avi,52,1093,781,312,39.94878361075544,morphological_dilation,3,2
0X3A3085150FD2D6E8.avi,40,2755,2267,488,21.52624614027349,morphological_dilation,3,2
0X3A3085150FD2D6E8.avi,60,1852,1448,404,27.900552486187845,morphological_dilation,3,2
0X3A309F6036FF0518.avi,50,1542,1174,368,31.3458262350937,morphological_dilation,3,2
0X3A309F6036FF0518.avi,67,959,647,312,48.222565687789796,morphological_dilation,3,2
0X3A30AB065E7F6735.avi,61,999,703,296,42.10526315789473,morphological_dilation,3,2
0X3A30AB065E7F6735.avi,74,719,421,298,70.78384798099762,morphological_dilation,3,2
0X3A34B1EB60C2A9AE.avi,135,1431,1087,344,31.646734130634773,morphological_dilation,3,2
0X3A34B1EB60C2A9AE.avi,152,841,569,272,47.803163444639715,morphological_dilation,3,2
0X3A381225412BA53C.avi,94,2613,2141,472,22.0457730032695,morphological_dilation,3,2
0X3A381225412BA53C.avi,111,1747,1343,404,30.081906180193595,morphological_dilation,3,2
0X3A46A45145C2FF9B.avi,50,1903,1495,408,27.29096989966555,morphological_dilation,3,2
0X3A46A45145C2FF9B.avi,64,1238,894,344,38.47874720357942,morphological_dilation,3,2
0X3A493A5E7BC5B076.avi,101,1588,1211,377,31.131296449215522,morphological_dilation,3,2
0X3A493A5E7BC5B076.avi,118,940,635,305,48.031496062992126,morphological_dilation,3,2
0X3A4D1AFE98C8476B.avi,79,1880,1484,396,26.68463611859838,morphological_dilation,3,2
0X3A4D1AFE98C8476B.avi,99,1221,885,336,37.96610169491525,morphological_dilation,3,2
0X3A58A66B6AF3DE55.avi,43,1802,1406,396,28.165007112375534,morphological_dilation,3,2
0X3A58A66B6AF3DE55.avi,58,1080,764,316,41.361256544502616,morphological_dilation,3,2
0X3A5F75A015056908.avi,90,1314,988,326,32.99595141700405,morphological_dilation,3,2
0X3A5F75A015056908.avi,103,737,443,294,66.36568848758465,morphological_dilation,3,2
0X3A6035ED10B83B7.avi,60,3049,2529,520,20.561486753657572,morphological_dilation,3,2
0X3A6035ED10B83B7.avi,86,1920,1500,420,28.000000000000004,morphological_dilation,3,2
0X3A6437E8004F6401.avi,98,2103,1695,408,24.07079646017699,morphological_dilation,3,2
0X3A6437E8004F6401.avi,114,1331,995,336,33.768844221105525,morphological_dilation,3,2
0X3A66D46DC689ADD2.avi,52,2068,1649,419,25.40933899332929,morphological_dilation,3,2
0X3A66D46DC689ADD2.avi,71,1385,1033,352,34.07550822846079,morphological_dilation,3,2
0X3A67F07292B0D9D4.avi,79,2171,1727,444,25.709322524609146,morphological_dilation,3,2
0X3A67F07292B0D9D4.avi,96,1317,953,364,38.19517313746065,morphological_dilation,3,2
0X3A689C00E2F6EE71.avi,57,1319,993,326,32.82980866062437,morphological_dilation,3,2
0X3A689C00E2F6EE71.avi,68,1053,751,302,40.21304926764314,morphological_dilation,3,2
0X3A6A8F1ED1A86F94.avi,3,1968,1572,396,25.190839694656486,morphological_dilation,3,2
0X3A6A8F1ED1A86F94.avi,15,1218,898,320,35.634743875278396,morphological_dilation,3,2
0X3A6E1BAA9065D40.avi,35,2981,2225,756,33.97752808988764,morphological_dilation,3,2
0X3A6E1BAA9065D40.avi,45,1925,1330,595,44.73684210526316,morphological_dilation,3,2
0X3A6E9277ED871C65.avi,45,1030,730,300,41.0958904109589,morphological_dilation,3,2
0X3A6E9277ED871C65.avi,61,651,411,240,58.3941605839416,morphological_dilation,3,2
0X3A7280211A9AC1E3.avi,37,1666,1294,372,28.748068006182383,morphological_dilation,3,2
0X3A7280211A9AC1E3.avi,53,982,682,300,43.988269794721404,morphological_dilation,3,2
0X3A73982E9C3E2D12.avi,38,1818,1442,376,26.0748959778086,morphological_dilation,3,2
0X3A73982E9C3E2D12.avi,49,1206,894,312,34.899328859060404,morphological_dilation,3,2
0X3A76AD5CC9D50E57.avi,120,1241,921,320,34.74484256243214,morphological_dilation,3,2
0X3A76AD5CC9D50E57.avi,139,812,536,276,51.49253731343284,morphological_dilation,3,2
0X3A7787951A5869B1.avi,62,1905,1517,388,25.576796308503624,morphological_dilation,3,2
0X3A7787951A5869B1.avi,76,1052,764,288,37.696335078534034,morphological_dilation,3,2
0X3A78E8C699486EDF.avi,36,2544,2076,468,22.54335260115607,morphological_dilation,3,2
0X3A78E8C699486EDF.avi,51,1564,1180,384,32.54237288135593,morphological_dilation,3,2
0X3A79044052AC3197.avi,52,1128,737,391,53.05291723202171,morphological_dilation,3,2
0X3A79044052AC3197.avi,78,614,398,216,54.2713567839196,morphological_dilation,3,2
0X3A7952D92A293CE8.avi,82,1553,1201,352,29.308909242298085,morphological_dilation,3,2
0X3A7952D92A293CE8.avi,94,948,668,280,41.91616766467065,morphological_dilation,3,2
0X3A7E305F4B67D1B5.avi,76,1770,1394,376,26.97274031563845,morphological_dilation,3,2
0X3A7E305F4B67D1B5.avi,89,1139,811,328,40.4438964241677,morphological_dilation,3,2
0X3A810212F92EEBFB.avi,43,2083,1639,444,27.089688834655277,morphological_dilation,3,2
0X3A810212F92EEBFB.avi,59,1316,964,352,36.51452282157676,morphological_dilation,3,2
0X3A84F1E3BCC9B6E6.avi,56,1376,1009,367,36.37264618434094,morphological_dilation,3,2
0X3A84F1E3BCC9B6E6.avi,76,1031,703,328,46.65718349928876,morphological_dilation,3,2
0X3A8625DCFA369F48.avi,101,1448,1104,344,31.15942028985507,morphological_dilation,3,2
0X3A8625DCFA369F48.avi,118,1086,782,304,38.87468030690537,morphological_dilation,3,2
0X3A87C4BE51F04CDA.avi,46,1534,1210,324,26.776859504132233,morphological_dilation,3,2
0X3A87C4BE51F04CDA.avi,65,1006,734,272,37.05722070844686,morphological_dilation,3,2
0X3A8CA79BEA19FD1F.avi,0,1876,1472,404,27.445652173913043,morphological_dilation,3,2
0X3A8CA79BEA19FD1F.avi,18,1185,853,332,38.921453692848765,morphological_dilation,3,2
0X3A8ED493DA57D7C9.avi,45,1562,1215,347,28.559670781893004,morphological_dilation,3,2
0X3A8ED493DA57D7C9.avi,63,997,717,280,39.05160390516039,morphological_dilation,3,2
0X3A8F6D088C91167E.avi,48,2121,1701,420,24.691358024691358,morphological_dilation,3,2
0X3A8F6D088C91167E.avi,68,1409,1049,360,34.31839847473784,morphological_dilation,3,2
0X3A9F57EC10C1BAC7.avi,37,1603,1223,380,31.07113654946852,morphological_dilation,3,2
0X3A9F57EC10C1BAC7.avi,51,975,663,312,47.05882352941176,morphological_dilation,3,2
0X3AA01BE48EE8D367.avi,39,1410,1082,328,30.31423290203327,morphological_dilation,3,2
0X3AA01BE48EE8D367.avi,52,942,670,272,40.59701492537313,morphological_dilation,3,2
0X3AA1B577666CC8F2.avi,37,1629,1269,360,28.368794326241137,morphological_dilation,3,2
0X3AA1B577666CC8F2.avi,53,1050,724,326,45.027624309392266,morphological_dilation,3,2
0X3AA31784B8E430AF.avi,34,1697,1313,384,29.246001523229246,morphological_dilation,3,2
0X3AA31784B8E430AF.avi,47,1102,770,332,43.116883116883116,morphological_dilation,3,2
0X3AA99E66716364B0.avi,90,1833,1449,384,26.501035196687372,morphological_dilation,3,2
0X3AA99E66716364B0.avi,103,1382,1046,336,32.122370936902485,morphological_dilation,3,2
0X3AAD7B4B21165095.avi,159,1937,1529,408,26.68410725964683,morphological_dilation,3,2
0X3AAD7B4B21165095.avi,169,1232,920,312,33.91304347826087,morphological_dilation,3,2
0X3AAFF6ACE7FF7530.avi,42,1547,1191,356,29.890848026868177,morphological_dilation,3,2
0X3AAFF6ACE7FF7530.avi,59,1003,693,310,44.733044733044736,morphological_dilation,3,2
0X3AB11C73780B865.avi,47,1234,906,328,36.20309050772627,morphological_dilation,3,2
0X3AB11C73780B865.avi,61,717,461,256,55.53145336225597,morphological_dilation,3,2
0X3AB210C90632B5E3.avi,104,2146,1742,404,23.19173363949483,morphological_dilation,3,2
0X3AB210C90632B5E3.avi,127,1669,1317,352,26.727410782080486,morphological_dilation,3,2
0X3AB5343A178908A5.avi,89,1585,1229,356,28.966639544344996,morphological_dilation,3,2
0X3AB5343A178908A5.avi,100,963,675,288,42.66666666666667,morphological_dilation,3,2
0X3AB7B94F0A6C3A4C.avi,94,2068,1648,420,25.485436893203882,morphological_dilation,3,2
0X3AB7B94F0A6C3A4C.avi,110,1196,856,340,39.719626168224295,morphological_dilation,3,2
0X3AB82E8B51CB82B4.avi,38,2021,1621,400,24.676125848241824,morphological_dilation,3,2
0X3AB82E8B51CB82B4.avi,57,1429,1085,344,31.70506912442396,morphological_dilation,3,2
0X3AC15CD077FEBB79.avi,42,1561,1205,356,29.543568464730292,morphological_dilation,3,2
0X3AC15CD077FEBB79.avi,56,994,694,300,43.22766570605187,morphological_dilation,3,2
0X3AC3331F9A0AF935.avi,2,1404,1056,348,32.95454545454545,morphological_dilation,3,2
0X3AC3331F9A0AF935.avi,16,826,554,272,49.09747292418773,morphological_dilation,3,2
0X3AC5CEEB4DAAF8BF.avi,137,2306,1882,424,22.52922422954304,morphological_dilation,3,2
0X3AC5CEEB4DAAF8BF.avi,157,2073,1665,408,24.504504504504503,morphological_dilation,3,2
0X3AC5EFB793652CF6.avi,128,2256,1820,436,23.956043956043956,morphological_dilation,3,2
0X3AC5EFB793652CF6.avi,149,1837,1461,376,25.735797399041754,morphological_dilation,3,2
0X3ACB543DE5B8DC6E.avi,58,1693,1285,408,31.75097276264591,morphological_dilation,3,2
0X3ACB543DE5B8DC6E.avi,78,950,620,330,53.2258064516129,morphological_dilation,3,2
0X3ACD9DB45C258269.avi,97,1293,941,352,37.40701381509033,morphological_dilation,3,2
0X3ACD9DB45C258269.avi,105,790,489,301,61.554192229038854,morphological_dilation,3,2
0X3AD4B9300F9748BC.avi,43,1429,1077,352,32.68337975858867,morphological_dilation,3,2
0X3AD4B9300F9748BC.avi,64,1082,774,308,39.79328165374677,morphological_dilation,3,2
0X3ADFA6B8CB1E4B50.avi,107,1463,1119,344,30.741733690795353,morphological_dilation,3,2
0X3ADFA6B8CB1E4B50.avi,126,1065,765,300,39.21568627450981,morphological_dilation,3,2
0X3AE208A723F16D85.avi,86,2246,1786,460,25.755879059350505,morphological_dilation,3,2
0X3AE208A723F16D85.avi,102,1362,988,374,37.85425101214575,morphological_dilation,3,2
0X3AE232F2E17B6E19.avi,65,2120,1720,400,23.25581395348837,morphological_dilation,3,2
0X3AE232F2E17B6E19.avi,88,1766,1402,364,25.962910128388017,morphological_dilation,3,2
0X3AE5CD9B4520576A.avi,74,1514,1146,368,32.11169284467714,morphological_dilation,3,2
0X3AE5CD9B4520576A.avi,95,908,624,284,45.51282051282051,morphological_dilation,3,2
0X3AE5DC56D2D6EB43.avi,45,3402,2858,544,19.034289713086075,morphological_dilation,3,2
0X3AE5DC56D2D6EB43.avi,63,1950,1491,459,30.784708249496983,morphological_dilation,3,2
0X3AE781FF538E7AB3.avi,67,1624,1244,380,30.54662379421222,morphological_dilation,3,2
0X3AE781FF538E7AB3.avi,82,1017,713,304,42.6367461430575,morphological_dilation,3,2
0X3AE7ECDB6EF083C6.avi,72,1535,1183,352,29.754860524091292,morphological_dilation,3,2
0X3AE7ECDB6EF083C6.avi,87,1110,802,308,38.403990024937656,morphological_dilation,3,2
0X3AEB0F3ACC9C5F9E.avi,142,2758,2286,472,20.64741907261592,morphological_dilation,3,2
0X3AEB0F3ACC9C5F9E.avi,162,1702,1302,400,30.721966205837177,morphological_dilation,3,2
0X3AF27BD1C1A050F1.avi,27,1950,1550,400,25.806451612903224,morphological_dilation,3,2
0X3AF27BD1C1A050F1.avi,39,1237,893,344,38.52183650615901,morphological_dilation,3,2
0X3AF341668970568D.avi,82,1658,1290,368,28.527131782945737,morphological_dilation,3,2
0X3AF341668970568D.avi,98,1084,784,300,38.265306122448976,morphological_dilation,3,2
0X3AF4F78B11EE5786.avi,53,1887,1479,408,27.586206896551722,morphological_dilation,3,2
0X3AF4F78B11EE5786.avi,62,1194,847,347,40.968122786304605,morphological_dilation,3,2
0X3AF6861FF7D6EBE4.avi,72,1458,1104,354,32.065217391304344,morphological_dilation,3,2
0X3AF6861FF7D6EBE4.avi,99,807,527,280,53.13092979127134,morphological_dilation,3,2
0X3AF7715F4850205C.avi,56,1272,944,328,34.74576271186441,morphological_dilation,3,2
0X3AF7715F4850205C.avi,71,852,576,276,47.91666666666667,morphological_dilation,3,2
0X3AFBEFE4316A347D.avi,51,1349,1000,349,34.9,morphological_dilation,3,2
0X3AFBEFE4316A347D.avi,69,856,579,277,47.84110535405872,morphological_dilation,3,2
0X3AFC37AB794657DD.avi,115,1590,1230,360,29.268292682926827,morphological_dilation,3,2
0X3AFC37AB794657DD.avi,128,981,693,288,41.55844155844156,morphological_dilation,3,2
0X3B01B7487E3D81EA.avi,97,2186,1766,420,23.78255945639864,morphological_dilation,3,2
0X3B01B7487E3D81EA.avi,114,1901,1493,408,27.327528466175487,morphological_dilation,3,2
0X3B051BD857A8B444.avi,4,1729,1349,380,28.169014084507044,morphological_dilation,3,2
0X3B051BD857A8B444.avi,18,1357,1021,336,32.90891283055827,morphological_dilation,3,2
0X3B08A5A9B4068C8.avi,91,1520,1129,391,34.63241806908769,morphological_dilation,3,2
0X3B08A5A9B4068C8.avi,105,919,595,324,54.45378151260504,morphological_dilation,3,2
0X3B0C001E8B03BB10.avi,53,2092,1692,400,23.64066193853428,morphological_dilation,3,2
0X3B0C001E8B03BB10.avi,76,1853,1485,368,24.781144781144782,morphological_dilation,3,2
0X3B0D2D527C387A0E.avi,52,2045,1610,435,27.018633540372672,morphological_dilation,3,2
0X3B0D2D527C387A0E.avi,65,1580,1196,384,32.10702341137124,morphological_dilation,3,2
0X3B0DB4D5A796D849.avi,64,1962,1566,396,25.287356321839084,morphological_dilation,3,2
0X3B0DB4D5A796D849.avi,84,1793,1425,368,25.824561403508774,morphological_dilation,3,2
0X3B0EFA9B23EC8818.avi,36,1910,1514,396,26.1558784676354,morphological_dilation,3,2
0X3B0EFA9B23EC8818.avi,53,1135,823,312,37.91008505467801,morphological_dilation,3,2
0X3B14BC7494925CB4.avi,6,1637,1222,415,33.9607201309329,morphological_dilation,3,2
0X3B14BC7494925CB4.avi,25,1234,862,372,43.1554524361949,morphological_dilation,3,2
0X3B1588F22CB71934.avi,62,1774,1398,376,26.895565092989987,morphological_dilation,3,2
0X3B1588F22CB71934.avi,76,1042,742,300,40.43126684636118,morphological_dilation,3,2
0X3B1FFC28D7B1CE3B.avi,52,1328,996,332,33.33333333333333,morphological_dilation,3,2
0X3B1FFC28D7B1CE3B.avi,69,810,532,278,52.255639097744364,morphological_dilation,3,2
0X3B22750F2A0F254A.avi,40,2805,2301,504,21.903520208604952,morphological_dilation,3,2
0X3B22750F2A0F254A.avi,60,1813,1397,416,29.7780959198282,morphological_dilation,3,2
0X3B23F68C62732572.avi,60,1877,1497,380,25.384101536406146,morphological_dilation,3,2
0X3B23F68C62732572.avi,80,1589,1237,352,28.455941794664515,morphological_dilation,3,2
0X3B296AB590431282.avi,31,1701,1341,360,26.845637583892618,morphological_dilation,3,2
0X3B296AB590431282.avi,46,978,678,300,44.24778761061947,morphological_dilation,3,2
0X3B2972B434AE6A78.avi,2,1869,1449,420,28.985507246376812,morphological_dilation,3,2
0X3B2972B434AE6A78.avi,14,1082,762,320,41.99475065616798,morphological_dilation,3,2
0X3B2B0A52DE5AD1A8.avi,117,1387,1055,332,31.469194312796205,morphological_dilation,3,2
0X3B2B0A52DE5AD1A8.avi,137,1005,725,280,38.62068965517241,morphological_dilation,3,2
0X3B2F240FF65AE41B.avi,61,1469,1097,372,33.910665451230635,morphological_dilation,3,2
0X3B2F240FF65AE41B.avi,73,934,650,284,43.69230769230769,morphological_dilation,3,2
0X3B30E66FEF073895.avi,68,1117,821,296,36.05359317904993,morphological_dilation,3,2
0X3B30E66FEF073895.avi,85,694,446,248,55.60538116591929,morphological_dilation,3,2
0X3B31E6C62C7C6591.avi,1,1360,1028,332,32.295719844357976,morphological_dilation,3,2
0X3B31E6C62C7C6591.avi,15,1043,755,288,38.145695364238414,morphological_dilation,3,2
0X3B31EB8AE613B1A7.avi,105,2230,1763,467,26.488939307997732,morphological_dilation,3,2
0X3B31EB8AE613B1A7.avi,129,1759,1319,440,33.35860500379076,morphological_dilation,3,2
0X3B32C9427B83BD8A.avi,54,1702,1314,388,29.52815829528158,morphological_dilation,3,2
0X3B32C9427B83BD8A.avi,71,1068,760,308,40.526315789473685,morphological_dilation,3,2
0X3B331163E39CA813.avi,29,1242,942,300,31.84713375796178,morphological_dilation,3,2
0X3B331163E39CA813.avi,37,740,500,240,48.0,morphological_dilation,3,2
0X3B33B2D734EC62BD.avi,62,1595,1235,360,29.1497975708502,morphological_dilation,3,2
0X3B33B2D734EC62BD.avi,76,1138,817,321,39.290085679314565,morphological_dilation,3,2
0X3B364B92D87FAE47.avi,47,2524,2068,456,22.05029013539652,morphological_dilation,3,2
0X3B364B92D87FAE47.avi,63,1610,1238,372,30.048465266558967,morphological_dilation,3,2
0X3B466B406FD980EF.avi,48,1776,1372,404,29.44606413994169,morphological_dilation,3,2
0X3B466B406FD980EF.avi,64,1101,773,328,42.43208279430789,morphological_dilation,3,2
0X3B4FD958BC21357A.avi,32,1647,1260,387,30.714285714285715,morphological_dilation,3,2
0X3B4FD958BC21357A.avi,47,1035,723,312,43.15352697095436,morphological_dilation,3,2
0X3B54A5459841DCE8.avi,182,2104,1648,456,27.669902912621357,morphological_dilation,3,2
0X3B54A5459841DCE8.avi,197,1268,887,381,42.95377677564825,morphological_dilation,3,2
0X3B54F8E8FCFF40EB.avi,62,3015,2508,507,20.215311004784688,morphological_dilation,3,2
0X3B54F8E8FCFF40EB.avi,78,2571,2083,488,23.42774843975036,morphological_dilation,3,2
0X3B552B3CA7ADCD4.avi,60,2433,1973,460,23.314749113025847,morphological_dilation,3,2
0X3B552B3CA7ADCD4.avi,84,1544,1160,384,33.10344827586207,morphological_dilation,3,2
0X3B56BE7AED85F78A.avi,35,1605,1223,382,31.234668847097304,morphological_dilation,3,2
0X3B56BE7AED85F78A.avi,53,977,665,312,46.91729323308271,morphological_dilation,3,2
0X3B578029793AD7B5.avi,2,1670,1282,388,30.265210608424336,morphological_dilation,3,2
0X3B578029793AD7B5.avi,24,1092,764,328,42.93193717277487,morphological_dilation,3,2
0X3B5BFB5AC9060009.avi,45,1814,1438,376,26.14742698191933,morphological_dilation,3,2
0X3B5BFB5AC9060009.avi,63,1313,985,328,33.2994923857868,morphological_dilation,3,2
0X3B5F7979D1C544AC.avi,160,1801,1417,384,27.09950599858857,morphological_dilation,3,2
0X3B5F7979D1C544AC.avi,177,1178,846,332,39.2434988179669,morphological_dilation,3,2
0X3B62B3502E5549A.avi,49,1123,831,292,35.13838748495788,morphological_dilation,3,2
0X3B62B3502E5549A.avi,61,771,515,256,49.70873786407767,morphological_dilation,3,2
0X3B631332E2C4EEC3.avi,32,1472,1108,364,32.851985559566785,morphological_dilation,3,2
0X3B631332E2C4EEC3.avi,44,994,674,320,47.47774480712167,morphological_dilation,3,2
0X3B6528FD917A0E82.avi,47,2928,2444,484,19.803600654664486,morphological_dilation,3,2
0X3B6528FD917A0E82.avi,68,1810,1414,396,28.005657708628007,morphological_dilation,3,2
0X3B678EDC4E4A37B7.avi,31,1936,1490,446,29.93288590604027,morphological_dilation,3,2
0X3B678EDC4E4A37B7.avi,46,1045,717,328,45.74616457461646,morphological_dilation,3,2
0X3B67E74D2C8F04BB.avi,36,1341,1005,336,33.43283582089553,morphological_dilation,3,2
0X3B67E74D2C8F04BB.avi,48,860,568,292,51.40845070422535,morphological_dilation,3,2
0X3B6A2EE83A5CFB1B.avi,106,1953,1553,400,25.756600128783003,morphological_dilation,3,2
0X3B6A2EE83A5CFB1B.avi,120,1180,872,308,35.321100917431195,morphological_dilation,3,2
0X3B6EA00B1D3C01D5.avi,55,1693,1306,387,29.632465543644713,morphological_dilation,3,2
0X3B6EA00B1D3C01D5.avi,75,1085,761,324,42.57555847568988,morphological_dilation,3,2
0X3B6EBD8C8C9A9567.avi,143,1838,1446,392,27.10926694329184,morphological_dilation,3,2
0X3B6EBD8C8C9A9567.avi,164,1436,1085,351,32.35023041474655,morphological_dilation,3,2
0X3B73EAA40F02D974.avi,101,1521,1161,360,31.007751937984494,morphological_dilation,3,2
0X3B73EAA40F02D974.avi,121,869,589,280,47.53820033955857,morphological_dilation,3,2
0X3B75427EFE40B784.avi,88,2924,2432,492,20.230263157894736,morphological_dilation,3,2
0X3B75427EFE40B784.avi,110,2417,1966,451,22.93997965412004,morphological_dilation,3,2
0X3B76E85F3FFFB9B2.avi,47,1181,849,332,39.10482921083628,morphological_dilation,3,2
0X3B76E85F3FFFB9B2.avi,72,704,460,244,53.04347826086957,morphological_dilation,3,2
0X3B7727089F2566F0.avi,37,1594,1206,388,32.172470978441126,morphological_dilation,3,2
0X3B7727089F2566F0.avi,53,1015,679,336,49.48453608247423,morphological_dilation,3,2
0X3B7AA5C59BF84FDA.avi,88,1562,1198,364,30.38397328881469,morphological_dilation,3,2
0X3B7AA5C59BF84FDA.avi,102,935,647,288,44.513137557959816,morphological_dilation,3,2
0X3B7D20FAB496DF62.avi,0,2812,2344,468,19.965870307167236,morphological_dilation,3,2
0X3B7D20FAB496DF62.avi,22,2075,1671,404,24.177139437462596,morphological_dilation,3,2
0X3B803011C96CBE78.avi,36,2122,1702,420,24.676850763807284,morphological_dilation,3,2
0X3B803011C96CBE78.avi,50,1360,1024,336,32.8125,morphological_dilation,3,2
0X3B80677CE0873E50.avi,47,2474,1995,479,24.01002506265664,morphological_dilation,3,2
0X3B80677CE0873E50.avi,62,1736,1310,426,32.51908396946565,morphological_dilation,3,2
0X3B82E9714CF3B6A4.avi,93,2679,2223,456,20.51282051282051,morphological_dilation,3,2
0X3B82E9714CF3B6A4.avi,108,1726,1322,404,30.559757942511347,morphological_dilation,3,2
0X3B877CAB3CE51ED3.avi,83,1506,1166,340,29.15951972555746,morphological_dilation,3,2
0X3B877CAB3CE51ED3.avi,99,921,649,272,41.910631741140215,morphological_dilation,3,2
0X3B8E49B631D4E9AA.avi,46,908,640,268,41.875,morphological_dilation,3,2
0X3B8E49B631D4E9AA.avi,59,677,449,228,50.779510022271715,morphological_dilation,3,2
0X3B91490FC40F157E.avi,54,1999,1615,384,23.77708978328173,morphological_dilation,3,2
0X3B91490FC40F157E.avi,73,1578,1234,344,27.876823338735818,morphological_dilation,3,2
0X3B931BE44B0F7CEF.avi,58,1327,1011,316,31.25618199802176,morphological_dilation,3,2
0X3B931BE44B0F7CEF.avi,70,834,574,260,45.29616724738676,morphological_dilation,3,2
0X3B94C97A61200FCC.avi,55,2586,2114,472,22.327341532639547,morphological_dilation,3,2
0X3B94C97A61200FCC.avi,72,1618,1254,364,29.02711323763955,morphological_dilation,3,2
0X3B9D7438096AB76B.avi,44,1384,1048,336,32.06106870229007,morphological_dilation,3,2
0X3B9D7438096AB76B.avi,64,919,635,284,44.724409448818896,morphological_dilation,3,2
0X3B9FBD87EE113D62.avi,144,2054,1642,412,25.091352009744217,morphological_dilation,3,2
0X3B9FBD87EE113D62.avi,160,1337,987,350,35.46099290780142,morphological_dilation,3,2
0X3BA12609E25A458F.avi,111,3959,3431,528,15.389099387933546,morphological_dilation,3,2
0X3BA12609E25A458F.avi,127,2491,1992,499,25.050200803212853,morphological_dilation,3,2
0X3BA376E0E5A67F4C.avi,47,2944,2444,500,20.458265139116204,morphological_dilation,3,2
0X3BA376E0E5A67F4C.avi,66,2122,1682,440,26.159334126040427,morphological_dilation,3,2
0X3BA391DC362B4BE7.avi,51,1912,1522,390,25.624178712220765,morphological_dilation,3,2
0X3BA391DC362B4BE7.avi,67,1276,948,328,34.59915611814346,morphological_dilation,3,2
0X3BA6403DB9C2AD71.avi,40,1333,993,340,34.239677744209466,morphological_dilation,3,2
0X3BA6403DB9C2AD71.avi,55,777,513,264,51.461988304093566,morphological_dilation,3,2
0X3BA9F7C9DB0CF55B.avi,0,2833,2326,507,21.79707652622528,morphological_dilation,3,2
0X3BA9F7C9DB0CF55B.avi,35,1572,1173,399,34.015345268542205,morphological_dilation,3,2
0X3BAA632C6C366B61.avi,126,1621,1265,356,28.142292490118574,morphological_dilation,3,2
0X3BAA632C6C366B61.avi,142,1020,736,284,38.58695652173913,morphological_dilation,3,2
0X3BAE126085E973A0.avi,91,1621,1253,368,29.36951316839585,morphological_dilation,3,2
0X3BAE126085E973A0.avi,115,1003,683,320,46.85212298682284,morphological_dilation,3,2
0X3BB173537B79E344.avi,205,2616,2124,492,23.163841807909606,morphological_dilation,3,2
0X3BB173537B79E344.avi,229,1860,1460,400,27.397260273972602,morphological_dilation,3,2
0X3BB32EDB13EC2A74.avi,50,4177,3549,628,17.69512538743308,morphological_dilation,3,2
0X3BB32EDB13EC2A74.avi,73,2333,1878,455,24.22790202342918,morphological_dilation,3,2
0X3BB510E550819AA2.avi,1,1236,900,336,37.333333333333336,morphological_dilation,3,2
0X3BB510E550819AA2.avi,19,693,445,248,55.73033707865168,morphological_dilation,3,2
0X3BB59C8B26565746.avi,45,1649,1269,380,29.944838455476752,morphological_dilation,3,2
0X3BB59C8B26565746.avi,59,1011,703,308,43.81223328591749,morphological_dilation,3,2
0X3BB8002E0FD6110F.avi,42,1026,738,288,39.02439024390244,morphological_dilation,3,2
0X3BB8002E0FD6110F.avi,54,627,395,232,58.734177215189874,morphological_dilation,3,2
0X3BBB2B7BE7446182.avi,47,2690,2222,468,21.062106210621064,morphological_dilation,3,2
0X3BBB2B7BE7446182.avi,62,1846,1426,420,29.453015427769984,morphological_dilation,3,2
0X3BBE4D476015547F.avi,0,1846,1462,384,26.265389876880985,morphological_dilation,3,2
0X3BBE4D476015547F.avi,18,1130,830,300,36.144578313253014,morphological_dilation,3,2
0X3BBFB5A8F09489E2.avi,76,2888,2396,492,20.534223706176963,morphological_dilation,3,2
0X3BBFB5A8F09489E2.avi,89,1882,1474,408,27.6797829036635,morphological_dilation,3,2
0X3BC39D4DEBF4DF5F.avi,95,1334,994,340,34.205231388329985,morphological_dilation,3,2
0X3BC39D4DEBF4DF5F.avi,115,962,658,304,46.20060790273556,morphological_dilation,3,2
0X3BC67725F75CEB00.avi,58,1651,1275,376,29.490196078431374,morphological_dilation,3,2
0X3BC67725F75CEB00.avi,79,1173,865,308,35.60693641618497,morphological_dilation,3,2
0X3BC79FE68CD2CED5.avi,85,2419,1963,456,23.22975038206826,morphological_dilation,3,2
0X3BC79FE68CD2CED5.avi,100,1524,1152,372,32.29166666666667,morphological_dilation,3,2
0X3BCAEEF6C5EE3565.avi,21,4207,3627,580,15.991177281499864,morphological_dilation,3,2
0X3BCAEEF6C5EE3565.avi,29,3675,3143,532,16.926503340757236,morphological_dilation,3,2
0X3BD7B111C743A3E8.avi,20,1208,900,308,34.22222222222222,morphological_dilation,3,2
0X3BD7B111C743A3E8.avi,32,815,551,264,47.91288566243194,morphological_dilation,3,2
0X3BD86D7A28CDA981.avi,0,1729,1357,372,27.413411938098747,morphological_dilation,3,2
0X3BD86D7A28CDA981.avi,15,990,698,292,41.833810888252145,morphological_dilation,3,2
0X3BDD6A56EDE84B37.avi,107,2096,1676,420,25.059665871121716,morphological_dilation,3,2
0X3BDD6A56EDE84B37.avi,125,1306,950,356,37.473684210526315,morphological_dilation,3,2
0X3BE0524B897D6DCF.avi,45,1506,1158,348,30.05181347150259,morphological_dilation,3,2
0X3BE0524B897D6DCF.avi,59,952,664,288,43.373493975903614,morphological_dilation,3,2
0X3BE346AF6B1F7F3D.avi,77,3345,2805,540,19.25133689839572,morphological_dilation,3,2
0X3BE346AF6B1F7F3D.avi,94,1877,1461,416,28.473648186173854,morphological_dilation,3,2
0X3BE3B298ACB92FB1.avi,151,1058,770,288,37.4025974025974,morphological_dilation,3,2
0X3BE3B298ACB92FB1.avi,164,663,431,232,53.82830626450116,morphological_dilation,3,2
0X3BE4253D023C725E.avi,68,1836,1440,396,27.500000000000004,morphological_dilation,3,2
0X3BE4253D023C725E.avi,91,1209,873,336,38.48797250859107,morphological_dilation,3,2
0X3BE4BB11401AFD70.avi,47,1923,1523,400,26.263952724885097,morphological_dilation,3,2
0X3BE4BB11401AFD70.avi,67,1275,943,332,35.2067868504772,morphological_dilation,3,2
0X3BE6ED32D643E96.avi,42,2104,1688,416,24.644549763033176,morphological_dilation,3,2
0X3BE6ED32D643E96.avi,61,1183,871,312,35.82089552238806,morphological_dilation,3,2
0X3BE6EEE3814E2D16.avi,45,2669,2205,464,21.04308390022676,morphological_dilation,3,2
0X3BE6EEE3814E2D16.avi,62,1556,1188,368,30.976430976430976,morphological_dilation,3,2
0X3BEEF9FC14A7E660.avi,82,1503,1135,368,32.42290748898679,morphological_dilation,3,2
0X3BEEF9FC14A7E660.avi,102,1224,904,320,35.39823008849557,morphological_dilation,3,2
0X3BF2052B5989097E.avi,50,1337,1005,332,33.03482587064677,morphological_dilation,3,2
0X3BF2052B5989097E.avi,65,785,529,256,48.39319470699433,morphological_dilation,3,2
0X3BF45BED0E9423D0.avi,42,1531,1163,368,31.64230438521066,morphological_dilation,3,2
0X3BF45BED0E9423D0.avi,54,1036,732,304,41.53005464480874,morphological_dilation,3,2
0X3BF4EAA8E0239D15.avi,43,1622,1242,380,30.595813204508858,morphological_dilation,3,2
0X3BF4EAA8E0239D15.avi,57,1062,738,324,43.90243902439025,morphological_dilation,3,2
0X3BFAE73D52A18389.avi,12,3439,2895,544,18.791018998272886,morphological_dilation,3,2
0X3BFAE73D52A18389.avi,32,2663,2175,488,22.436781609195403,morphological_dilation,3,2
0X3BFC66B250CE89A9.avi,94,1738,1366,372,27.232796486090777,morphological_dilation,3,2
0X3BFC66B250CE89A9.avi,105,1037,725,312,43.03448275862069,morphological_dilation,3,2
0X3BFD07170E3ECF82.avi,116,1670,1282,388,30.265210608424336,morphological_dilation,3,2
0X3BFD07170E3ECF82.avi,128,937,617,320,51.86385737439222,morphological_dilation,3,2
0X3BFFB8615C86AE75.avi,56,2029,1617,412,25.479282622139763,morphological_dilation,3,2
0X3BFFB8615C86AE75.avi,72,1321,993,328,33.03121852970796,morphological_dilation,3,2
0X3C01B72B850884FE.avi,55,1296,960,336,35.0,morphological_dilation,3,2
0X3C01B72B850884FE.avi,75,841,561,280,49.9108734402852,morphological_dilation,3,2
0X3C05A6B4BBA623EB.avi,0,1720,1360,360,26.47058823529412,morphological_dilation,3,2
0X3C05A6B4BBA623EB.avi,17,1362,1046,316,30.210325047801145,morphological_dilation,3,2
0X3C0B954729E57D23.avi,77,1670,1290,380,29.457364341085274,morphological_dilation,3,2
0X3C0B954729E57D23.avi,104,997,685,312,45.54744525547445,morphological_dilation,3,2
0X3C0E58FD3198CE78.avi,75,906,638,268,42.00626959247649,morphological_dilation,3,2
0X3C0E58FD3198CE78.avi,87,567,347,220,63.40057636887608,morphological_dilation,3,2
0X3C10C1CAA3095680.avi,46,1629,1261,368,29.183187946074547,morphological_dilation,3,2
0X3C10C1CAA3095680.avi,59,1109,793,316,39.84867591424969,morphological_dilation,3,2
0X3C10FEA4A7AA072E.avi,132,1933,1509,424,28.098078197481772,morphological_dilation,3,2
0X3C10FEA4A7AA072E.avi,143,1104,780,324,41.53846153846154,morphological_dilation,3,2
0X3C1488440F282158.avi,86,1867,1467,400,27.266530334015,morphological_dilation,3,2
0X3C1488440F282158.avi,101,1152,820,332,40.487804878048784,morphological_dilation,3,2
0X3C1724919FD1F5F3.avi,60,2335,1875,460,24.53333333333333,morphological_dilation,3,2
0X3C1724919FD1F5F3.avi,74,1604,1224,380,31.045751633986928,morphological_dilation,3,2
0X3C18E7594F18AEB9.avi,84,1548,1176,372,31.63265306122449,morphological_dilation,3,2
0X3C18E7594F18AEB9.avi,102,890,571,319,55.86690017513135,morphological_dilation,3,2
0X3C1C3E87980982AA.avi,35,1374,1010,364,36.039603960396036,morphological_dilation,3,2
0X3C1C3E87980982AA.avi,48,1246,910,336,36.92307692307693,morphological_dilation,3,2
0X3C1D516F4D4D105B.avi,64,1750,1350,400,29.629629629629626,morphological_dilation,3,2
0X3C1D516F4D4D105B.avi,82,1018,691,327,47.32272069464544,morphological_dilation,3,2
0X3C1E9131F69E4821.avi,135,2766,2274,492,21.63588390501319,morphological_dilation,3,2
0X3C1E9131F69E4821.avi,154,1858,1435,423,29.477351916376303,morphological_dilation,3,2
0X3C1F4A30EA25362E.avi,36,1463,1111,352,31.683168316831683,morphological_dilation,3,2
0X3C1F4A30EA25362E.avi,54,899,624,275,44.07051282051282,morphological_dilation,3,2
0X3C207E8489AD5BAE.avi,100,1840,1445,395,27.33564013840831,morphological_dilation,3,2
0X3C207E8489AD5BAE.avi,114,1089,773,316,40.879689521345405,morphological_dilation,3,2
0X3C214412B9774A5C.avi,95,2335,1891,444,23.479640401903755,morphological_dilation,3,2
0X3C214412B9774A5C.avi,105,1426,1046,380,36.32887189292543,morphological_dilation,3,2
0X3C2544AC6E008D62.avi,51,1415,1063,352,33.11382878645344,morphological_dilation,3,2
0X3C2544AC6E008D62.avi,71,876,596,280,46.97986577181208,morphological_dilation,3,2
0X3C28EECDC72E0A31.avi,108,1726,1338,388,28.998505231689087,morphological_dilation,3,2
0X3C28EECDC72E0A31.avi,122,997,712,285,40.02808988764045,morphological_dilation,3,2
0X3C29707A418FF73A.avi,44,1181,857,324,37.80630105017503,morphological_dilation,3,2
0X3C29707A418FF73A.avi,55,787,511,276,54.01174168297456,morphological_dilation,3,2
0X3C2DCCC974C5380D.avi,42,1212,892,320,35.874439461883405,morphological_dilation,3,2
0X3C2DCCC974C5380D.avi,64,732,480,252,52.5,morphological_dilation,3,2
0X3C2E350B97C8F6CD.avi,40,1591,1235,356,28.825910931174086,morphological_dilation,3,2
0X3C2E350B97C8F6CD.avi,53,1045,737,308,41.7910447761194,morphological_dilation,3,2
0X3C3AAA44DBD1EC3D.avi,62,2902,2402,500,20.815986677768525,morphological_dilation,3,2
0X3C3AAA44DBD1EC3D.avi,78,1610,1217,393,32.29252259654889,morphological_dilation,3,2
0X3C3C53B0F4B5AD69.avi,90,1323,987,336,34.04255319148936,morphological_dilation,3,2
0X3C3C53B0F4B5AD69.avi,106,858,559,299,53.48837209302325,morphological_dilation,3,2
0X3C3C930EC09E4FA0.avi,64,1471,1139,332,29.148375768217733,morphological_dilation,3,2
0X3C3C930EC09E4FA0.avi,79,1063,787,276,35.06988564167726,morphological_dilation,3,2
0X3C456FD0C7FE2F99.avi,70,2036,1608,428,26.616915422885572,morphological_dilation,3,2
0X3C456FD0C7FE2F99.avi,81,1351,984,367,37.296747967479675,morphological_dilation,3,2
0X3C48AA6205472D1F.avi,70,2320,1868,452,24.197002141327623,morphological_dilation,3,2
0X3C48AA6205472D1F.avi,83,1893,1465,428,29.215017064846414,morphological_dilation,3,2
0X3C4A698888698E8D.avi,55,2297,1849,448,24.229313142239047,morphological_dilation,3,2
0X3C4A698888698E8D.avi,77,1691,1283,408,31.80046765393609,morphological_dilation,3,2
0X3C4BE41655860B16.avi,209,2526,2050,476,23.219512195121954,morphological_dilation,3,2
0X3C4BE41655860B16.avi,236,1434,1000,434,43.4,morphological_dilation,3,2
0X3C4F8E30B6FB805F.avi,102,1768,1384,384,27.74566473988439,morphological_dilation,3,2
0X3C4F8E30B6FB805F.avi,118,1178,846,332,39.2434988179669,morphological_dilation,3,2
0X3C539D3821B4C6C3.avi,133,917,622,295,47.42765273311897,morphological_dilation,3,2
0X3C539D3821B4C6C3.avi,156,640,388,252,64.94845360824742,morphological_dilation,3,2
0X3C53CAB06AA69C4E.avi,32,1324,992,332,33.46774193548387,morphological_dilation,3,2
0X3C53CAB06AA69C4E.avi,44,759,488,271,55.5327868852459,morphological_dilation,3,2
0X3C56DA933D255BF8.avi,143,1905,1521,384,25.2465483234714,morphological_dilation,3,2
0X3C56DA933D255BF8.avi,160,1159,843,316,37.48517200474496,morphological_dilation,3,2
0X3C5A6B5C6A66C7C0.avi,136,1248,916,332,36.24454148471616,morphological_dilation,3,2
0X3C5A6B5C6A66C7C0.avi,147,819,539,280,51.94805194805194,morphological_dilation,3,2
0X3C5E3047DEC19504.avi,60,2062,1603,459,28.63381160324392,morphological_dilation,3,2
0X3C5E3047DEC19504.avi,73,1275,854,421,49.29742388758782,morphological_dilation,3,2
0X3C63C23E5B0823D.avi,0,1533,1187,346,29.14911541701769,morphological_dilation,3,2
0X3C63C23E5B0823D.avi,15,1612,1159,453,39.085418464193275,morphological_dilation,3,2
0X3C67FDA7B1C1ECFB.avi,40,1702,1310,392,29.923664122137406,morphological_dilation,3,2
0X3C67FDA7B1C1ECFB.avi,52,957,657,300,45.662100456621005,morphological_dilation,3,2
0X3C68A75B6DE0D08C.avi,31,1410,1062,348,32.7683615819209,morphological_dilation,3,2
0X3C68A75B6DE0D08C.avi,41,806,514,292,56.809338521400775,morphological_dilation,3,2
0X3C6F96F86CD908BD.avi,121,1652,1284,368,28.66043613707165,morphological_dilation,3,2
0X3C6F96F86CD908BD.avi,139,1075,767,308,40.15645371577575,morphological_dilation,3,2
0X3C7BC046308348F6.avi,74,1596,1232,364,29.545454545454547,morphological_dilation,3,2
0X3C7BC046308348F6.avi,91,950,662,288,43.50453172205438,morphological_dilation,3,2
0X3C7E3932E8C3BFFE.avi,66,1518,1150,368,32.0,morphological_dilation,3,2
0X3C7E3932E8C3BFFE.avi,84,980,676,304,44.97041420118343,morphological_dilation,3,2
0X3C7EF15C4B7BEEA1.avi,40,1511,1171,340,29.035012809564474,morphological_dilation,3,2
0X3C7EF15C4B7BEEA1.avi,55,1060,756,304,40.21164021164021,morphological_dilation,3,2
0X3C8AE3EFC3758990.avi,67,3019,2523,496,19.659135949266744,morphological_dilation,3,2
0X3C8AE3EFC3758990.avi,86,2390,1954,436,22.313203684749233,morphological_dilation,3,2
0X3C8EB3097C147507.avi,4,2764,2280,484,21.228070175438596,morphological_dilation,3,2
0X3C8EB3097C147507.avi,17,1701,1325,376,28.37735849056604,morphological_dilation,3,2
0X3C9463D76CD9D31D.avi,109,1856,1436,420,29.247910863509752,morphological_dilation,3,2
0X3C9463D76CD9D31D.avi,128,1164,809,355,43.88133498145859,morphological_dilation,3,2
0X3C990664C618D934.avi,4,1195,875,320,36.57142857142857,morphological_dilation,3,2
0X3C990664C618D934.avi,20,745,485,260,53.608247422680414,morphological_dilation,3,2
0X3C9E605F756EA1A7.avi,3,1655,1275,380,29.80392156862745,morphological_dilation,3,2
0X3C9E605F756EA1A7.avi,19,1040,716,324,45.2513966480447,morphological_dilation,3,2
0X3CA062FAAA9EFB99.avi,150,1586,1238,348,28.109854604200322,morphological_dilation,3,2
0X3CA062FAAA9EFB99.avi,170,1058,754,304,40.318302387267906,morphological_dilation,3,2
0X3CA164EF7A7C434E.avi,47,2437,2021,416,20.58386937159822,morphological_dilation,3,2
0X3CA164EF7A7C434E.avi,61,2303,1880,423,22.5,morphological_dilation,3,2
0X3CA5F8D4ADB6829.avi,44,1889,1489,400,26.863666890530556,morphological_dilation,3,2
0X3CA5F8D4ADB6829.avi,58,1216,892,324,36.32286995515695,morphological_dilation,3,2
0X3CA6AD191674E7F3.avi,60,2321,1885,436,23.129973474801062,morphological_dilation,3,2
0X3CA6AD191674E7F3.avi,78,1373,1037,336,32.401157184185145,morphological_dilation,3,2
0X3CB03161634EC101.avi,53,1494,1138,356,31.282952548330407,morphological_dilation,3,2
0X3CB03161634EC101.avi,70,1133,818,315,38.50855745721272,morphological_dilation,3,2
0X3CB10C063C914079.avi,155,1503,1147,356,31.03748910200523,morphological_dilation,3,2
0X3CB10C063C914079.avi,170,916,640,276,43.125,morphological_dilation,3,2
0X3CB30E851B8FBC78.avi,54,1482,1134,348,30.687830687830687,morphological_dilation,3,2
0X3CB30E851B8FBC78.avi,68,844,560,284,50.71428571428571,morphological_dilation,3,2
0X3CB7489A1A24C46B.avi,53,2888,2412,476,19.734660033167494,morphological_dilation,3,2
0X3CB7489A1A24C46B.avi,71,2016,1612,404,25.06203473945409,morphological_dilation,3,2
0X3CBDF15DCB01AF08.avi,83,1721,1341,380,28.33706189410887,morphological_dilation,3,2
0X3CBDF15DCB01AF08.avi,99,979,679,300,44.18262150220913,morphological_dilation,3,2
0X3CC1B60D1EB0CC43.avi,73,2293,1850,443,23.945945945945944,morphological_dilation,3,2
0X3CC1B60D1EB0CC43.avi,99,1355,1007,348,34.55809334657398,morphological_dilation,3,2
0X3CC2AB71D7704B20.avi,54,2723,2255,468,20.753880266075388,morphological_dilation,3,2
0X3CC2AB71D7704B20.avi,68,2395,1947,448,23.00975860297894,morphological_dilation,3,2
0X3CC63FF01D85B689.avi,43,1179,883,296,33.52208380520951,morphological_dilation,3,2
0X3CC63FF01D85B689.avi,57,686,446,240,53.81165919282511,morphological_dilation,3,2
0X3CC86A7AC66865CC.avi,109,2747,2283,464,20.324134910205867,morphological_dilation,3,2
0X3CC86A7AC66865CC.avi,130,1909,1505,404,26.843853820598007,morphological_dilation,3,2
0X3CCC712117D9D487.avi,29,1593,1245,348,27.951807228915666,morphological_dilation,3,2
0X3CCC712117D9D487.avi,40,1061,761,300,39.42181340341656,morphological_dilation,3,2
0X3CCC98A57DEBD70F.avi,0,2210,1802,408,22.641509433962266,morphological_dilation,3,2
0X3CCC98A57DEBD70F.avi,20,1203,887,316,35.62570462232244,morphological_dilation,3,2
0X3CCE67A145CD0C46.avi,121,1437,1088,349,32.07720588235294,morphological_dilation,3,2
0X3CCE67A145CD0C46.avi,142,915,621,294,47.34299516908212,morphological_dilation,3,2
0X3CD460CFB766061A.avi,28,1077,781,296,37.900128040973115,morphological_dilation,3,2
0X3CD460CFB766061A.avi,39,696,444,252,56.75675675675676,morphological_dilation,3,2
0X3CD5272915885147.avi,85,1619,1247,372,29.83159582999198,morphological_dilation,3,2
0X3CD5272915885147.avi,97,816,556,260,46.76258992805755,morphological_dilation,3,2
0X3CDBEFCEB9B8880A.avi,48,1671,1323,348,26.303854875283445,morphological_dilation,3,2
0X3CDBEFCEB9B8880A.avi,65,1057,773,284,36.73997412677878,morphological_dilation,3,2
0X3CE02140AB9185AA.avi,2,1600,1224,376,30.718954248366014,morphological_dilation,3,2
0X3CE02140AB9185AA.avi,17,1102,800,302,37.75,morphological_dilation,3,2
0X3CEA8556432BE7BC.avi,127,1597,1241,356,28.68654311039484,morphological_dilation,3,2
0X3CEA8556432BE7BC.avi,148,1028,736,292,39.67391304347826,morphological_dilation,3,2
0X3CEEFB97FDD529F6.avi,111,2715,2223,492,22.13225371120108,morphological_dilation,3,2
0X3CEEFB97FDD529F6.avi,124,1564,1184,380,32.0945945945946,morphological_dilation,3,2
0X3CF4BCE027237660.avi,91,1047,716,331,46.229050279329606,morphological_dilation,3,2
0X3CF4BCE027237660.avi,107,680,424,256,60.37735849056604,morphological_dilation,3,2
0X3CF60A132BD7B415.avi,24,1463,1115,348,31.210762331838566,morphological_dilation,3,2
0X3CF60A132BD7B415.avi,36,1127,819,308,37.60683760683761,morphological_dilation,3,2
0X3CF7C368106B59F2.avi,30,2169,1685,484,28.724035608308608,morphological_dilation,3,2
0X3CF7C368106B59F2.avi,45,1406,1002,404,40.31936127744511,morphological_dilation,3,2
0X3CF920996FE95ADD.avi,41,2354,1934,420,21.71664943123061,morphological_dilation,3,2
0X3CF920996FE95ADD.avi,58,1500,1152,348,30.208333333333332,morphological_dilation,3,2
0X3CF93606C249E004.avi,108,1242,942,300,31.84713375796178,morphological_dilation,3,2
0X3CF93606C249E004.avi,129,774,530,244,46.0377358490566,morphological_dilation,3,2
0X3CF952AD9FD34D08.avi,51,2075,1679,396,23.5854675402025,morphological_dilation,3,2
0X3CF952AD9FD34D08.avi,63,1658,1302,356,27.342549923195087,morphological_dilation,3,2
0X3CFB24DC0CD3A91E.avi,124,1621,1257,364,28.957836117740655,morphological_dilation,3,2
0X3CFB24DC0CD3A91E.avi,145,900,608,292,48.026315789473685,morphological_dilation,3,2
0X3CFBD509C0C1139C.avi,88,1789,1401,388,27.69450392576731,morphological_dilation,3,2
0X3CFBD509C0C1139C.avi,105,1091,779,312,40.05134788189987,morphological_dilation,3,2
0X3D02DA95E6C72181.avi,39,2135,1695,440,25.958702064896755,morphological_dilation,3,2
0X3D02DA95E6C72181.avi,55,1745,1345,400,29.739776951672862,morphological_dilation,3,2
0X3D045BDA30F1FBBC.avi,209,2364,1908,456,23.89937106918239,morphological_dilation,3,2
0X3D045BDA30F1FBBC.avi,234,1448,1084,364,33.579335793357934,morphological_dilation,3,2
0X3D04E9B90266352E.avi,62,1687,1311,376,28.680396643783375,morphological_dilation,3,2
0X3D04E9B90266352E.avi,79,1335,977,358,36.642784032753326,morphological_dilation,3,2
0X3D058CE72C565376.avi,49,1737,1317,420,31.890660592255127,morphological_dilation,3,2
0X3D058CE72C565376.avi,68,1005,701,304,43.36661911554921,morphological_dilation,3,2
0X3D07B11AAF49F722.avi,107,1840,1440,400,27.77777777777778,morphological_dilation,3,2
0X3D07B11AAF49F722.avi,123,1257,925,332,35.891891891891895,morphological_dilation,3,2
0X3D0F47DF1809F2DD.avi,2,1531,1175,356,30.29787234042553,morphological_dilation,3,2
0X3D0F47DF1809F2DD.avi,16,1018,718,300,41.78272980501393,morphological_dilation,3,2
0X3D1241A509AEDD5D.avi,116,1998,1574,424,26.937738246505717,morphological_dilation,3,2
0X3D1241A509AEDD5D.avi,143,1323,959,364,37.95620437956204,morphological_dilation,3,2
0X3D1676A87AECCD69.avi,64,1102,794,308,38.79093198992443,morphological_dilation,3,2
0X3D1676A87AECCD69.avi,77,695,443,252,56.884875846501124,morphological_dilation,3,2
0X3D1BC917DF22CD1C.avi,111,1083,779,304,39.02439024390244,morphological_dilation,3,2
0X3D1BC917DF22CD1C.avi,122,717,457,260,56.89277899343544,morphological_dilation,3,2
0X3D27B5899DFF0F5B.avi,151,1431,1083,348,32.13296398891966,morphological_dilation,3,2
0X3D27B5899DFF0F5B.avi,163,903,619,284,45.880452342487885,morphological_dilation,3,2
0X3D2B3C9081953DBF.avi,79,1571,1223,348,28.454619787408014,morphological_dilation,3,2
0X3D2B3C9081953DBF.avi,97,986,702,284,40.45584045584046,morphological_dilation,3,2
0X3D2FBDFA09694A20.avi,66,1814,1438,376,26.14742698191933,morphological_dilation,3,2
0X3D2FBDFA09694A20.avi,82,1135,835,300,35.92814371257485,morphological_dilation,3,2
0X3D39E510C89F3D8A.avi,38,1319,959,360,37.53910323253389,morphological_dilation,3,2
0X3D39E510C89F3D8A.avi,53,857,557,300,53.85996409335727,morphological_dilation,3,2
0X3D3A944C969D30E.avi,63,2925,2417,508,21.017790649565576,morphological_dilation,3,2
0X3D3A944C969D30E.avi,82,1986,1542,444,28.793774319066145,morphological_dilation,3,2
0X3D3B33569911F8E9.avi,86,1412,1056,356,33.71212121212121,morphological_dilation,3,2
0X3D3B33569911F8E9.avi,101,802,530,272,51.320754716981135,morphological_dilation,3,2
0X3D3DB395AA082092.avi,71,2320,1893,427,22.556788166930797,morphological_dilation,3,2
0X3D3DB395AA082092.avi,87,1523,1183,340,28.740490278951818,morphological_dilation,3,2
0X3D3F1825094494A8.avi,60,1423,1079,344,31.881371640407785,morphological_dilation,3,2
0X3D3F1825094494A8.avi,72,1038,729,309,42.38683127572017,morphological_dilation,3,2
0X3D403DF4736012FA.avi,80,1455,1108,347,31.31768953068592,morphological_dilation,3,2
0X3D403DF4736012FA.avi,98,907,631,276,43.74009508716323,morphological_dilation,3,2
0X3D407167B0EA095C.avi,137,1330,1010,320,31.683168316831683,morphological_dilation,3,2
0X3D407167B0EA095C.avi,152,900,624,276,44.230769230769226,morphological_dilation,3,2
0X3D41C6447029BE0E.avi,83,1865,1465,400,27.303754266211605,morphological_dilation,3,2
0X3D41C6447029BE0E.avi,100,1251,920,331,35.97826086956522,morphological_dilation,3,2
0X3D42EBE6DAD6A388.avi,86,1343,1015,328,32.31527093596059,morphological_dilation,3,2
0X3D42EBE6DAD6A388.avi,107,848,588,260,44.21768707482993,morphological_dilation,3,2
0X3D451D3B3946A2D.avi,81,2803,2328,475,20.403780068728523,morphological_dilation,3,2
0X3D451D3B3946A2D.avi,97,1996,1585,411,25.930599369085172,morphological_dilation,3,2
0X3D490017BDE7B6EE.avi,104,3135,2643,492,18.615209988649262,morphological_dilation,3,2
0X3D490017BDE7B6EE.avi,132,2517,2047,470,22.960429897410844,morphological_dilation,3,2
0X3D536804F75D24EB.avi,72,2213,1761,452,25.66723452583759,morphological_dilation,3,2
0X3D536804F75D24EB.avi,88,1509,1121,388,34.611953612845674,morphological_dilation,3,2
0X3D5444E2DD4FB625.avi,60,3998,3398,600,17.657445556209534,morphological_dilation,3,2
0X3D5444E2DD4FB625.avi,81,2544,2040,504,24.705882352941178,morphological_dilation,3,2
0X3D595A1C7728A00B.avi,54,1290,946,344,36.36363636363637,morphological_dilation,3,2
0X3D595A1C7728A00B.avi,73,844,568,276,48.59154929577465,morphological_dilation,3,2
0X3D5C0E6B4A194D33.avi,39,2769,2262,507,22.413793103448278,morphological_dilation,3,2
0X3D5C0E6B4A194D33.avi,55,1940,1500,440,29.333333333333332,morphological_dilation,3,2
0X3D5F894D74A3D21C.avi,121,1828,1432,396,27.6536312849162,morphological_dilation,3,2
0X3D5F894D74A3D21C.avi,134,1527,1164,363,31.185567010309278,morphological_dilation,3,2
0X3D63829F3F3D8C85.avi,63,1839,1459,380,26.04523646333105,morphological_dilation,3,2
0X3D63829F3F3D8C85.avi,79,1296,960,336,35.0,morphological_dilation,3,2
0X3D66A6CF6230C66.avi,32,2848,2373,475,20.01685630004214,morphological_dilation,3,2
0X3D66A6CF6230C66.avi,49,1663,1291,372,28.814872192099152,morphological_dilation,3,2
0X3D6D79A159FD4A12.avi,108,3004,2516,488,19.395866454689983,morphological_dilation,3,2
0X3D6D79A159FD4A12.avi,123,2582,2138,444,20.767072029934518,morphological_dilation,3,2
0X3D6E773C9BEA8474.avi,115,4428,3786,642,16.957210776545168,morphological_dilation,3,2
0X3D6E773C9BEA8474.avi,134,2354,1862,492,26.423200859291086,morphological_dilation,3,2
0X3D74EF75B61DFE76.avi,237,1714,1338,376,28.101644245142005,morphological_dilation,3,2
0X3D74EF75B61DFE76.avi,269,1141,823,318,38.639125151883356,morphological_dilation,3,2
0X3D7715AB0A91C268.avi,62,2639,2183,456,20.888685295464956,morphological_dilation,3,2
0X3D7715AB0A91C268.avi,88,1944,1540,404,26.233766233766232,morphological_dilation,3,2
0X3D775CE5815FC482.avi,100,1894,1471,423,28.755948334466346,morphological_dilation,3,2
0X3D775CE5815FC482.avi,117,1107,734,373,50.817438692098094,morphological_dilation,3,2
0X3D7C7B6AFF1A89F9.avi,94,2464,1996,468,23.446893787575153,morphological_dilation,3,2
0X3D7C7B6AFF1A89F9.avi,114,1455,1083,372,34.34903047091413,morphological_dilation,3,2
0X3D829DE5E49B5761.avi,40,1633,1277,356,27.877838684416602,morphological_dilation,3,2
0X3D829DE5E49B5761.avi,57,829,585,244,41.70940170940171,morphological_dilation,3,2
0X3D8353611168F743.avi,43,1305,874,431,49.31350114416476,morphological_dilation,3,2
0X3D8353611168F743.avi,58,885,593,292,49.24114671163575,morphological_dilation,3,2
0X3D856D0C128BEF63.avi,43,2016,1593,423,26.55367231638418,morphological_dilation,3,2
0X3D856D0C128BEF63.avi,67,1274,926,348,37.580993520518355,morphological_dilation,3,2
0X3D858B954AD5D2FA.avi,41,2223,1803,420,23.294509151414307,morphological_dilation,3,2
0X3D858B954AD5D2FA.avi,58,1381,1037,344,33.17261330761813,morphological_dilation,3,2
0X3D8A8864DB8B12E.avi,53,1642,1250,392,31.36,morphological_dilation,3,2
0X3D8A8864DB8B12E.avi,67,1063,735,328,44.625850340136054,morphological_dilation,3,2
0X3D8B6D455EECFE25.avi,48,2243,1789,454,25.377305757406372,morphological_dilation,3,2
0X3D8B6D455EECFE25.avi,68,1454,1090,364,33.39449541284404,morphological_dilation,3,2
0X3D8EE56C7B00E120.avi,62,2314,1870,444,23.74331550802139,morphological_dilation,3,2
0X3D8EE56C7B00E120.avi,89,1951,1551,400,25.78981302385558,morphological_dilation,3,2
0X3D93FC3FB436EC51.avi,54,1554,1198,356,29.716193656093488,morphological_dilation,3,2
0X3D93FC3FB436EC51.avi,68,1292,958,334,34.864300626304804,morphological_dilation,3,2
0X3D94B49D5A396636.avi,131,2700,2208,492,22.282608695652172,morphological_dilation,3,2
0X3D94B49D5A396636.avi,150,1546,1158,388,33.506044905008636,morphological_dilation,3,2
0X3D9576C39233FCCF.avi,4,1550,1206,344,28.524046434494192,morphological_dilation,3,2
0X3D9576C39233FCCF.avi,15,1410,1080,330,30.555555555555557,morphological_dilation,3,2
0X3D982D1B05D54EE.avi,2,1151,847,304,35.891381345926796,morphological_dilation,3,2
0X3D982D1B05D54EE.avi,17,677,441,236,53.51473922902494,morphological_dilation,3,2
0X3DA2B290B58A6540.avi,49,2556,2100,456,21.714285714285715,morphological_dilation,3,2
0X3DA2B290B58A6540.avi,68,2045,1641,404,24.619134673979282,morphological_dilation,3,2
0X3DAB48A224B6D7D8.avi,0,1179,851,328,38.54289071680376,morphological_dilation,3,2
0X3DAB48A224B6D7D8.avi,14,833,557,276,49.55116696588869,morphological_dilation,3,2
0X3DAD6456C3A92CD6.avi,127,1997,1601,396,24.734540911930043,morphological_dilation,3,2
0X3DAD6456C3A92CD6.avi,145,1316,980,336,34.285714285714285,morphological_dilation,3,2
0X3DAEE457C2318B8.avi,41,1680,1324,356,26.888217522658607,morphological_dilation,3,2
0X3DAEE457C2318B8.avi,52,1095,786,309,39.31297709923664,morphological_dilation,3,2
0X3DAFB661E3500C9F.avi,52,2122,1690,432,25.562130177514792,morphological_dilation,3,2
0X3DAFB661E3500C9F.avi,62,2007,1595,412,25.830721003134798,morphological_dilation,3,2
0X3DB63E43A23F46D3.avi,101,1134,818,316,38.63080684596577,morphological_dilation,3,2
0X3DB63E43A23F46D3.avi,120,790,534,256,47.940074906367045,morphological_dilation,3,2
0X3DB7EB2C0003CD50.avi,32,1871,1435,436,30.383275261324044,morphological_dilation,3,2
0X3DB7EB2C0003CD50.avi,48,1209,815,394,48.34355828220859,morphological_dilation,3,2
0X3DBA4134C729B96D.avi,50,1294,966,328,33.95445134575569,morphological_dilation,3,2
0X3DBA4134C729B96D.avi,66,888,596,292,48.99328859060403,morphological_dilation,3,2
0X3DBBF3506D11ACF5.avi,71,1802,1430,372,26.013986013986013,morphological_dilation,3,2
0X3DBBF3506D11ACF5.avi,87,1180,876,304,34.70319634703196,morphological_dilation,3,2
0X3DBF6E850E8E7FA.avi,1,1146,846,300,35.46099290780142,morphological_dilation,3,2
0X3DBF6E850E8E7FA.avi,6,707,447,260,58.16554809843401,morphological_dilation,3,2
0X3DC0EC09F9CDBCCB.avi,54,1743,1367,376,27.505486466715436,morphological_dilation,3,2
0X3DC0EC09F9CDBCCB.avi,74,1190,867,323,37.254901960784316,morphological_dilation,3,2
0X3DC339BAEDC91F8C.avi,49,2304,1852,452,24.406047516198704,morphological_dilation,3,2
0X3DC339BAEDC91F8C.avi,65,1407,1040,367,35.28846153846154,morphological_dilation,3,2
0X3DC771421B48F300.avi,90,1783,1395,388,27.813620071684586,morphological_dilation,3,2
0X3DC771421B48F300.avi,104,1112,812,300,36.94581280788177,morphological_dilation,3,2
0X3DC981FD3E796896.avi,0,2088,1660,428,25.783132530120483,morphological_dilation,3,2
0X3DC981FD3E796896.avi,14,1635,1253,382,30.486831604150037,morphological_dilation,3,2
0X3DCE831133A8B66C.avi,60,1913,1513,400,26.437541308658297,morphological_dilation,3,2
0X3DCE831133A8B66C.avi,78,1148,828,320,38.64734299516908,morphological_dilation,3,2
0X3DD2E68A5BE7A4FE.avi,129,1441,1093,348,31.83897529734675,morphological_dilation,3,2
0X3DD2E68A5BE7A4FE.avi,149,857,593,264,44.51939291736931,morphological_dilation,3,2
0X3DD6E63CFB42333E.avi,4,2275,1859,416,22.377622377622377,morphological_dilation,3,2
0X3DD6E63CFB42333E.avi,15,1455,1091,364,33.36388634280477,morphological_dilation,3,2
0X3DD8AAB0045765B9.avi,113,2433,2013,420,20.864381520119224,morphological_dilation,3,2
0X3DD8AAB0045765B9.avi,136,2126,1734,392,22.606689734717417,morphological_dilation,3,2
0X3DDFCD65C68B3AF6.avi,53,2472,2024,448,22.134387351778656,morphological_dilation,3,2
0X3DDFCD65C68B3AF6.avi,70,1819,1404,415,29.55840455840456,morphological_dilation,3,2
0X3DE081EA128A37EB.avi,116,2215,1803,412,22.85080421519689,morphological_dilation,3,2
0X3DE081EA128A37EB.avi,132,1447,1111,336,30.243024302430243,morphological_dilation,3,2
0X3DE5250E0FF122E3.avi,0,1649,1297,352,27.139552814186587,morphological_dilation,3,2
0X3DE5250E0FF122E3.avi,12,939,659,280,42.4886191198786,morphological_dilation,3,2
0X3DEB26CCC9E0393A.avi,51,1604,1240,364,29.354838709677416,morphological_dilation,3,2
0X3DEB26CCC9E0393A.avi,68,1111,799,312,39.04881101376721,morphological_dilation,3,2
0X3DEBAD684DB64050.avi,84,1823,1423,400,28.109627547434997,morphological_dilation,3,2
0X3DEBAD684DB64050.avi,101,1196,856,340,39.719626168224295,morphological_dilation,3,2
0X3DEC46D1B8397CDE.avi,27,1287,979,308,31.46067415730337,morphological_dilation,3,2
0X3DEC46D1B8397CDE.avi,34,1091,802,289,36.03491271820449,morphological_dilation,3,2
0X3DF087AF1FA33A0A.avi,41,2028,1640,388,23.65853658536585,morphological_dilation,3,2
0X3DF087AF1FA33A0A.avi,57,1402,1074,328,30.54003724394786,morphological_dilation,3,2
0X3DF459E0724B3BC.avi,54,1520,1156,364,31.4878892733564,morphological_dilation,3,2
0X3DF459E0724B3BC.avi,74,851,583,268,45.96912521440824,morphological_dilation,3,2
0X3DF564B9BA59AC74.avi,121,1589,1225,364,29.714285714285715,morphological_dilation,3,2
0X3DF564B9BA59AC74.avi,136,1095,763,332,43.51245085190039,morphological_dilation,3,2
0X3DF694B393734B26.avi,119,1465,1121,344,30.686886708296164,morphological_dilation,3,2
0X3DF694B393734B26.avi,132,686,426,260,61.03286384976526,morphological_dilation,3,2
0X3DF6E49145C3F553.avi,41,1878,1474,404,27.408412483039346,morphological_dilation,3,2
0X3DF6E49145C3F553.avi,58,1198,858,340,39.62703962703963,morphological_dilation,3,2
0X3DF926CE61E8DE9.avi,51,1201,881,320,36.322360953461974,morphological_dilation,3,2
0X3DF926CE61E8DE9.avi,68,953,657,296,45.053272450532724,morphological_dilation,3,2
0X3DFD53597B122E4B.avi,122,1923,1499,424,28.285523682454972,morphological_dilation,3,2
0X3DFD53597B122E4B.avi,138,1166,830,336,40.48192771084337,morphological_dilation,3,2
0X3E00E41595F7FD72.avi,69,1791,1395,396,28.387096774193548,morphological_dilation,3,2
0X3E00E41595F7FD72.avi,89,1354,1010,344,34.05940594059406,morphological_dilation,3,2
0X3E04B170778411F9.avi,121,1162,857,305,35.58926487747958,morphological_dilation,3,2
0X3E04B170778411F9.avi,137,736,455,281,61.75824175824176,morphological_dilation,3,2
0X3E0D058327AC7898.avi,50,1703,1290,413,32.015503875968996,morphological_dilation,3,2
0X3E0D058327AC7898.avi,69,1184,852,332,38.967136150234744,morphological_dilation,3,2
0X3E14A0D52DE6AB3E.avi,96,1637,1249,388,31.064851881505206,morphological_dilation,3,2
0X3E14A0D52DE6AB3E.avi,107,953,645,308,47.751937984496124,morphological_dilation,3,2
0X3E15B2CD0D7FFFEB.avi,41,1673,1297,376,28.98997686969931,morphological_dilation,3,2
0X3E15B2CD0D7FFFEB.avi,56,1310,986,324,32.86004056795132,morphological_dilation,3,2
0X3E15E5CD8C70443D.avi,56,2156,1732,424,24.480369515011546,morphological_dilation,3,2
0X3E15E5CD8C70443D.avi,74,1191,859,332,38.64959254947614,morphological_dilation,3,2
0X3E1E76F3876FA4CB.avi,90,2110,1678,432,25.744934445768774,morphological_dilation,3,2
0X3E1E76F3876FA4CB.avi,106,1149,787,362,45.99745870393901,morphological_dilation,3,2
0X3E201401ADFBC022.avi,44,2031,1619,412,25.44780728844966,morphological_dilation,3,2
0X3E201401ADFBC022.avi,60,1846,1450,396,27.310344827586206,morphological_dilation,3,2
0X3E22D89049C5F9BA.avi,31,2198,1774,424,23.900789177001126,morphological_dilation,3,2
0X3E22D89049C5F9BA.avi,43,1245,921,324,35.17915309446254,morphological_dilation,3,2
0X3E2557960F25996A.avi,49,1883,1483,400,26.972353337828725,morphological_dilation,3,2
0X3E2557960F25996A.avi,63,1117,769,348,45.25357607282184,morphological_dilation,3,2
0X3E26D7B4C74C467C.avi,28,1495,1135,360,31.718061674008812,morphological_dilation,3,2
0X3E26D7B4C74C467C.avi,40,1240,912,328,35.96491228070175,morphological_dilation,3,2
0X3E2841AEE0E86911.avi,67,1369,1048,321,30.62977099236641,morphological_dilation,3,2
0X3E2841AEE0E86911.avi,83,1044,760,284,37.368421052631575,morphological_dilation,3,2
0X3E28448D6D5B8AA1.avi,77,1844,1460,384,26.301369863013697,morphological_dilation,3,2
0X3E28448D6D5B8AA1.avi,88,1114,814,300,36.85503685503686,morphological_dilation,3,2
0X3E29ABEC75D557EB.avi,79,2018,1582,436,27.560050568900124,morphological_dilation,3,2
0X3E29ABEC75D557EB.avi,98,1511,1129,382,33.83525243578388,morphological_dilation,3,2
0X3E2C9B9D3AAE8365.avi,118,1916,1524,392,25.72178477690289,morphological_dilation,3,2
0X3E2C9B9D3AAE8365.avi,137,948,664,284,42.77108433734939,morphological_dilation,3,2
0X3E2F182038897EA5.avi,35,1183,883,300,33.975084937712346,morphological_dilation,3,2
0X3E2F182038897EA5.avi,50,868,596,272,45.63758389261745,morphological_dilation,3,2
0X3E3207C0977DED20.avi,58,2069,1681,388,23.081499107674002,morphological_dilation,3,2
0X3E3207C0977DED20.avi,71,1797,1426,371,26.016830294530152,morphological_dilation,3,2
0X3E3C352FEA13FFF3.avi,45,2374,1912,462,24.163179916317993,morphological_dilation,3,2
0X3E3C352FEA13FFF3.avi,62,1461,1077,384,35.65459610027855,morphological_dilation,3,2
0X3E3D4ED914A2CC26.avi,49,917,637,280,43.956043956043956,morphological_dilation,3,2
0X3E3D4ED914A2CC26.avi,59,691,439,252,57.40318906605923,morphological_dilation,3,2
0X3E3D520FC52F1206.avi,43,1657,1290,367,28.449612403100776,morphological_dilation,3,2
0X3E3D520FC52F1206.avi,62,1137,837,300,35.842293906810035,morphological_dilation,3,2
0X3E410467C49E2577.avi,140,1713,1317,396,30.068337129840543,morphological_dilation,3,2
0X3E410467C49E2577.avi,155,1065,742,323,43.53099730458221,morphological_dilation,3,2
0X3E41F86EDA927362.avi,68,3085,2593,492,18.97416120323949,morphological_dilation,3,2
0X3E41F86EDA927362.avi,89,2003,1591,412,25.895663104965433,morphological_dilation,3,2
0X3E423D83A5D8629A.avi,97,1204,892,312,34.97757847533632,morphological_dilation,3,2
0X3E423D83A5D8629A.avi,111,814,550,264,48.0,morphological_dilation,3,2
0X3E4992933C229E41.avi,78,1756,1388,368,26.512968299711815,morphological_dilation,3,2
0X3E4992933C229E41.avi,96,1075,771,304,39.429312581063556,morphological_dilation,3,2
0X3E4E93103612D991.avi,106,1801,1405,396,28.18505338078292,morphological_dilation,3,2
0X3E4E93103612D991.avi,121,1113,793,320,40.3530895334174,morphological_dilation,3,2
0X3E4F117C74E7789D.avi,39,1881,1485,396,26.666666666666668,morphological_dilation,3,2
0X3E4F117C74E7789D.avi,55,1204,880,324,36.81818181818181,morphological_dilation,3,2
0X3E512A22832F853E.avi,52,2810,2314,496,21.43474503025065,morphological_dilation,3,2
0X3E512A22832F853E.avi,68,1819,1392,427,30.67528735632184,morphological_dilation,3,2
0X3E519478152D535B.avi,111,2263,1839,424,23.05600870038064,morphological_dilation,3,2
0X3E519478152D535B.avi,130,1297,950,347,36.526315789473685,morphological_dilation,3,2
0X3E54E90C8CF89B22.avi,98,1801,1413,388,27.459306440198162,morphological_dilation,3,2
0X3E54E90C8CF89B22.avi,111,1017,687,330,48.03493449781659,morphological_dilation,3,2
0X3E554757948CE381.avi,41,1862,1478,384,25.98105548037889,morphological_dilation,3,2
0X3E554757948CE381.avi,59,1076,772,304,39.37823834196891,morphological_dilation,3,2
0X3E561D7327B975CB.avi,51,4552,3940,612,15.532994923857867,morphological_dilation,3,2
0X3E561D7327B975CB.avi,67,2754,2251,503,22.345624167036874,morphological_dilation,3,2
0X3E56DED8582F762B.avi,116,1397,1017,380,37.364798426745324,morphological_dilation,3,2
0X3E56DED8582F762B.avi,131,861,554,307,55.415162454873645,morphological_dilation,3,2
0X3E5B5FCDCC9F9D5.avi,107,2018,1598,420,26.282853566958696,morphological_dilation,3,2
0X3E5B5FCDCC9F9D5.avi,122,1359,998,361,36.172344689378754,morphological_dilation,3,2
0X3E5EDF4D13CA55D7.avi,0,1685,1323,362,27.362055933484502,morphological_dilation,3,2
0X3E5EDF4D13CA55D7.avi,13,1129,820,309,37.68292682926829,morphological_dilation,3,2
0X3E616DCE18D8B5DA.avi,93,2983,2499,484,19.367747098839537,morphological_dilation,3,2
0X3E616DCE18D8B5DA.avi,111,1985,1597,388,24.29555416405761,morphological_dilation,3,2
0X3E6339FE3313BF65.avi,172,1629,1241,388,31.26510878323932,morphological_dilation,3,2
0X3E6339FE3313BF65.avi,191,1009,705,304,43.12056737588652,morphological_dilation,3,2
0X3E65996D18F7EA4A.avi,48,2612,2152,460,21.37546468401487,morphological_dilation,3,2
0X3E65996D18F7EA4A.avi,66,1829,1425,404,28.350877192982455,morphological_dilation,3,2
0X3E663E38BC70B73C.avi,2,2129,1701,428,25.16166960611405,morphological_dilation,3,2
0X3E663E38BC70B73C.avi,20,1420,1076,344,31.970260223048324,morphological_dilation,3,2
0X3E6901D663EA8922.avi,42,2932,2436,496,20.361247947454846,morphological_dilation,3,2
0X3E6901D663EA8922.avi,61,2128,1704,424,24.88262910798122,morphological_dilation,3,2
0X3E6A113EC1BA37C2.avi,85,1546,1194,352,29.48073701842546,morphological_dilation,3,2
0X3E6A113EC1BA37C2.avi,100,925,645,280,43.41085271317829,morphological_dilation,3,2
0X3E6AE8BEB9B6DBD4.avi,31,1717,1373,344,25.054624908958484,morphological_dilation,3,2
0X3E6AE8BEB9B6DBD4.avi,48,1195,895,300,33.5195530726257,morphological_dilation,3,2
0X3E73331470DA4030.avi,1,1367,1005,362,36.01990049751244,morphological_dilation,3,2
0X3E73331470DA4030.avi,19,837,565,272,48.14159292035398,morphological_dilation,3,2
0X3E767AC5BF9A0089.avi,42,1263,951,312,32.80757097791798,morphological_dilation,3,2
0X3E767AC5BF9A0089.avi,59,889,629,260,41.33545310015898,morphological_dilation,3,2
0X3E778B07970A2940.avi,108,1430,1063,367,34.52492944496707,morphological_dilation,3,2
0X3E778B07970A2940.avi,132,851,565,286,50.61946902654867,morphological_dilation,3,2
0X3E786535782F9C5F.avi,55,1445,1093,352,32.20494053064959,morphological_dilation,3,2
0X3E786535782F9C5F.avi,73,891,607,284,46.787479406919275,morphological_dilation,3,2
0X3E7951D6403EC835.avi,83,1489,1133,356,31.42100617828773,morphological_dilation,3,2
0X3E7951D6403EC835.avi,98,956,664,292,43.97590361445783,morphological_dilation,3,2
0X3E79B6F78B6B7331.avi,70,3108,2588,520,20.09273570324575,morphological_dilation,3,2
0X3E79B6F78B6B7331.avi,85,1905,1501,404,26.915389740173218,morphological_dilation,3,2
0X3E7A22F643CCEC3E.avi,36,2107,1691,416,24.600827912477826,morphological_dilation,3,2
0X3E7A22F643CCEC3E.avi,51,1284,944,340,36.016949152542374,morphological_dilation,3,2
0X3E822C675DD2B6A3.avi,43,2638,2119,519,24.492685228881548,morphological_dilation,3,2
0X3E822C675DD2B6A3.avi,63,1434,1023,411,40.17595307917888,morphological_dilation,3,2
0X3E84E059A32F47E0.avi,31,1424,1088,336,30.88235294117647,morphological_dilation,3,2
0X3E84E059A32F47E0.avi,49,1193,877,316,36.03192702394527,morphological_dilation,3,2
0X3E880A36CEE7240D.avi,86,2036,1624,412,25.36945812807882,morphological_dilation,3,2
0X3E880A36CEE7240D.avi,105,1225,873,352,40.32073310423826,morphological_dilation,3,2
0X3E8B36F8E715DED1.avi,2,2302,1862,440,23.630504833512354,morphological_dilation,3,2
0X3E8B36F8E715DED1.avi,14,1505,1141,364,31.901840490797547,morphological_dilation,3,2
0X3E8B547584BD000D.avi,101,1258,954,304,31.865828092243188,morphological_dilation,3,2
0X3E8B547584BD000D.avi,104,1855,1314,541,41.17199391171994,morphological_dilation,3,2
0X3E8D8B4A87FECF17.avi,109,2344,1900,444,23.36842105263158,morphological_dilation,3,2
0X3E8D8B4A87FECF17.avi,122,1508,1128,380,33.687943262411345,morphological_dilation,3,2
0X3E8E8C0F87FF65BF.avi,49,1755,1379,376,27.26613488034808,morphological_dilation,3,2
0X3E8E8C0F87FF65BF.avi,64,1192,864,328,37.96296296296296,morphological_dilation,3,2
0X3E91DA6C6799C069.avi,67,2621,2157,464,21.511358368103846,morphological_dilation,3,2
0X3E91DA6C6799C069.avi,83,1563,1175,388,33.02127659574468,morphological_dilation,3,2
0X3E92D553912D1EA1.avi,124,1568,1200,368,30.666666666666664,morphological_dilation,3,2
0X3E92D553912D1EA1.avi,138,932,648,284,43.82716049382716,morphological_dilation,3,2
0X3E93B09A1B702BAF.avi,42,1580,1212,368,30.363036303630363,morphological_dilation,3,2
0X3E93B09A1B702BAF.avi,56,995,703,292,41.53627311522048,morphological_dilation,3,2
0X3E9510ADA06F09A9.avi,51,2754,2306,448,19.4275802254987,morphological_dilation,3,2
0X3E9510ADA06F09A9.avi,67,1904,1520,384,25.263157894736842,morphological_dilation,3,2
0X3E9FD284E6497932.avi,38,1872,1480,392,26.486486486486488,morphological_dilation,3,2
0X3E9FD284E6497932.avi,53,1152,855,297,34.73684210526316,morphological_dilation,3,2
0X3EA17859559E4ABF.avi,51,3574,3046,528,17.334208798424164,morphological_dilation,3,2
0X3EA17859559E4ABF.avi,66,2735,2259,476,21.07127047366091,morphological_dilation,3,2
0X3EA9C5F8DCDD2DEC.avi,47,1696,1316,380,28.87537993920973,morphological_dilation,3,2
0X3EA9C5F8DCDD2DEC.avi,66,1117,791,326,41.21365360303413,morphological_dilation,3,2
0X3EAA6F77F2617102.avi,44,2172,1756,416,23.690205011389523,morphological_dilation,3,2
0X3EAA6F77F2617102.avi,61,1377,1029,348,33.819241982507286,morphological_dilation,3,2
0X3EAF0968B6971345.avi,95,1838,1450,388,26.75862068965517,morphological_dilation,3,2
0X3EAF0968B6971345.avi,110,1148,844,304,36.018957345971565,morphological_dilation,3,2
0X3EB0FC2695B0AB5F.avi,16,1012,700,312,44.57142857142857,morphological_dilation,3,2
0X3EB0FC2695B0AB5F.avi,88,2390,1810,580,32.04419889502763,morphological_dilation,3,2
0X3EB109A9072999EC.avi,44,2459,1997,462,23.13470205307962,morphological_dilation,3,2
0X3EB109A9072999EC.avi,63,1485,1129,356,31.53232949512843,morphological_dilation,3,2
0X3EB1A47797F16A83.avi,83,1599,1239,360,29.055690072639223,morphological_dilation,3,2
0X3EB1A47797F16A83.avi,102,1002,704,298,42.32954545454545,morphological_dilation,3,2
0X3EBA07E431D6AC14.avi,98,1410,1070,340,31.775700934579437,morphological_dilation,3,2
0X3EBA07E431D6AC14.avi,111,766,480,286,59.583333333333336,morphological_dilation,3,2
0X3EC21D2B9F1EA8CC.avi,69,2747,2299,448,19.48673336233145,morphological_dilation,3,2
0X3EC21D2B9F1EA8CC.avi,93,1735,1371,364,26.549963530269878,morphological_dilation,3,2
0X3EC366112F42E64.avi,31,1563,1191,372,31.234256926952142,morphological_dilation,3,2
0X3EC366112F42E64.avi,46,940,622,318,51.12540192926045,morphological_dilation,3,2
0X3EC5E2BA17FB1E6E.avi,119,1826,1436,390,27.158774373259053,morphological_dilation,3,2
0X3EC5E2BA17FB1E6E.avi,132,1077,771,306,39.688715953307394,morphological_dilation,3,2
0X3ECA9EB5E06CEA8B.avi,2,2192,1758,434,24.687144482366325,morphological_dilation,3,2
0X3ECA9EB5E06CEA8B.avi,13,1385,1017,368,36.18485742379548,morphological_dilation,3,2
0X3ECCF263161995AB.avi,77,1662,1302,360,27.64976958525346,morphological_dilation,3,2
0X3ECCF263161995AB.avi,97,1390,1054,336,31.87855787476281,morphological_dilation,3,2
0X3ECE2DC0B6619E01.avi,82,1867,1482,385,25.978407557354927,morphological_dilation,3,2
0X3ECE2DC0B6619E01.avi,99,1241,929,312,33.58449946178686,morphological_dilation,3,2
0X3ED97063EEB0647F.avi,41,2200,1740,460,26.436781609195403,morphological_dilation,3,2
0X3ED97063EEB0647F.avi,56,1383,1001,382,38.16183816183816,morphological_dilation,3,2
0X3EDC28E881C680CB.avi,62,2250,1806,444,24.58471760797342,morphological_dilation,3,2
0X3EDC28E881C680CB.avi,82,1335,987,348,35.25835866261398,morphological_dilation,3,2
0X3EDC9FA8DD9B473E.avi,57,2425,1935,490,25.32299741602067,morphological_dilation,3,2
0X3EDC9FA8DD9B473E.avi,79,1432,1031,401,38.89427740058196,morphological_dilation,3,2
0X3EE9455B3F6C0C25.avi,50,1904,1506,398,26.42762284196547,morphological_dilation,3,2
0X3EE9455B3F6C0C25.avi,66,1281,941,340,36.1317747077577,morphological_dilation,3,2
0X3EEFB992455C8E98.avi,93,1044,746,298,39.946380697050934,morphological_dilation,3,2
0X3EEFB992455C8E98.avi,112,639,415,224,53.975903614457835,morphological_dilation,3,2
0X3EF49ADFD0B23622.avi,54,1641,1249,392,31.385108086469177,morphological_dilation,3,2
0X3EF49ADFD0B23622.avi,75,927,631,296,46.90966719492869,morphological_dilation,3,2
0X3EF958B90BC01EE.avi,49,2005,1613,392,24.302541847489152,morphological_dilation,3,2
0X3EF958B90BC01EE.avi,69,1688,1328,360,27.10843373493976,morphological_dilation,3,2
0X3F016CB9A145CA5F.avi,47,1755,1379,376,27.26613488034808,morphological_dilation,3,2
0X3F016CB9A145CA5F.avi,64,1056,756,300,39.682539682539684,morphological_dilation,3,2
0X3F0187363675176A.avi,46,2385,1937,448,23.128549303045947,morphological_dilation,3,2
0X3F0187363675176A.avi,63,1450,1098,352,32.05828779599271,morphological_dilation,3,2
0X3F02002B186417B4.avi,51,1774,1386,388,27.994227994227995,morphological_dilation,3,2
0X3F02002B186417B4.avi,68,1169,817,352,43.08445532435741,morphological_dilation,3,2
0X3F022794066FF6CA.avi,38,1285,965,320,33.160621761658035,morphological_dilation,3,2
0X3F022794066FF6CA.avi,54,932,652,280,42.944785276073624,morphological_dilation,3,2
0X3F06BAFD1BACCE09.avi,48,1561,1193,368,30.846605196982395,morphological_dilation,3,2
0X3F06BAFD1BACCE09.avi,66,970,678,292,43.067846607669615,morphological_dilation,3,2
0X3F076329C702F768.avi,48,1159,859,300,34.92433061699651,morphological_dilation,3,2
0X3F076329C702F768.avi,64,779,488,291,59.63114754098361,morphological_dilation,3,2
0X3F0A268A296882B5.avi,103,1057,781,276,35.3393085787452,morphological_dilation,3,2
0X3F0A268A296882B5.avi,121,731,475,256,53.89473684210526,morphological_dilation,3,2
0X3F0C78F7A17748AC.avi,3,2326,1906,420,22.03567681007345,morphological_dilation,3,2
0X3F0C78F7A17748AC.avi,21,1789,1412,377,26.69971671388102,morphological_dilation,3,2
0X3F0ED71A38DA9C98.avi,104,1555,1191,364,30.56255247691016,morphological_dilation,3,2
0X3F0ED71A38DA9C98.avi,121,1131,819,312,38.095238095238095,morphological_dilation,3,2
0X3F0F139DF3E450A5.avi,60,1934,1538,396,25.74772431729519,morphological_dilation,3,2
0X3F0F139DF3E450A5.avi,83,1226,902,324,35.92017738359202,morphological_dilation,3,2
0X3F1D93F58B1FD1FD.avi,54,1592,1248,344,27.564102564102566,morphological_dilation,3,2
0X3F1D93F58B1FD1FD.avi,71,1073,781,292,37.38796414852753,morphological_dilation,3,2
0X3F1ED852891344A2.avi,5,1305,973,332,34.1212744090442,morphological_dilation,3,2
0X3F1ED852891344A2.avi,19,1088,788,300,38.07106598984771,morphological_dilation,3,2
0X3F21B014EDBAD737.avi,108,2493,2017,476,23.599405057015368,morphological_dilation,3,2
0X3F21B014EDBAD737.avi,120,1508,1124,384,34.16370106761566,morphological_dilation,3,2
0X3F22CABAAF726217.avi,79,2393,1965,428,21.78117048346056,morphological_dilation,3,2
0X3F22CABAAF726217.avi,104,1444,1108,336,30.324909747292416,morphological_dilation,3,2
0X3F24B7E7AE2C282B.avi,92,1966,1562,404,25.86427656850192,morphological_dilation,3,2
0X3F24B7E7AE2C282B.avi,112,1424,1064,360,33.83458646616541,morphological_dilation,3,2
0X3F267C727EACE516.avi,38,3164,2628,536,20.395738203957382,morphological_dilation,3,2
0X3F267C727EACE516.avi,51,2177,1710,467,27.309941520467834,morphological_dilation,3,2
0X3F2724A0E1BC2582.avi,54,1325,1005,320,31.8407960199005,morphological_dilation,3,2
0X3F2724A0E1BC2582.avi,69,924,632,292,46.20253164556962,morphological_dilation,3,2
0X3F276CE820A27C46.avi,80,1688,1324,364,27.492447129909365,morphological_dilation,3,2
0X3F276CE820A27C46.avi,90,1001,709,292,41.18476727785614,morphological_dilation,3,2
0X3F27BA3A0224153F.avi,4,1797,1441,356,24.70506592643997,morphological_dilation,3,2
0X3F27BA3A0224153F.avi,22,1174,878,296,33.712984054669704,morphological_dilation,3,2
0X3F2924595718D58A.avi,69,2765,2293,472,20.584387265590927,morphological_dilation,3,2
0X3F2924595718D58A.avi,95,2410,1959,451,23.021949974476776,morphological_dilation,3,2
0X3F2BD19A79D5A8AD.avi,53,2844,2372,472,19.898819561551434,morphological_dilation,3,2
0X3F2BD19A79D5A8AD.avi,73,1818,1426,392,27.489481065918653,morphological_dilation,3,2
0X3F2C0A0610E39E08.avi,0,1490,1122,368,32.79857397504456,morphological_dilation,3,2
0X3F2C0A0610E39E08.avi,16,871,599,272,45.40901502504174,morphological_dilation,3,2
0X3F2D1C1FFD4D503E.avi,35,1909,1505,404,26.843853820598007,morphological_dilation,3,2
0X3F2D1C1FFD4D503E.avi,49,1279,933,346,37.08467309753483,morphological_dilation,3,2
0X3F2D3F4C42130943.avi,93,1884,1496,388,25.935828877005346,morphological_dilation,3,2
0X3F2D3F4C42130943.avi,113,1049,751,298,39.680426098535285,morphological_dilation,3,2
0X3F318993B8006FD7.avi,65,1028,724,304,41.988950276243095,morphological_dilation,3,2
0X3F318993B8006FD7.avi,76,671,399,272,68.1704260651629,morphological_dilation,3,2
0X3F3190FAC575A7AC.avi,118,2313,1877,436,23.228556206712838,morphological_dilation,3,2
0X3F3190FAC575A7AC.avi,139,1535,1167,368,31.533847472150818,morphological_dilation,3,2
0X3F3397C6B81E8565.avi,47,3395,2840,555,19.54225352112676,morphological_dilation,3,2
0X3F3397C6B81E8565.avi,74,2110,1662,448,26.955475330926593,morphological_dilation,3,2
0X3F38886ABD417322.avi,105,2545,2058,487,23.663751214771622,morphological_dilation,3,2
0X3F38886ABD417322.avi,142,1549,1153,396,34.34518647007806,morphological_dilation,3,2
0X3F3965B7F7CAEEB4.avi,49,1761,1378,383,27.793904208998548,morphological_dilation,3,2
0X3F3965B7F7CAEEB4.avi,69,1061,773,288,37.25743855109961,morphological_dilation,3,2
0X3F3DC1A6F0B18FA.avi,34,1290,950,340,35.78947368421053,morphological_dilation,3,2
0X3F3DC1A6F0B18FA.avi,50,958,650,308,47.38461538461539,morphological_dilation,3,2
0X3F46D480CDB787B9.avi,122,2621,2165,456,21.062355658198616,morphological_dilation,3,2
0X3F46D480CDB787B9.avi,142,1953,1549,404,26.081342801807615,morphological_dilation,3,2
0X3F4EE55CAA4CF6B4.avi,107,1380,1044,336,32.18390804597701,morphological_dilation,3,2
0X3F4EE55CAA4CF6B4.avi,122,881,593,288,48.566610455311974,morphological_dilation,3,2
0X3F50ED36355BC255.avi,38,2743,2259,484,21.425409473218238,morphological_dilation,3,2
0X3F50ED36355BC255.avi,57,1705,1301,404,31.053036126056877,morphological_dilation,3,2
0X3F63071C1EB0A15E.avi,56,898,618,280,45.307443365695796,morphological_dilation,3,2
0X3F63071C1EB0A15E.avi,62,533,302,231,76.49006622516556,morphological_dilation,3,2
0X3F699DC528E8E721.avi,54,1301,949,352,37.09167544783983,morphological_dilation,3,2
0X3F699DC528E8E721.avi,71,754,494,260,52.63157894736842,morphological_dilation,3,2
0X3F6A65114504DCE4.avi,5,2307,1871,436,23.30304649919829,morphological_dilation,3,2
0X3F6A65114504DCE4.avi,18,1942,1535,407,26.514657980456025,morphological_dilation,3,2
0X3F6DF4F515FE44FA.avi,94,1131,823,308,37.424058323207774,morphological_dilation,3,2
0X3F6DF4F515FE44FA.avi,111,751,479,272,56.78496868475992,morphological_dilation,3,2
0X3F71ED0C572EB3E7.avi,27,2065,1677,388,23.13655336911151,morphological_dilation,3,2
0X3F71ED0C572EB3E7.avi,46,1795,1435,360,25.087108013937282,morphological_dilation,3,2
0X3F7285D129E9D228.avi,3,1813,1437,376,26.165622825330548,morphological_dilation,3,2
0X3F7285D129E9D228.avi,17,1019,707,312,44.13012729844413,morphological_dilation,3,2
0X3F86A98444A36448.avi,3,1384,1060,324,30.566037735849054,morphological_dilation,3,2
0X3F86A98444A36448.avi,21,1006,718,288,40.11142061281337,morphological_dilation,3,2
0X3F86DB69FFDAC9AF.avi,49,1704,1324,380,28.700906344410875,morphological_dilation,3,2
0X3F86DB69FFDAC9AF.avi,67,1123,799,324,40.550688360450565,morphological_dilation,3,2
0X3F8AB03513284E92.avi,39,1519,1167,352,30.162810625535563,morphological_dilation,3,2
0X3F8AB03513284E92.avi,54,1065,765,300,39.21568627450981,morphological_dilation,3,2
0X3F914081EEB5588A.avi,77,1429,1097,332,30.264357338195076,morphological_dilation,3,2
0X3F914081EEB5588A.avi,92,1030,742,288,38.81401617250674,morphological_dilation,3,2
0X3F92841AA6681005.avi,48,1624,1264,360,28.48101265822785,morphological_dilation,3,2
0X3F92841AA6681005.avi,64,1090,778,312,40.102827763496144,morphological_dilation,3,2
0X3F97ED7FEAA2AC6E.avi,76,1986,1586,400,25.220680958385877,morphological_dilation,3,2
0X3F97ED7FEAA2AC6E.avi,92,1703,1339,364,27.184466019417474,morphological_dilation,3,2
0X3F9A02817B34BB11.avi,50,1899,1511,388,25.6783587028458,morphological_dilation,3,2
0X3F9A02817B34BB11.avi,64,1210,886,324,36.56884875846501,morphological_dilation,3,2
0X3F9EF1DB2A783F8.avi,164,3524,2992,532,17.780748663101605,morphological_dilation,3,2
0X3F9EF1DB2A783F8.avi,176,3123,2627,496,18.880852683669584,morphological_dilation,3,2
0X3FAD7F576C576B76.avi,125,1936,1516,420,27.70448548812665,morphological_dilation,3,2
0X3FAD7F576C576B76.avi,140,1293,939,354,37.69968051118211,morphological_dilation,3,2
0X3FB36AEDBE1A4B10.avi,0,1187,886,301,33.972911963882616,morphological_dilation,3,2
0X3FB36AEDBE1A4B10.avi,11,867,607,260,42.833607907743,morphological_dilation,3,2
0X3FB431651C25CB49.avi,51,4419,3831,588,15.348472983555208,morphological_dilation,3,2
0X3FB431651C25CB49.avi,68,3202,2686,516,19.21072226358898,morphological_dilation,3,2
0X3FB529259ACCAD46.avi,47,1412,1084,328,30.25830258302583,morphological_dilation,3,2
0X3FB529259ACCAD46.avi,60,925,657,268,40.791476407914764,morphological_dilation,3,2
0X3FB5BB8755886893.avi,42,623,363,260,71.62534435261708,morphological_dilation,3,2
0X3FB5BB8755886893.avi,57,426,184,242,131.52173913043478,morphological_dilation,3,2
0X3FB63A70136D80EF.avi,82,1787,1423,364,25.579761068165848,morphological_dilation,3,2
0X3FB63A70136D80EF.avi,97,1116,820,296,36.09756097560975,morphological_dilation,3,2
0X3FB8DCE875DFB29F.avi,32,1313,949,364,38.35616438356164,morphological_dilation,3,2
0X3FB8DCE875DFB29F.avi,46,801,513,288,56.14035087719298,morphological_dilation,3,2
0X3FBB626ABE49160.avi,103,2955,2487,468,18.817852834740652,morphological_dilation,3,2
0X3FBB626ABE49160.avi,118,1980,1580,400,25.31645569620253,morphological_dilation,3,2
0X3FBBF5350D8CE522.avi,110,2281,1813,468,25.81356867071153,morphological_dilation,3,2
0X3FBBF5350D8CE522.avi,127,1693,1289,404,31.342125678820793,morphological_dilation,3,2
0X3FBC7F6543824119.avi,92,2074,1678,396,23.59952324195471,morphological_dilation,3,2
0X3FBC7F6543824119.avi,114,1396,1056,340,32.196969696969695,morphological_dilation,3,2
0X3FBCED662ED19173.avi,58,2351,1896,455,23.99789029535865,morphological_dilation,3,2
0X3FBCED662ED19173.avi,84,1530,1162,368,31.669535283993117,morphological_dilation,3,2
0X3FC4CD5A46EF4035.avi,79,1216,916,300,32.751091703056765,morphological_dilation,3,2
0X3FC4CD5A46EF4035.avi,97,815,563,252,44.760213143872114,morphological_dilation,3,2
0X3FC56CBCE0A32923.avi,41,2519,2047,472,23.058133854421104,morphological_dilation,3,2
0X3FC56CBCE0A32923.avi,57,1520,1136,384,33.80281690140845,morphological_dilation,3,2
0X3FCDAB936D61FB3C.avi,71,1605,1249,356,28.502802241793436,morphological_dilation,3,2
0X3FCDAB936D61FB3C.avi,84,1366,1054,312,29.601518026565465,morphological_dilation,3,2
0X3FCF64E16CAB91B.avi,47,1815,1399,416,29.735525375268047,morphological_dilation,3,2
0X3FCF64E16CAB91B.avi,64,1253,876,377,43.0365296803653,morphological_dilation,3,2
0X3FD06E4600AFB1B7.avi,52,1381,1037,344,33.17261330761813,morphological_dilation,3,2
0X3FD06E4600AFB1B7.avi,66,890,594,296,49.831649831649834,morphological_dilation,3,2
0X3FD37EEEABBE989D.avi,41,2323,1887,436,23.105458399576044,morphological_dilation,3,2
0X3FD37EEEABBE989D.avi,55,1534,1174,360,30.664395229982965,morphological_dilation,3,2
0X3FD79FECFF0B9E30.avi,118,2623,2139,484,22.62739597942964,morphological_dilation,3,2
0X3FD79FECFF0B9E30.avi,135,1836,1408,428,30.39772727272727,morphological_dilation,3,2
0X3FDA5448318F58AC.avi,52,2379,1911,468,24.489795918367346,morphological_dilation,3,2
0X3FDA5448318F58AC.avi,74,1559,1171,388,33.134073441502984,morphological_dilation,3,2
0X3FDECC3DAEFC3C88.avi,74,1832,1456,376,25.82417582417583,morphological_dilation,3,2
0X3FDECC3DAEFC3C88.avi,87,1498,1152,346,30.03472222222222,morphological_dilation,3,2
0X3FE045B8656715A9.avi,39,4045,3477,568,16.33592177164222,morphological_dilation,3,2
0X3FE045B8656715A9.avi,57,2590,2130,460,21.5962441314554,morphological_dilation,3,2
0X3FE27FE080EC17D8.avi,1,1551,1191,360,30.22670025188917,morphological_dilation,3,2
0X3FE27FE080EC17D8.avi,10,1032,732,300,40.98360655737705,morphological_dilation,3,2
0X3FE59CC3E9AF7EE5.avi,59,1716,1312,404,30.79268292682927,morphological_dilation,3,2
0X3FE59CC3E9AF7EE5.avi,83,1001,701,300,42.796005706134096,morphological_dilation,3,2
0X3FE72DE1C9A5154C.avi,117,2084,1684,400,23.75296912114014,morphological_dilation,3,2
0X3FE72DE1C9A5154C.avi,138,1419,1071,348,32.49299719887955,morphological_dilation,3,2
0X3FE9162ED296F4A3.avi,93,2230,1798,432,24.026696329254726,morphological_dilation,3,2
0X3FE9162ED296F4A3.avi,107,1316,964,352,36.51452282157676,morphological_dilation,3,2
0X3FE99EBEE1E0830E.avi,54,2516,2062,454,22.017458777885548,morphological_dilation,3,2
0X3FE99EBEE1E0830E.avi,70,1444,1080,364,33.7037037037037,morphological_dilation,3,2
0X3FF10F5B3ACC1D81.avi,48,1620,1260,360,28.57142857142857,morphological_dilation,3,2
0X3FF10F5B3ACC1D81.avi,71,1060,760,300,39.473684210526315,morphological_dilation,3,2
0X3FF2A5EB9E33B58F.avi,57,1925,1505,420,27.906976744186046,morphological_dilation,3,2
0X3FF2A5EB9E33B58F.avi,74,1144,812,332,40.88669950738916,morphological_dilation,3,2
0X3FF38CE334BFB6AA.avi,49,2190,1766,424,24.009060022650054,morphological_dilation,3,2
0X3FF38CE334BFB6AA.avi,67,1411,1055,356,33.74407582938389,morphological_dilation,3,2
0X3FF3AADBE6D35A09.avi,79,3236,2717,519,19.10195068089805,morphological_dilation,3,2
0X3FF3AADBE6D35A09.avi,92,2923,2447,476,19.45239068246833,morphological_dilation,3,2
0X3FF4A824721D77C4.avi,122,1970,1566,404,25.798212005108557,morphological_dilation,3,2
0X3FF4A824721D77C4.avi,138,1172,852,320,37.558685446009385,morphological_dilation,3,2
0X3FF79E1647F263C4.avi,79,2081,1650,431,26.121212121212125,morphological_dilation,3,2
0X3FF79E1647F263C4.avi,93,1271,911,360,39.51701427003293,morphological_dilation,3,2
0X3FFC6F63147F8BE2.avi,82,1492,1132,360,31.802120141342755,morphological_dilation,3,2
0X3FFC6F63147F8BE2.avi,96,968,671,297,44.26229508196721,morphological_dilation,3,2
0X3FFD93A11E0038E1.avi,34,1464,1116,348,31.182795698924732,morphological_dilation,3,2
0X3FFD93A11E0038E1.avi,46,952,664,288,43.373493975903614,morphological_dilation,3,2
0X3FFFEF15F69088B5.avi,91,934,646,288,44.58204334365325,morphological_dilation,3,2
0X3FFFEF15F69088B5.avi,108,650,394,256,64.9746192893401,morphological_dilation,3,2
0X40005DECF5DCF4D0.avi,54,1697,1309,388,29.640947288006114,morphological_dilation,3,2
0X40005DECF5DCF4D0.avi,70,1239,895,344,38.435754189944134,morphological_dilation,3,2
0X4002E1801D36EDA8.avi,83,1339,994,345,34.70824949698189,morphological_dilation,3,2
0X4002E1801D36EDA8.avi,113,772,500,272,54.400000000000006,morphological_dilation,3,2
0X40089B3B847361A0.avi,3,1740,1380,360,26.08695652173913,morphological_dilation,3,2
0X40089B3B847361A0.avi,20,1087,795,292,36.72955974842767,morphological_dilation,3,2
0X400CC61D727033DF.avi,75,1667,1287,380,29.526029526029525,morphological_dilation,3,2
0X400CC61D727033DF.avi,88,1028,728,300,41.208791208791204,morphological_dilation,3,2
0X4010CDE479C5BB80.avi,44,1757,1373,384,27.967953386744355,morphological_dilation,3,2
0X4010CDE479C5BB80.avi,66,1053,742,311,41.91374663072776,morphological_dilation,3,2
0X40124E47CF121BDC.avi,1,1156,860,296,34.418604651162795,morphological_dilation,3,2
0X40124E47CF121BDC.avi,15,798,542,256,47.23247232472325,morphological_dilation,3,2
0X4013D6C4137D4297.avi,49,1441,1085,356,32.8110599078341,morphological_dilation,3,2
0X4013D6C4137D4297.avi,59,982,666,316,47.44744744744745,morphological_dilation,3,2
0X40237596721647DC.avi,50,1679,1303,376,28.85648503453569,morphological_dilation,3,2
0X40237596721647DC.avi,70,1116,784,332,42.3469387755102,morphological_dilation,3,2
0X40253981E97848E5.avi,79,1871,1452,419,28.856749311294767,morphological_dilation,3,2
0X40253981E97848E5.avi,91,1318,960,358,37.291666666666664,morphological_dilation,3,2
0X40271772155BCBF0.avi,40,1805,1421,384,27.023223082336383,morphological_dilation,3,2
0X40271772155BCBF0.avi,53,1580,1212,368,30.363036303630363,morphological_dilation,3,2
0X402ECE64134842CD.avi,42,3725,3165,560,17.69352290679305,morphological_dilation,3,2
0X402ECE64134842CD.avi,60,2370,1902,468,24.605678233438486,morphological_dilation,3,2
0X402F47A30DFA51A3.avi,1,2909,2417,492,20.35581299131154,morphological_dilation,3,2
0X402F47A30DFA51A3.avi,21,1828,1393,435,31.2275664034458,morphological_dilation,3,2
0X4030E11F8E65C1EC.avi,138,1533,1137,396,34.82849604221636,morphological_dilation,3,2
0X4030E11F8E65C1EC.avi,155,939,610,329,53.93442622950819,morphological_dilation,3,2
0X4032BAC50AC5C707.avi,50,2050,1618,432,26.699629171817058,morphological_dilation,3,2
0X4032BAC50AC5C707.avi,69,1226,874,352,40.274599542334094,morphological_dilation,3,2
0X403633BA8EA5322C.avi,116,1601,1245,356,28.594377510040157,morphological_dilation,3,2
0X403633BA8EA5322C.avi,131,1118,782,336,42.96675191815857,morphological_dilation,3,2
0X40363DBD828783F.avi,99,638,402,236,58.70646766169154,morphological_dilation,3,2
0X40363DBD828783F.avi,106,1889,1364,525,38.489736070381234,morphological_dilation,3,2
0X403CA8347D30A9D1.avi,4,1437,1093,344,31.473010064043915,morphological_dilation,3,2
0X403CA8347D30A9D1.avi,23,885,607,278,45.799011532125206,morphological_dilation,3,2
0X403F31515BED0BC2.avi,41,2487,2031,456,22.451994091580502,morphological_dilation,3,2
0X403F31515BED0BC2.avi,54,1348,992,356,35.88709677419355,morphological_dilation,3,2
0X404118277675D8BD.avi,57,1737,1369,368,26.880934989043098,morphological_dilation,3,2
0X404118277675D8BD.avi,76,1100,761,339,44.54664914586071,morphological_dilation,3,2
0X40414596BC8DF812.avi,75,1664,1296,368,28.39506172839506,morphological_dilation,3,2
0X40414596BC8DF812.avi,93,1100,784,316,40.30612244897959,morphological_dilation,3,2
0X404AF6762D671C09.avi,69,2313,1885,428,22.70557029177719,morphological_dilation,3,2
0X404AF6762D671C09.avi,88,1388,1048,340,32.44274809160305,morphological_dilation,3,2
0X40527E38E6EAC117.avi,55,1911,1495,416,27.82608695652174,morphological_dilation,3,2
0X40527E38E6EAC117.avi,73,1180,844,336,39.81042654028436,morphological_dilation,3,2
0X40551ED55932933D.avi,97,1746,1374,372,27.074235807860266,morphological_dilation,3,2
0X40551ED55932933D.avi,113,1240,904,336,37.16814159292036,morphological_dilation,3,2
0X405B25BDFB97D0AB.avi,95,1415,1083,332,30.655586334256697,morphological_dilation,3,2
0X405B25BDFB97D0AB.avi,112,1187,879,308,35.03981797497156,morphological_dilation,3,2
0X40601D27143778D2.avi,193,1963,1565,398,25.431309904153355,morphological_dilation,3,2
0X40601D27143778D2.avi,218,1247,886,361,40.74492099322799,morphological_dilation,3,2
0X4065BFB6010E7254.avi,97,1583,1219,364,29.860541427399507,morphological_dilation,3,2
0X4065BFB6010E7254.avi,111,904,615,289,46.99186991869919,morphological_dilation,3,2
0X406899187CFD9A61.avi,48,1615,1231,384,31.194151096669376,morphological_dilation,3,2
0X406899187CFD9A61.avi,55,938,630,308,48.888888888888886,morphological_dilation,3,2
0X4069B91589712C3A.avi,138,1762,1338,424,31.689088191330345,morphological_dilation,3,2
0X4069B91589712C3A.avi,155,1010,678,332,48.96755162241888,morphological_dilation,3,2
0X406B49B4D454D534.avi,50,1905,1513,392,25.908790482485127,morphological_dilation,3,2
0X406B49B4D454D534.avi,68,1205,881,324,36.776390465380246,morphological_dilation,3,2
0X406BAC86BAC0B5A6.avi,58,1430,990,440,44.44444444444444,morphological_dilation,3,2
0X406BAC86BAC0B5A6.avi,76,954,581,373,64.19965576592082,morphological_dilation,3,2
0X406C05B9EE046427.avi,45,2117,1701,416,24.45620223398001,morphological_dilation,3,2
0X406C05B9EE046427.avi,63,1238,914,324,35.44857768052516,morphological_dilation,3,2
0X406C79DF5EBE13D9.avi,44,2472,2024,448,22.134387351778656,morphological_dilation,3,2
0X406C79DF5EBE13D9.avi,61,1613,1225,388,31.673469387755105,morphological_dilation,3,2
0X40736AFD734803E0.avi,43,1452,1106,346,31.28390596745027,morphological_dilation,3,2
0X40736AFD734803E0.avi,56,1110,810,300,37.03703703703704,morphological_dilation,3,2
0X407AA1CC9F54562A.avi,125,2883,2387,496,20.77922077922078,morphological_dilation,3,2
0X407AA1CC9F54562A.avi,146,1592,1209,383,31.679073614557485,morphological_dilation,3,2
0X407E509DDF2BC32C.avi,39,1436,1104,332,30.07246376811594,morphological_dilation,3,2
0X407E509DDF2BC32C.avi,53,967,687,280,40.756914119359536,morphological_dilation,3,2
0X40818EDA7A4B5FD4.avi,95,1664,1304,360,27.607361963190186,morphological_dilation,3,2
0X40818EDA7A4B5FD4.avi,110,981,681,300,44.052863436123346,morphological_dilation,3,2
0X40819D22B667DFBD.avi,34,1771,1387,384,27.68565248738284,morphological_dilation,3,2
0X40819D22B667DFBD.avi,50,1079,787,292,37.10292249047014,morphological_dilation,3,2
0X4082228407B256A7.avi,71,1676,1316,360,27.35562310030395,morphological_dilation,3,2
0X4082228407B256A7.avi,89,954,662,292,44.10876132930513,morphological_dilation,3,2
0X4082A009493C50F0.avi,153,2818,2350,468,19.914893617021274,morphological_dilation,3,2
0X4082A009493C50F0.avi,168,2403,1951,452,23.167606355715016,morphological_dilation,3,2
0X408387EC8C30606B.avi,47,1701,1325,376,28.37735849056604,morphological_dilation,3,2
0X408387EC8C30606B.avi,64,1237,904,333,36.836283185840706,morphological_dilation,3,2
0X40859A35AFC437FA.avi,61,2906,2419,487,20.132286068623397,morphological_dilation,3,2
0X40859A35AFC437FA.avi,76,1978,1559,419,26.87620269403464,morphological_dilation,3,2
0X408693AAA1896166.avi,9,1548,1184,364,30.743243243243246,morphological_dilation,3,2
0X408693AAA1896166.avi,21,1038,734,304,41.41689373297003,morphological_dilation,3,2
0X4088FBA37F95B692.avi,119,2182,1766,416,23.556058890147224,morphological_dilation,3,2
0X4088FBA37F95B692.avi,136,1574,1226,348,28.38499184339315,morphological_dilation,3,2
0X408CA650E6AD4896.avi,36,1528,1164,364,31.27147766323024,morphological_dilation,3,2
0X408CA650E6AD4896.avi,51,1027,731,296,40.49247606019152,morphological_dilation,3,2
0X408F18F641936D78.avi,40,1748,1380,368,26.666666666666668,morphological_dilation,3,2
0X408F18F641936D78.avi,52,1053,753,300,39.8406374501992,morphological_dilation,3,2
0X4090418C2ABF84C6.avi,30,1086,782,304,38.87468030690537,morphological_dilation,3,2
0X4090418C2ABF84C6.avi,40,803,523,280,53.53728489483748,morphological_dilation,3,2
0X4091E9362CF3A5E9.avi,111,2239,1803,436,24.18191902384914,morphological_dilation,3,2
0X4091E9362CF3A5E9.avi,130,1377,1005,372,37.014925373134325,morphological_dilation,3,2
0X4093BA80E43ED821.avi,91,1710,1346,364,27.043090638930163,morphological_dilation,3,2
0X4093BA80E43ED821.avi,104,1052,760,292,38.421052631578945,morphological_dilation,3,2
0X4093E9E5EC007FB5.avi,94,1968,1568,400,25.510204081632654,morphological_dilation,3,2
0X4093E9E5EC007FB5.avi,112,1816,1436,380,26.46239554317549,morphological_dilation,3,2
0X409A16F791C8CE6D.avi,53,2098,1706,392,22.97772567409144,morphological_dilation,3,2
0X409A16F791C8CE6D.avi,67,1774,1410,364,25.81560283687943,morphological_dilation,3,2
0X409AE8C96B617FDC.avi,104,2202,1770,432,24.40677966101695,morphological_dilation,3,2
0X409AE8C96B617FDC.avi,126,1541,1177,364,30.92608326253186,morphological_dilation,3,2
0X409C1560857D0D4A.avi,40,1970,1586,384,24.211853720050442,morphological_dilation,3,2
0X409C1560857D0D4A.avi,57,1142,822,320,38.929440389294406,morphological_dilation,3,2
0X409CD860C8D45814.avi,45,1192,860,332,38.604651162790695,morphological_dilation,3,2
0X409CD860C8D45814.avi,59,742,468,274,58.54700854700855,morphological_dilation,3,2
0X40A08EF6EABF3936.avi,35,1576,1220,356,29.18032786885246,morphological_dilation,3,2
0X40A08EF6EABF3936.avi,51,1013,721,292,40.49930651872399,morphological_dilation,3,2
0X40A1C500E145B14B.avi,42,1727,1359,368,27.078734363502576,morphological_dilation,3,2
0X40A1C500E145B14B.avi,56,1166,818,348,42.54278728606357,morphological_dilation,3,2
0X40A33D515599EAA9.avi,104,2167,1751,416,23.75785265562536,morphological_dilation,3,2
0X40A33D515599EAA9.avi,120,1353,1017,336,33.03834808259587,morphological_dilation,3,2
0X40A621CC0171F360.avi,138,1369,1021,348,34.084231145935355,morphological_dilation,3,2
0X40A621CC0171F360.avi,152,858,541,317,58.59519408502772,morphological_dilation,3,2
0X40A984ED6112B7E.avi,47,1399,1039,360,34.64870067372473,morphological_dilation,3,2
0X40A984ED6112B7E.avi,64,973,649,324,49.922958397534664,morphological_dilation,3,2
0X40BA8F1AE901A09F.avi,59,2656,2192,464,21.16788321167883,morphological_dilation,3,2
0X40BA8F1AE901A09F.avi,74,2139,1704,435,25.528169014084508,morphological_dilation,3,2
0X40BD33B3D3423B77.avi,58,2413,1961,452,23.04946455889852,morphological_dilation,3,2
0X40BD33B3D3423B77.avi,78,1490,1126,364,32.326820603907635,morphological_dilation,3,2
0X40BF3AC7A4247121.avi,155,3466,2930,536,18.293515358361777,morphological_dilation,3,2
0X40BF3AC7A4247121.avi,173,2621,2145,476,22.19114219114219,morphological_dilation,3,2
0X40C09230C16A634A.avi,46,845,572,273,47.72727272727273,morphological_dilation,3,2
0X40C09230C16A634A.avi,68,1389,1041,348,33.429394812680115,morphological_dilation,3,2
0X40C4C63CE4108315.avi,78,2809,2313,496,21.444012105490703,morphological_dilation,3,2
0X40C4C63CE4108315.avi,96,1625,1241,384,30.942788074133766,morphological_dilation,3,2
0X40C9109740FB02C0.avi,56,1316,976,340,34.83606557377049,morphological_dilation,3,2
0X40C9109740FB02C0.avi,77,825,557,268,48.114901256732495,morphological_dilation,3,2
0X40CC7E1811AE44A7.avi,39,1122,802,320,39.900249376558605,morphological_dilation,3,2
0X40CC7E1811AE44A7.avi,56,692,440,252,57.27272727272727,morphological_dilation,3,2
0X40CFB9F5945D9A25.avi,29,2129,1709,420,24.575775307197194,morphological_dilation,3,2
0X40CFB9F5945D9A25.avi,57,1555,1167,388,33.24764353041988,morphological_dilation,3,2
0X40D1A3EFB465C064.avi,45,2316,1868,448,23.98286937901499,morphological_dilation,3,2
0X40D1A3EFB465C064.avi,61,1864,1464,400,27.322404371584703,morphological_dilation,3,2
0X40D28C26DDD4F3AE.avi,41,1846,1450,396,27.310344827586206,morphological_dilation,3,2
0X40D28C26DDD4F3AE.avi,55,1217,877,340,38.76852907639681,morphological_dilation,3,2
0X40D38248ACAECAFF.avi,39,1400,1056,344,32.57575757575758,morphological_dilation,3,2
0X40D38248ACAECAFF.avi,53,816,524,292,55.72519083969466,morphological_dilation,3,2
0X40D604767A9FEED7.avi,119,2307,1867,440,23.567220139260847,morphological_dilation,3,2
0X40D604767A9FEED7.avi,150,1384,1026,358,34.89278752436647,morphological_dilation,3,2
0X40D6BD692A4A1AA2.avi,45,1487,1123,364,32.41317898486198,morphological_dilation,3,2
0X40D6BD692A4A1AA2.avi,63,1208,880,328,37.27272727272727,morphological_dilation,3,2
0X40D6CA4DA2637768.avi,111,1509,1122,387,34.49197860962567,morphological_dilation,3,2
0X40D6CA4DA2637768.avi,124,994,686,308,44.89795918367347,morphological_dilation,3,2
0X40DFB5351FAEA5B3.avi,48,2900,2402,498,20.73272273105745,morphological_dilation,3,2
0X40DFB5351FAEA5B3.avi,70,1919,1520,399,26.25,morphological_dilation,3,2
0X40E0117CBE0F5B26.avi,62,3070,2582,488,18.90007745933385,morphological_dilation,3,2
0X40E0117CBE0F5B26.avi,83,1664,1296,368,28.39506172839506,morphological_dilation,3,2
0X40EBACBB84040DA1.avi,3,2764,2300,464,20.17391304347826,morphological_dilation,3,2
0X40EBACBB84040DA1.avi,15,2426,1998,428,21.42142142142142,morphological_dilation,3,2
0X40EDBEF64BC45E9B.avi,82,1724,1356,368,27.13864306784661,morphological_dilation,3,2
0X40EDBEF64BC45E9B.avi,98,1239,907,332,36.60418963616318,morphological_dilation,3,2
0X40F21F75AAD20630.avi,29,1950,1546,404,26.13195342820181,morphological_dilation,3,2
0X40F21F75AAD20630.avi,41,1671,1295,376,29.034749034749037,morphological_dilation,3,2
0X40F475A3CA97F09B.avi,41,1727,1343,384,28.59270290394639,morphological_dilation,3,2
0X40F475A3CA97F09B.avi,52,1357,1010,347,34.35643564356436,morphological_dilation,3,2
0X40F87CEA33AD96E4.avi,70,2117,1701,416,24.45620223398001,morphological_dilation,3,2
0X40F87CEA33AD96E4.avi,81,1445,1081,364,33.672525439407956,morphological_dilation,3,2
0X40FD0B2BD7D3024E.avi,77,3107,2619,488,18.63306605574647,morphological_dilation,3,2
0X40FD0B2BD7D3024E.avi,89,2652,2196,456,20.76502732240437,morphological_dilation,3,2
0X40FE2C51364DC01C.avi,40,914,634,280,44.164037854889585,morphological_dilation,3,2
0X40FE2C51364DC01C.avi,55,631,391,240,61.38107416879796,morphological_dilation,3,2
0X40FF58F1074E0DB6.avi,0,1877,1471,406,27.60027192386132,morphological_dilation,3,2
0X40FF58F1074E0DB6.avi,17,1196,867,329,37.94694348327566,morphological_dilation,3,2
0X41032F601E057D7A.avi,31,2194,1782,412,23.120089786756452,morphological_dilation,3,2
0X41032F601E057D7A.avi,48,1780,1404,376,26.780626780626783,morphological_dilation,3,2
0X41080410790C9DC1.avi,37,1555,1199,356,29.69140950792327,morphological_dilation,3,2
0X41080410790C9DC1.avi,52,1012,700,312,44.57142857142857,morphological_dilation,3,2
0X410B873DE1ED0E4E.avi,43,1723,1336,387,28.967065868263475,morphological_dilation,3,2
0X410B873DE1ED0E4E.avi,60,1023,707,316,44.6958981612447,morphological_dilation,3,2
0X411029297A4D5496.avi,52,2126,1694,432,25.50177095631641,morphological_dilation,3,2
0X411029297A4D5496.avi,69,1251,887,364,41.037204058624575,morphological_dilation,3,2
0X41130893A44122AB.avi,74,1585,1193,392,32.858340318524725,morphological_dilation,3,2
0X41130893A44122AB.avi,92,1033,677,356,52.58493353028065,morphological_dilation,3,2
0X4117A1621282635F.avi,94,2027,1593,434,27.244193345888263,morphological_dilation,3,2
0X4117A1621282635F.avi,114,1187,863,324,37.54345307068366,morphological_dilation,3,2
0X411DD3F7DC7803DE.avi,42,1086,782,304,38.87468030690537,morphological_dilation,3,2
0X411DD3F7DC7803DE.avi,50,933,641,292,45.55382215288611,morphological_dilation,3,2
0X411E89F93DAB415A.avi,48,1807,1413,394,27.883934890304317,morphological_dilation,3,2
0X411E89F93DAB415A.avi,69,1205,878,327,37.24373576309795,morphological_dilation,3,2
0X4123160399050F47.avi,119,1406,1050,356,33.904761904761905,morphological_dilation,3,2
0X4123160399050F47.avi,138,746,474,272,57.383966244725734,morphological_dilation,3,2
0X412697A4C6EF423E.avi,39,1745,1366,379,27.74524158125915,morphological_dilation,3,2
0X412697A4C6EF423E.avi,54,1230,908,322,35.46255506607929,morphological_dilation,3,2
0X412BA2C154A65BFA.avi,119,1532,1192,340,28.523489932885905,morphological_dilation,3,2
0X412BA2C154A65BFA.avi,134,821,569,252,44.288224956063274,morphological_dilation,3,2
0X41308881D4F393B1.avi,50,2267,1816,451,24.834801762114537,morphological_dilation,3,2
0X41308881D4F393B1.avi,66,1397,1013,384,37.90720631786772,morphological_dilation,3,2
0X4130EB4CD7ED958B.avi,36,1913,1509,404,26.772697150430748,morphological_dilation,3,2
0X4130EB4CD7ED958B.avi,51,1270,926,344,37.14902807775378,morphological_dilation,3,2
0X4139F1929AE5230.avi,6,1807,1447,360,24.8790601243953,morphological_dilation,3,2
0X4139F1929AE5230.avi,15,1573,1233,340,27.5750202757502,morphological_dilation,3,2
0X413A04EDB27F10BE.avi,70,1936,1536,400,26.041666666666668,morphological_dilation,3,2
0X413A04EDB27F10BE.avi,88,1169,849,320,37.69140164899882,morphological_dilation,3,2
0X413CDF79953C6C31.avi,35,2174,1755,419,23.874643874643876,morphological_dilation,3,2
0X413CDF79953C6C31.avi,50,1309,965,344,35.64766839378238,morphological_dilation,3,2
0X413DF958F18C23EF.avi,114,1745,1365,380,27.83882783882784,morphological_dilation,3,2
0X413DF958F18C23EF.avi,127,1111,805,306,38.01242236024845,morphological_dilation,3,2
0X41443641BCA80EC1.avi,56,1701,1341,360,26.845637583892618,morphological_dilation,3,2
0X41443641BCA80EC1.avi,81,1350,1030,320,31.06796116504854,morphological_dilation,3,2
0X4146353BEBAC0B61.avi,122,1452,1097,355,32.36098450319052,morphological_dilation,3,2
0X4146353BEBAC0B61.avi,141,835,567,268,47.266313932980594,morphological_dilation,3,2
0X414A9CA51200E64A.avi,91,1883,1479,404,27.315753887762,morphological_dilation,3,2
0X414A9CA51200E64A.avi,105,1190,866,324,37.41339491916859,morphological_dilation,3,2
0X4154F112065C857B.avi,45,1959,1453,506,34.824501032346866,morphological_dilation,3,2
0X4154F112065C857B.avi,265,1818,1426,392,27.489481065918653,morphological_dilation,3,2
0X41563E2CC2230C0E.avi,47,1896,1500,396,26.400000000000002,morphological_dilation,3,2
0X41563E2CC2230C0E.avi,61,1674,1292,382,29.566563467492262,morphological_dilation,3,2
0X415B037A261F0B09.avi,100,1714,1310,404,30.839694656488547,morphological_dilation,3,2
0X415B037A261F0B09.avi,119,1159,839,320,38.14064362336114,morphological_dilation,3,2
0X415C13236237ADB7.avi,86,1458,1118,340,30.41144901610018,morphological_dilation,3,2
0X415C13236237ADB7.avi,103,1050,758,292,38.522427440633244,morphological_dilation,3,2
0X415D34188C1D556C.avi,63,2635,2151,484,22.501162250116224,morphological_dilation,3,2
0X415D34188C1D556C.avi,83,1571,1211,360,29.72749793559042,morphological_dilation,3,2
0X415E9AAB5322E413.avi,45,1801,1405,396,28.18505338078292,morphological_dilation,3,2
0X415E9AAB5322E413.avi,61,1120,804,316,39.30348258706468,morphological_dilation,3,2
0X4160B78C9976F248.avi,2,1758,1390,368,26.47482014388489,morphological_dilation,3,2
0X4160B78C9976F248.avi,19,1070,774,296,38.24289405684754,morphological_dilation,3,2
0X4161CE9AEBC8547A.avi,48,1780,1360,420,30.88235294117647,morphological_dilation,3,2
0X4161CE9AEBC8547A.avi,67,1101,733,368,50.20463847203275,morphological_dilation,3,2
0X41620B09AE05528A.avi,64,2665,2181,484,22.191655204034845,morphological_dilation,3,2
0X41620B09AE05528A.avi,81,1628,1217,411,33.77156943303204,morphological_dilation,3,2
0X4164152D3E303FE3.avi,164,3726,3154,572,18.13570069752695,morphological_dilation,3,2
0X4164152D3E303FE3.avi,189,2118,1686,432,25.622775800711743,morphological_dilation,3,2
0X41705247E0540BD7.avi,44,1134,816,318,38.970588235294116,morphological_dilation,3,2
0X41705247E0540BD7.avi,55,681,429,252,58.74125874125874,morphological_dilation,3,2
0X41744FC51A5EE79B.avi,33,1649,1269,380,29.944838455476752,morphological_dilation,3,2
0X41744FC51A5EE79B.avi,45,1134,798,336,42.10526315789473,morphological_dilation,3,2
0X4176EA075A0EBF26.avi,48,1086,767,319,41.59061277705345,morphological_dilation,3,2
0X4176EA075A0EBF26.avi,58,660,404,256,63.366336633663366,morphological_dilation,3,2
0X417AD9FA7525C729.avi,108,1351,1031,320,31.03782735208536,morphological_dilation,3,2
0X417AD9FA7525C729.avi,120,767,527,240,45.54079696394687,morphological_dilation,3,2
0X417FE24DAA4F1CFD.avi,60,1823,1419,404,28.4707540521494,morphological_dilation,3,2
0X417FE24DAA4F1CFD.avi,77,1378,1028,350,34.04669260700389,morphological_dilation,3,2
0X418002B8508D5B48.avi,40,1349,1013,336,33.16880552813426,morphological_dilation,3,2
0X418002B8508D5B48.avi,60,879,607,272,44.81054365733114,morphological_dilation,3,2
0X418085E25998E23F.avi,102,1510,1146,364,31.762652705061083,morphological_dilation,3,2
0X418085E25998E23F.avi,116,1009,706,303,42.91784702549575,morphological_dilation,3,2
0X4181DF413111AE92.avi,51,1530,1150,380,33.04347826086956,morphological_dilation,3,2
0X4181DF413111AE92.avi,65,948,653,295,45.176110260336905,morphological_dilation,3,2
0X41895072DE028B62.avi,43,1986,1566,420,26.81992337164751,morphological_dilation,3,2
0X41895072DE028B62.avi,60,1745,1357,388,28.592483419307296,morphological_dilation,3,2
0X418C2890BA967BAD.avi,108,1690,1318,372,28.224582701062218,morphological_dilation,3,2
0X418C2890BA967BAD.avi,127,943,659,284,43.09559939301973,morphological_dilation,3,2
0X418DBC5A437805F7.avi,126,1661,1297,364,28.064764841942946,morphological_dilation,3,2
0X418DBC5A437805F7.avi,148,1098,798,300,37.59398496240601,morphological_dilation,3,2
0X418EBC0BB953DD1D.avi,97,1887,1479,408,27.586206896551722,morphological_dilation,3,2
0X418EBC0BB953DD1D.avi,118,1043,731,312,42.6812585499316,morphological_dilation,3,2
0X419129FDE2B698.avi,48,2186,1770,416,23.502824858757062,morphological_dilation,3,2
0X419129FDE2B698.avi,61,1428,1084,344,31.73431734317343,morphological_dilation,3,2
0X4191ACD0157311E5.avi,128,2096,1684,412,24.46555819477435,morphological_dilation,3,2
0X4191ACD0157311E5.avi,148,1478,1122,356,31.72905525846702,morphological_dilation,3,2
0X4192B06B630C55B.avi,54,1575,1211,364,30.057803468208093,morphological_dilation,3,2
0X4192B06B630C55B.avi,81,1113,797,316,39.6486825595985,morphological_dilation,3,2
0X4195ECBB24A79F9C.avi,52,1839,1451,388,26.740179186767747,morphological_dilation,3,2
0X4195ECBB24A79F9C.avi,76,1534,1166,368,31.56089193825043,morphological_dilation,3,2
0X4196162A5DACE3D3.avi,2,2742,2262,480,21.220159151193634,morphological_dilation,3,2
0X4196162A5DACE3D3.avi,22,1430,1063,367,34.52492944496707,morphological_dilation,3,2
0X41968367F83EE799.avi,27,1216,892,324,36.32286995515695,morphological_dilation,3,2
0X41968367F83EE799.avi,39,912,632,280,44.303797468354425,morphological_dilation,3,2
0X419AE8BD5422648A.avi,65,1326,1002,324,32.33532934131736,morphological_dilation,3,2
0X419AE8BD5422648A.avi,80,877,613,264,43.066884176182704,morphological_dilation,3,2
0X419B8AB73B88CD2.avi,38,1644,1273,371,29.143754909662217,morphological_dilation,3,2
0X419B8AB73B88CD2.avi,51,1064,748,316,42.24598930481284,morphological_dilation,3,2
0X419CFE84D92DA4C9.avi,45,1477,1116,361,32.34767025089606,morphological_dilation,3,2
0X419CFE84D92DA4C9.avi,64,923,571,352,61.646234676007005,morphological_dilation,3,2
0X419D371816750A8F.avi,50,1818,1434,384,26.778242677824267,morphological_dilation,3,2
0X419D371816750A8F.avi,67,1162,842,320,38.00475059382423,morphological_dilation,3,2
0X41A0E8A4807C4032.avi,41,1893,1517,376,24.785761371127222,morphological_dilation,3,2
0X41A0E8A4807C4032.avi,59,1459,1135,324,28.54625550660793,morphological_dilation,3,2
0X41A429D0083F5F5.avi,43,2069,1657,412,24.864212432106218,morphological_dilation,3,2
0X41A429D0083F5F5.avi,64,1277,933,344,36.87031082529475,morphological_dilation,3,2
0X41ABCD5C085A1AD1.avi,67,2755,2251,504,22.390048867170144,morphological_dilation,3,2
0X41ABCD5C085A1AD1.avi,83,2000,1536,464,30.208333333333332,morphological_dilation,3,2
0X41AC5C5FC2E3352A.avi,56,1377,1031,346,33.559650824442286,morphological_dilation,3,2
0X41AC5C5FC2E3352A.avi,64,1089,781,308,39.436619718309856,morphological_dilation,3,2
0X41B290E45772DEE1.avi,43,1529,1181,348,29.466553767993226,morphological_dilation,3,2
0X41B290E45772DEE1.avi,53,1013,717,296,41.283124128312416,morphological_dilation,3,2
0X41B2A2D4742E77C1.avi,40,1276,902,374,41.46341463414634,morphological_dilation,3,2
0X41B2A2D4742E77C1.avi,58,1114,763,351,46.00262123197903,morphological_dilation,3,2
0X41B72A9649E82710.avi,83,1814,1426,388,27.20897615708275,morphological_dilation,3,2
0X41B72A9649E82710.avi,97,1147,839,308,36.7103694874851,morphological_dilation,3,2
0X41B74DD5E613C49F.avi,4,1601,1229,372,30.268510984540274,morphological_dilation,3,2
0X41B74DD5E613C49F.avi,20,1042,726,316,43.52617079889807,morphological_dilation,3,2
0X41BA1D1E3BB9581F.avi,49,1289,981,308,31.396534148827726,morphological_dilation,3,2
0X41BA1D1E3BB9581F.avi,73,992,724,268,37.01657458563536,morphological_dilation,3,2
0X41BAB6D9416FBE7B.avi,43,2174,1714,460,26.837806301050176,morphological_dilation,3,2
0X41BAB6D9416FBE7B.avi,65,1372,1004,368,36.65338645418327,morphological_dilation,3,2
0X41BB1EB5C7CD7602.avi,69,1611,1239,372,30.024213075060537,morphological_dilation,3,2
0X41BB1EB5C7CD7602.avi,87,1021,709,312,44.00564174894217,morphological_dilation,3,2
0X41C2A106032ED4C8.avi,78,1465,1117,348,31.15487914055506,morphological_dilation,3,2
0X41C2A106032ED4C8.avi,92,871,579,292,50.431778929188255,morphological_dilation,3,2
0X41CCADA441ED8E9D.avi,129,1654,1282,372,29.017160686427456,morphological_dilation,3,2
0X41CCADA441ED8E9D.avi,145,1343,991,352,35.51967709384461,morphological_dilation,3,2
0X41D05190CAD06AFF.avi,62,1560,1188,372,31.313131313131315,morphological_dilation,3,2
0X41D05190CAD06AFF.avi,80,918,609,309,50.73891625615764,morphological_dilation,3,2
0X41D3376851045E5C.avi,32,1542,1158,384,33.160621761658035,morphological_dilation,3,2
0X41D3376851045E5C.avi,50,1043,719,324,45.06258692628651,morphological_dilation,3,2
0X41D34DC8CABC6CEB.avi,120,2103,1691,412,24.36428149024246,morphological_dilation,3,2
0X41D34DC8CABC6CEB.avi,146,1292,956,336,35.146443514644346,morphological_dilation,3,2
0X41DE226BF847CB96.avi,51,2404,1936,468,24.173553719008265,morphological_dilation,3,2
0X41DE226BF847CB96.avi,66,1414,1050,364,34.66666666666667,morphological_dilation,3,2
0X41E0823368A8B52C.avi,103,2739,2235,504,22.550335570469798,morphological_dilation,3,2
0X41E0823368A8B52C.avi,121,2036,1583,453,28.616550852811116,morphological_dilation,3,2
0X41E72F7748120F47.avi,112,1476,1140,336,29.47368421052631,morphological_dilation,3,2
0X41E72F7748120F47.avi,126,1000,712,288,40.44943820224719,morphological_dilation,3,2
0X41E921A2E68382C.avi,64,2059,1627,432,26.551936078672405,morphological_dilation,3,2
0X41E921A2E68382C.avi,81,1758,1342,416,30.998509687034275,morphological_dilation,3,2
0X41EBF1EA58FF8DD9.avi,67,1511,1171,340,29.035012809564474,morphological_dilation,3,2
0X41EBF1EA58FF8DD9.avi,84,953,673,280,41.60475482912333,morphological_dilation,3,2
0X41ECEC7AAEEFD0E6.avi,94,2569,2101,468,22.275107091861017,morphological_dilation,3,2
0X41ECEC7AAEEFD0E6.avi,110,1609,1235,374,30.2834008097166,morphological_dilation,3,2
0X41EDA817E75BE7C5.avi,50,1728,1368,360,26.31578947368421,morphological_dilation,3,2
0X41EDA817E75BE7C5.avi,72,1127,823,304,36.93803159173755,morphological_dilation,3,2
0X41F0358EBEADDEBC.avi,83,1457,1129,328,29.052258635961024,morphological_dilation,3,2
0X41F0358EBEADDEBC.avi,103,1113,809,304,37.57725587144623,morphological_dilation,3,2
0X41F15BF2544F66AF.avi,54,1362,1000,362,36.199999999999996,morphological_dilation,3,2
0X41F15BF2544F66AF.avi,76,920,576,344,59.72222222222222,morphological_dilation,3,2
0X41F3070C2F41EE12.avi,86,2271,1839,432,23.491027732463294,morphological_dilation,3,2
0X41F3070C2F41EE12.avi,101,1337,989,348,35.18705763397371,morphological_dilation,3,2
0X41F30922BBD210B2.avi,108,1072,756,316,41.7989417989418,morphological_dilation,3,2
0X41F30922BBD210B2.avi,122,689,415,274,66.02409638554217,morphological_dilation,3,2
0X41F8C8319BD36BF2.avi,51,2398,1959,439,22.40939254721797,morphological_dilation,3,2
0X41F8C8319BD36BF2.avi,69,1425,1061,364,34.30725730442978,morphological_dilation,3,2
0X41FE84170D568B47.avi,87,1408,1064,344,32.33082706766917,morphological_dilation,3,2
0X41FE84170D568B47.avi,105,830,562,268,47.686832740213525,morphological_dilation,3,2
0X420398026F3662C9.avi,50,1235,896,339,37.83482142857143,morphological_dilation,3,2
0X420398026F3662C9.avi,64,933,623,310,49.75922953451043,morphological_dilation,3,2
0X4205814AC4202A6F.avi,81,1620,1252,368,29.39297124600639,morphological_dilation,3,2
0X4205814AC4202A6F.avi,95,1036,736,300,40.76086956521739,morphological_dilation,3,2
0X4205B4B64D62076E.avi,42,1552,1181,371,31.41405588484335,morphological_dilation,3,2
0X4205B4B64D62076E.avi,59,909,618,291,47.0873786407767,morphological_dilation,3,2
0X420CADF76E49326E.avi,122,2394,1970,424,21.522842639593907,morphological_dilation,3,2
0X420CADF76E49326E.avi,140,1540,1184,356,30.067567567567565,morphological_dilation,3,2
0X4214946C295B2A3F.avi,47,1200,864,336,38.88888888888889,morphological_dilation,3,2
0X4214946C295B2A3F.avi,64,818,534,284,53.18352059925093,morphological_dilation,3,2
0X42160C64630C3604.avi,64,1891,1503,388,25.815036593479707,morphological_dilation,3,2
0X42160C64630C3604.avi,84,1153,837,316,37.753882915173236,morphological_dilation,3,2
0X42186EEA400ABD80.avi,35,1130,818,312,38.141809290953546,morphological_dilation,3,2
0X42186EEA400ABD80.avi,50,800,528,272,51.515151515151516,morphological_dilation,3,2
0X421A1675AA317C41.avi,74,1630,1270,360,28.346456692913385,morphological_dilation,3,2
0X421A1675AA317C41.avi,87,904,612,292,47.712418300653596,morphological_dilation,3,2
0X421B7C03B9A14BBD.avi,40,2098,1679,419,24.95533055390113,morphological_dilation,3,2
0X421B7C03B9A14BBD.avi,58,1386,1034,352,34.04255319148936,morphological_dilation,3,2
0X42221E1A611968E4.avi,53,1931,1519,412,27.123107307439103,morphological_dilation,3,2
0X42221E1A611968E4.avi,68,1247,903,344,38.095238095238095,morphological_dilation,3,2
0X422467D9C123BE7F.avi,47,2374,1946,428,21.99383350462487,morphological_dilation,3,2
0X422467D9C123BE7F.avi,73,2120,1708,412,24.121779859484775,morphological_dilation,3,2
0X4225D03BC0BFD7BA.avi,2,1363,1029,334,32.458697764820215,morphological_dilation,3,2
0X4225D03BC0BFD7BA.avi,18,783,510,273,53.529411764705884,morphological_dilation,3,2
0X422763AFB6CC0079.avi,118,1644,1288,356,27.639751552795033,morphological_dilation,3,2
0X422763AFB6CC0079.avi,131,973,697,276,39.59827833572454,morphological_dilation,3,2
0X4227F6B51B9564C1.avi,49,2561,2077,484,23.302840635532018,morphological_dilation,3,2
0X4227F6B51B9564C1.avi,66,1432,1015,417,41.083743842364534,morphological_dilation,3,2
0X422C6837BE6E90FF.avi,38,1471,1123,348,30.98842386464826,morphological_dilation,3,2
0X422C6837BE6E90FF.avi,45,968,672,296,44.047619047619044,morphological_dilation,3,2
0X423111F7729F2921.avi,127,1608,1196,412,34.448160535117054,morphological_dilation,3,2
0X423111F7729F2921.avi,145,961,579,382,65.97582037996546,morphological_dilation,3,2
0X423333322D0460A1.avi,52,2360,1902,458,24.079915878023133,morphological_dilation,3,2
0X423333322D0460A1.avi,70,1409,1061,348,32.79924599434496,morphological_dilation,3,2
0X4234AE7B8A1D56DB.avi,80,1730,1354,376,27.76957163958641,morphological_dilation,3,2
0X4234AE7B8A1D56DB.avi,89,1396,1068,328,30.711610486891384,morphological_dilation,3,2
0X423517ED3C3F4F4A.avi,45,2102,1679,423,25.193567599761764,morphological_dilation,3,2
0X423517ED3C3F4F4A.avi,63,1410,1052,358,34.030418250950575,morphological_dilation,3,2
0X423C16E2A001C3F4.avi,0,2075,1645,430,26.13981762917933,morphological_dilation,3,2
0X423C16E2A001C3F4.avi,19,1233,901,332,36.847946725860155,morphological_dilation,3,2
0X423CEDC513D5B859.avi,2,1374,1046,328,31.35755258126195,morphological_dilation,3,2
0X423CEDC513D5B859.avi,19,1089,785,304,38.726114649681534,morphological_dilation,3,2
0X423EA0BF7849D62F.avi,59,1404,1072,332,30.970149253731343,morphological_dilation,3,2
0X423EA0BF7849D62F.avi,71,898,614,284,46.25407166123778,morphological_dilation,3,2
0X42452C0B4B89666C.avi,148,1969,1561,408,26.137091607943624,morphological_dilation,3,2
0X42452C0B4B89666C.avi,166,1171,835,336,40.23952095808383,morphological_dilation,3,2
0X4245425C1E02917.avi,112,1667,1295,372,28.725868725868725,morphological_dilation,3,2
0X4245425C1E02917.avi,124,1037,737,300,40.70556309362279,morphological_dilation,3,2
0X4248836479957C64.avi,105,2127,1703,424,24.897240164415738,morphological_dilation,3,2
0X4248836479957C64.avi,119,1148,832,316,37.980769230769226,morphological_dilation,3,2
0X424902FAA612F188.avi,6,1383,1043,340,32.59827420901246,morphological_dilation,3,2
0X424902FAA612F188.avi,18,1081,769,312,40.572171651495445,morphological_dilation,3,2
0X424A49302AC57003.avi,3,1169,857,312,36.406067677946325,morphological_dilation,3,2
0X424A49302AC57003.avi,18,693,441,252,57.14285714285714,morphological_dilation,3,2
0X4251AEC1C92C818B.avi,80,2647,2163,484,22.37632917244568,morphological_dilation,3,2
0X4251AEC1C92C818B.avi,93,1497,1109,388,34.98647430117223,morphological_dilation,3,2
0X42524FDE837219AD.avi,79,2440,2000,440,22.0,morphological_dilation,3,2
0X42524FDE837219AD.avi,103,1522,1162,360,30.98106712564544,morphological_dilation,3,2
0X4255A4E685B8C704.avi,1,1735,1355,380,28.044280442804425,morphological_dilation,3,2
0X4255A4E685B8C704.avi,14,1219,883,336,38.052095130237824,morphological_dilation,3,2
0X4258AE527948FCC6.avi,77,1259,899,360,40.04449388209122,morphological_dilation,3,2
0X4258AE527948FCC6.avi,88,820,528,292,55.3030303030303,morphological_dilation,3,2
0X425BF6D9A7606E95.avi,106,1263,931,332,35.660580021482275,morphological_dilation,3,2
0X425BF6D9A7606E95.avi,115,830,542,288,53.13653136531366,morphological_dilation,3,2
0X425ED2D33412C0ED.avi,103,2006,1618,388,23.980222496909764,morphological_dilation,3,2
0X425ED2D33412C0ED.avi,135,1232,906,326,35.98233995584989,morphological_dilation,3,2
0X4260E36917BA928C.avi,66,1951,1531,420,27.433050293925536,morphological_dilation,3,2
0X4260E36917BA928C.avi,84,1152,813,339,41.69741697416974,morphological_dilation,3,2
0X4261735B7D42AAC3.avi,78,2111,1703,408,23.95772166764533,morphological_dilation,3,2
0X4261735B7D42AAC3.avi,94,1483,1127,356,31.588287488908605,morphological_dilation,3,2
0X4263AE5BC2AB585.avi,54,1619,1247,372,29.83159582999198,morphological_dilation,3,2
0X4263AE5BC2AB585.avi,68,947,647,300,46.36785162287481,morphological_dilation,3,2
0X42686D6D058B94F3.avi,69,2054,1618,436,26.94684796044499,morphological_dilation,3,2
0X42686D6D058B94F3.avi,79,1301,945,356,37.67195767195767,morphological_dilation,3,2
0X4269E4638DFA9D6F.avi,199,3297,2793,504,18.045112781954884,morphological_dilation,3,2
0X4269E4638DFA9D6F.avi,222,2178,1731,447,25.82322357019064,morphological_dilation,3,2
0X426A61CAF55DE426.avi,88,1797,1405,392,27.900355871886124,morphological_dilation,3,2
0X426A61CAF55DE426.avi,103,1114,806,308,38.21339950372209,morphological_dilation,3,2
0X4271BA2AE35CA20C.avi,33,1525,1165,360,30.90128755364807,morphological_dilation,3,2
0X4271BA2AE35CA20C.avi,49,902,618,284,45.9546925566343,morphological_dilation,3,2
0X427B9E706F15970F.avi,37,1205,899,306,34.03781979977753,morphological_dilation,3,2
0X427B9E706F15970F.avi,54,669,429,240,55.94405594405595,morphological_dilation,3,2
0X427F2A16BCD02AC1.avi,110,1571,1219,352,28.87612797374898,morphological_dilation,3,2
0X427F2A16BCD02AC1.avi,122,947,659,288,43.70257966616085,morphological_dilation,3,2
0X4289FCE738C4F880.avi,110,2080,1673,407,24.32755528989839,morphological_dilation,3,2
0X4289FCE738C4F880.avi,130,1179,858,321,37.41258741258741,morphological_dilation,3,2
0X428C4C892FAA3A4.avi,109,1542,1170,372,31.794871794871792,morphological_dilation,3,2
0X428C4C892FAA3A4.avi,127,890,595,295,49.57983193277311,morphological_dilation,3,2
0X4291313997B65398.avi,35,1532,1180,352,29.830508474576273,morphological_dilation,3,2
0X4291313997B65398.avi,70,955,659,296,44.916540212443095,morphological_dilation,3,2
0X4293A45F4307D1C1.avi,103,3337,2801,536,19.136022848982506,morphological_dilation,3,2
0X4293A45F4307D1C1.avi,124,2292,1837,455,24.76864452912357,morphological_dilation,3,2
0X429630AA81357707.avi,49,1436,1088,348,31.985294117647058,morphological_dilation,3,2
0X429630AA81357707.avi,66,891,611,280,45.826513911620296,morphological_dilation,3,2
0X4298D4668E5A228E.avi,138,1593,1241,352,28.364222401289286,morphological_dilation,3,2
0X4298D4668E5A228E.avi,154,888,624,264,42.30769230769231,morphological_dilation,3,2
0X429D3AEAF71AF3A0.avi,4,1548,1202,346,28.785357737104828,morphological_dilation,3,2
0X429D3AEAF71AF3A0.avi,14,886,599,287,47.91318864774624,morphological_dilation,3,2
0X429D577F56E5C4C4.avi,0,1414,1074,340,31.65735567970205,morphological_dilation,3,2
0X429D577F56E5C4C4.avi,12,964,674,290,43.02670623145401,morphological_dilation,3,2
0X429DCB15C18B3DAC.avi,54,1632,1261,371,29.42109436954798,morphological_dilation,3,2
0X429DCB15C18B3DAC.avi,69,914,589,325,55.178268251273344,morphological_dilation,3,2
0X429EA0C3F7F89BE4.avi,76,2080,1664,416,25.0,morphological_dilation,3,2
0X429EA0C3F7F89BE4.avi,93,1168,852,316,37.08920187793427,morphological_dilation,3,2
0X429F7C1AEE51AE35.avi,89,1491,1119,372,33.24396782841823,morphological_dilation,3,2
0X429F7C1AEE51AE35.avi,108,831,534,297,55.61797752808989,morphological_dilation,3,2
0X429FE687ADA1461C.avi,55,1879,1487,392,26.36180228648285,morphological_dilation,3,2
0X429FE687ADA1461C.avi,75,1034,730,304,41.64383561643836,morphological_dilation,3,2
0X42A20F2F4933967B.avi,107,1835,1447,388,26.81409813407049,morphological_dilation,3,2
0X42A20F2F4933967B.avi,123,1144,824,320,38.83495145631068,morphological_dilation,3,2
0X42A3C9A6C7D2E883.avi,0,3635,3079,556,18.057810977590126,morphological_dilation,3,2
0X42A3C9A6C7D2E883.avi,20,2745,2184,561,25.686813186813183,morphological_dilation,3,2
0X42A595A2F699E62C.avi,46,2100,1692,408,24.113475177304963,morphological_dilation,3,2
0X42A595A2F699E62C.avi,64,1208,876,332,37.89954337899543,morphological_dilation,3,2
0X42A8CA2A231EB60D.avi,52,2595,2099,496,23.630300142925204,morphological_dilation,3,2
0X42A8CA2A231EB60D.avi,70,1709,1276,433,33.93416927899687,morphological_dilation,3,2
0X42A97568F13E2DB2.avi,33,1524,1176,348,29.591836734693878,morphological_dilation,3,2
0X42A97568F13E2DB2.avi,43,972,684,288,42.10526315789473,morphological_dilation,3,2
0X42AADB936FD457E6.avi,44,880,604,276,45.6953642384106,morphological_dilation,3,2
0X42AADB936FD457E6.avi,57,576,356,220,61.79775280898876,morphological_dilation,3,2
0X42AF88E9A1646C0D.avi,64,2134,1730,404,23.352601156069362,morphological_dilation,3,2
0X42AF88E9A1646C0D.avi,78,1358,1010,348,34.45544554455445,morphological_dilation,3,2
0X42B6080C10501A3C.avi,39,1814,1430,384,26.853146853146853,morphological_dilation,3,2
0X42B6080C10501A3C.avi,61,989,697,292,41.89383070301291,morphological_dilation,3,2
0X42B73B5F4502A112.avi,60,1407,1047,360,34.38395415472779,morphological_dilation,3,2
0X42B73B5F4502A112.avi,72,1056,730,326,44.657534246575345,morphological_dilation,3,2
0X42BCAEEAABF2299B.avi,73,1832,1444,388,26.869806094182824,morphological_dilation,3,2
0X42BCAEEAABF2299B.avi,86,1254,922,332,36.00867678958785,morphological_dilation,3,2
0X42C04088F5D97815.avi,94,2468,2018,450,22.29930624380575,morphological_dilation,3,2
0X42C04088F5D97815.avi,112,1807,1427,380,26.629292221443592,morphological_dilation,3,2
0X42C3CEBDAA6DDFFF.avi,35,1496,1128,368,32.62411347517731,morphological_dilation,3,2
0X42C3CEBDAA6DDFFF.avi,57,990,674,316,46.88427299703264,morphological_dilation,3,2
0X42C8891F05AF4C14.avi,41,1225,901,324,35.96004439511653,morphological_dilation,3,2
0X42C8891F05AF4C14.avi,61,810,562,248,44.128113879003564,morphological_dilation,3,2
0X42C8E86BF44DA282.avi,46,2168,1720,448,26.046511627906977,morphological_dilation,3,2
0X42C8E86BF44DA282.avi,63,1264,911,353,38.748627881448954,morphological_dilation,3,2
0X42CAA48D4E8A27F2.avi,50,1309,993,316,31.822759315206444,morphological_dilation,3,2
0X42CAA48D4E8A27F2.avi,69,819,559,260,46.51162790697674,morphological_dilation,3,2
0X42CBCE2146F01745.avi,46,1898,1506,392,26.029216467463478,morphological_dilation,3,2
0X42CBCE2146F01745.avi,60,1300,964,336,34.85477178423236,morphological_dilation,3,2
0X42CBFD88E60F9D7B.avi,51,1576,1224,352,28.75816993464052,morphological_dilation,3,2
0X42CBFD88E60F9D7B.avi,66,1210,894,316,35.34675615212528,morphological_dilation,3,2
0X42D0EE9B93BD8553.avi,66,1274,962,312,32.432432432432435,morphological_dilation,3,2
0X42D0EE9B93BD8553.avi,76,980,704,276,39.20454545454545,morphological_dilation,3,2
0X42D952F5218473D0.avi,94,2598,2114,484,22.894985808893093,morphological_dilation,3,2
0X42D952F5218473D0.avi,110,1679,1264,415,32.83227848101266,morphological_dilation,3,2
0X42E373298623FEB5.avi,41,1295,955,340,35.602094240837694,morphological_dilation,3,2
0X42E373298623FEB5.avi,54,814,550,264,48.0,morphological_dilation,3,2
0X42E71F03706C0C1B.avi,83,1759,1379,380,27.556200145032633,morphological_dilation,3,2
0X42E71F03706C0C1B.avi,97,1152,830,322,38.795180722891565,morphological_dilation,3,2
0X42E75641217CF946.avi,35,1412,1048,364,34.73282442748092,morphological_dilation,3,2
0X42E75641217CF946.avi,49,1177,789,388,49.17617237008872,morphological_dilation,3,2
0X42E8226CA93B7BAC.avi,84,2357,1929,428,22.187662001036806,morphological_dilation,3,2
0X42E8226CA93B7BAC.avi,99,1487,1135,352,31.013215859030836,morphological_dilation,3,2
0X42EE64F2F93A5495.avi,120,1747,1379,368,26.68600435097897,morphological_dilation,3,2
0X42EE64F2F93A5495.avi,139,1109,805,304,37.7639751552795,morphological_dilation,3,2
0X42F1D77D086650B7.avi,45,1780,1368,412,30.116959064327485,morphological_dilation,3,2
0X42F1D77D086650B7.avi,60,1126,767,359,46.80573663624511,morphological_dilation,3,2
0X42F2DEE7361EB3EA.avi,42,2255,1811,444,24.516841524019878,morphological_dilation,3,2
0X42F2DEE7361EB3EA.avi,57,1453,1069,384,35.92142188961646,morphological_dilation,3,2
0X42F505EAA821321C.avi,1,2098,1690,408,24.142011834319526,morphological_dilation,3,2
0X42F505EAA821321C.avi,19,1283,951,332,34.910620399579386,morphological_dilation,3,2
0X42F798C10FDBFFD2.avi,2,2267,1827,440,24.0831964969896,morphological_dilation,3,2
0X42F798C10FDBFFD2.avi,21,1512,1135,377,33.215859030837,morphological_dilation,3,2
0X42F9A073A7F81C75.avi,53,1785,1417,368,25.970359915314045,morphological_dilation,3,2
0X42F9A073A7F81C75.avi,72,1036,744,292,39.247311827956985,morphological_dilation,3,2
0X42FA0DD3D57C70F0.avi,48,2443,1987,456,22.949169602415704,morphological_dilation,3,2
0X42FA0DD3D57C70F0.avi,60,1901,1497,404,26.9873079492318,morphological_dilation,3,2
0X42FB891C8FD2AF86.avi,46,1714,1342,372,27.719821162444113,morphological_dilation,3,2
0X42FB891C8FD2AF86.avi,65,1114,794,320,40.302267002518896,morphological_dilation,3,2
0X42FBF848EE88CB8D.avi,58,2137,1729,408,23.597455176402544,morphological_dilation,3,2
0X42FBF848EE88CB8D.avi,80,1316,988,328,33.198380566801625,morphological_dilation,3,2
0X42FC131122748839.avi,63,1073,769,304,39.531859557867364,morphological_dilation,3,2
0X42FC131122748839.avi,72,899,615,284,46.17886178861789,morphological_dilation,3,2
0X42FCA98A2D9A42ED.avi,134,1535,1175,360,30.638297872340424,morphological_dilation,3,2
0X42FCA98A2D9A42ED.avi,153,975,679,296,43.59351988217968,morphological_dilation,3,2
0X42FE7843ABA61F46.avi,47,1431,1109,322,29.035166816952206,morphological_dilation,3,2
0X42FE7843ABA61F46.avi,66,931,655,276,42.13740458015267,morphological_dilation,3,2
0X43006B44D749C590.avi,85,1642,1266,376,29.6998420221169,morphological_dilation,3,2
0X43006B44D749C590.avi,94,1481,1121,360,32.114183764495984,morphological_dilation,3,2
0X43023BBA3D8A2262.avi,3,1351,1023,328,32.06256109481916,morphological_dilation,3,2
0X43023BBA3D8A2262.avi,22,917,645,272,42.17054263565891,morphological_dilation,3,2
0X430656FE4E49EF4.avi,40,1418,1054,364,34.53510436432637,morphological_dilation,3,2
0X430656FE4E49EF4.avi,53,1050,734,316,43.05177111716621,morphological_dilation,3,2
0X430D43B88803388B.avi,44,1384,1028,356,34.63035019455253,morphological_dilation,3,2
0X430D43B88803388B.avi,63,964,656,308,46.95121951219512,morphological_dilation,3,2
0X430DF0D4A4EAAF4F.avi,44,1821,1425,396,27.789473684210524,morphological_dilation,3,2
0X430DF0D4A4EAAF4F.avi,66,1184,852,332,38.967136150234744,morphological_dilation,3,2
0X431296CD82BE53D1.avi,43,2992,2504,488,19.488817891373802,morphological_dilation,3,2
0X431296CD82BE53D1.avi,60,2030,1626,404,24.846248462484624,morphological_dilation,3,2
0X43175234A39001F7.avi,46,2089,1693,396,23.390431187241585,morphological_dilation,3,2
0X43175234A39001F7.avi,69,1746,1378,368,26.705370101596515,morphological_dilation,3,2
0X4317999FCC5CED6.avi,51,2373,1917,456,23.78716744913928,morphological_dilation,3,2
0X4317999FCC5CED6.avi,68,1673,1269,404,31.836091410559497,morphological_dilation,3,2
0X4318E9C5A211F415.avi,72,1765,1365,400,29.304029304029307,morphological_dilation,3,2
0X4318E9C5A211F415.avi,94,1334,990,344,34.74747474747475,morphological_dilation,3,2
0X431DCBBC8DB99EB.avi,131,1537,1197,340,28.404344193817877,morphological_dilation,3,2
0X431DCBBC8DB99EB.avi,149,1074,778,296,38.04627249357326,morphological_dilation,3,2
0X431E2B7F33C1E480.avi,48,2107,1659,448,27.004219409282697,morphological_dilation,3,2
0X431E2B7F33C1E480.avi,66,1383,987,396,40.121580547112465,morphological_dilation,3,2
0X431E5FB3F15C0615.avi,76,1546,1182,364,30.79526226734349,morphological_dilation,3,2
0X431E5FB3F15C0615.avi,92,923,603,320,53.06799336650083,morphological_dilation,3,2
0X432623D2D414961F.avi,36,1805,1393,412,29.576453697056714,morphological_dilation,3,2
0X432623D2D414961F.avi,50,1251,911,340,37.32162458836443,morphological_dilation,3,2
0X4326F9C7F097171F.avi,42,2202,1750,452,25.82857142857143,morphological_dilation,3,2
0X4326F9C7F097171F.avi,56,1297,949,348,36.670179135932564,morphological_dilation,3,2
0X432B70567E87D984.avi,31,2004,1600,404,25.25,morphological_dilation,3,2
0X432B70567E87D984.avi,47,1485,1125,360,32.0,morphological_dilation,3,2
0X432F60CE4D406775.avi,4,1741,1346,395,29.34621099554235,morphological_dilation,3,2
0X432F60CE4D406775.avi,18,1068,750,318,42.4,morphological_dilation,3,2
0X433A0F02D46DF762.avi,104,1374,1030,344,33.398058252427184,morphological_dilation,3,2
0X433A0F02D46DF762.avi,121,942,654,288,44.03669724770643,morphological_dilation,3,2
0X433AB6AAF05E964.avi,38,1770,1394,376,26.97274031563845,morphological_dilation,3,2
0X433AB6AAF05E964.avi,54,1128,812,316,38.91625615763547,morphological_dilation,3,2
0X433BDA782B668C2A.avi,50,1887,1488,399,26.814516129032256,morphological_dilation,3,2
0X433BDA782B668C2A.avi,66,1083,763,320,41.9397116644823,morphological_dilation,3,2
0X4341623F0423931B.avi,90,1992,1596,396,24.81203007518797,morphological_dilation,3,2
0X4341623F0423931B.avi,105,1203,883,320,36.2400906002265,morphological_dilation,3,2
0X434587808499737A.avi,33,1434,1090,344,31.55963302752294,morphological_dilation,3,2
0X434587808499737A.avi,57,817,557,260,46.678635547576306,morphological_dilation,3,2
0X4349B3104CBFBBDD.avi,52,3161,2588,573,22.14064914992272,morphological_dilation,3,2
0X4349B3104CBFBBDD.avi,75,1967,1512,455,30.09259259259259,morphological_dilation,3,2
0X434E045B4F822B88.avi,57,2565,2121,444,20.933521923620933,morphological_dilation,3,2
0X434E045B4F822B88.avi,70,2366,1946,420,21.58273381294964,morphological_dilation,3,2
0X434FFAE9BF99D811.avi,49,3957,3381,576,17.036379769299025,morphological_dilation,3,2
0X434FFAE9BF99D811.avi,72,2712,2225,487,21.8876404494382,morphological_dilation,3,2
0X4350FE5538F115C9.avi,1,1389,1046,343,32.79158699808795,morphological_dilation,3,2
0X4350FE5538F115C9.avi,16,902,618,284,45.9546925566343,morphological_dilation,3,2
0X4356EE7B8102993C.avi,75,1712,1360,352,25.882352941176475,morphological_dilation,3,2
0X4356EE7B8102993C.avi,93,1435,1103,332,30.099728014505896,morphological_dilation,3,2
0X4356F73DF9D111B1.avi,5,1824,1416,408,28.8135593220339,morphological_dilation,3,2
0X4356F73DF9D111B1.avi,20,1437,1073,364,33.92357875116495,morphological_dilation,3,2
0X4357A4E9731D8383.avi,62,2128,1700,428,25.176470588235293,morphological_dilation,3,2
0X4357A4E9731D8383.avi,80,1314,986,328,33.2657200811359,morphological_dilation,3,2
0X4357D74D4E26F278.avi,56,1431,1095,336,30.684931506849317,morphological_dilation,3,2
0X4357D74D4E26F278.avi,76,933,656,277,42.22560975609756,morphological_dilation,3,2
0X435D425391F6DF3C.avi,124,1287,947,340,35.90285110876452,morphological_dilation,3,2
0X435D425391F6DF3C.avi,138,787,527,260,49.33586337760911,morphological_dilation,3,2
0X4361231DA99A3480.avi,88,1276,972,304,31.275720164609055,morphological_dilation,3,2
0X4361231DA99A3480.avi,114,1136,848,288,33.9622641509434,morphological_dilation,3,2
0X436381EDEAF56C17.avi,79,2018,1630,388,23.803680981595093,morphological_dilation,3,2
0X436381EDEAF56C17.avi,97,1632,1280,352,27.500000000000004,morphological_dilation,3,2
0X4365A9CB0E95EDEF.avi,75,2779,2271,508,22.369000440334656,morphological_dilation,3,2
0X4365A9CB0E95EDEF.avi,92,1695,1263,432,34.204275534441805,morphological_dilation,3,2
0X4365DD7E115C67FE.avi,92,1935,1539,396,25.730994152046783,morphological_dilation,3,2
0X4365DD7E115C67FE.avi,107,1186,858,328,38.22843822843823,morphological_dilation,3,2
0X436641C58DF2E587.avi,105,1953,1533,420,27.397260273972602,morphological_dilation,3,2
0X436641C58DF2E587.avi,129,1674,1290,384,29.767441860465116,morphological_dilation,3,2
0X43664BF0CDA9C803.avi,194,1593,1221,372,30.46683046683047,morphological_dilation,3,2
0X43664BF0CDA9C803.avi,213,940,656,284,43.292682926829265,morphological_dilation,3,2
0X436749E54CB808D9.avi,100,1418,1080,338,31.296296296296294,morphological_dilation,3,2
0X436749E54CB808D9.avi,110,877,584,293,50.171232876712324,morphological_dilation,3,2
0X4370E51E70C62FFC.avi,60,2282,1842,440,23.887079261672095,morphological_dilation,3,2
0X4370E51E70C62FFC.avi,80,1331,995,336,33.768844221105525,morphological_dilation,3,2
0X43715A8C6B3E61D0.avi,49,1418,1066,352,33.02063789868668,morphological_dilation,3,2
0X43715A8C6B3E61D0.avi,67,783,495,288,58.18181818181818,morphological_dilation,3,2
0X437170B1DA64BB42.avi,90,2013,1597,416,26.04884157795867,morphological_dilation,3,2
0X437170B1DA64BB42.avi,107,1293,945,348,36.82539682539683,morphological_dilation,3,2
0X4371FE77D4A20EEC.avi,74,2018,1622,396,24.41430332922318,morphological_dilation,3,2
0X4371FE77D4A20EEC.avi,85,1335,1007,328,32.57199602780536,morphological_dilation,3,2
0X43765C8EB3F53183.avi,77,1437,1109,328,29.57619477006312,morphological_dilation,3,2
0X43765C8EB3F53183.avi,92,996,712,284,39.8876404494382,morphological_dilation,3,2
0X43776A8E158E1D2F.avi,39,1926,1522,404,26.544021024967147,morphological_dilation,3,2
0X43776A8E158E1D2F.avi,54,1207,879,328,37.31513083048919,morphological_dilation,3,2
0X437B9516E64991DE.avi,103,1852,1464,388,26.50273224043716,morphological_dilation,3,2
0X437B9516E64991DE.avi,118,1200,880,320,36.36363636363637,morphological_dilation,3,2
0X437D0633EFFC953B.avi,154,1565,1201,364,30.308076602830976,morphological_dilation,3,2
0X437D0633EFFC953B.avi,166,1125,786,339,43.12977099236641,morphological_dilation,3,2
0X437E57907032965C.avi,68,1649,1293,356,27.532869296210364,morphological_dilation,3,2
0X437E57907032965C.avi,88,1085,781,304,38.92445582586428,morphological_dilation,3,2
0X4382CD09EDB1F1AE.avi,52,1265,913,352,38.55421686746988,morphological_dilation,3,2
0X4382CD09EDB1F1AE.avi,65,857,565,292,51.681415929203546,morphological_dilation,3,2
0X43861B35CB8BA1BB.avi,4,2081,1677,404,24.09063804412642,morphological_dilation,3,2
0X43861B35CB8BA1BB.avi,17,1228,904,324,35.84070796460177,morphological_dilation,3,2
0X438D6923619BE51.avi,42,1694,1326,368,27.7526395173454,morphological_dilation,3,2
0X438D6923619BE51.avi,62,1020,724,296,40.88397790055249,morphological_dilation,3,2
0X4399118D8F5C539D.avi,43,2637,2133,504,23.628691983122362,morphological_dilation,3,2
0X4399118D8F5C539D.avi,58,1430,1041,389,37.36791546589818,morphological_dilation,3,2
0X439A555348548AF4.avi,81,1515,1175,340,28.936170212765955,morphological_dilation,3,2
0X439A555348548AF4.avi,90,1202,886,316,35.66591422121896,morphological_dilation,3,2
0X439A95D51AEB357C.avi,70,2926,2418,508,21.009098428453267,morphological_dilation,3,2
0X439A95D51AEB357C.avi,85,1812,1404,408,29.059829059829063,morphological_dilation,3,2
0X439B5F9ACAD2B7B9.avi,22,2407,1975,432,21.873417721518987,morphological_dilation,3,2
0X439B5F9ACAD2B7B9.avi,37,1919,1531,388,25.34291312867407,morphological_dilation,3,2
0X439D002885864206.avi,51,2112,1700,412,24.235294117647058,morphological_dilation,3,2
0X439D002885864206.avi,62,1694,1330,364,27.368421052631582,morphological_dilation,3,2
0X439F5C1EA9F88AB1.avi,54,2082,1634,448,27.41738066095471,morphological_dilation,3,2
0X439F5C1EA9F88AB1.avi,74,1330,962,368,38.25363825363826,morphological_dilation,3,2
0X43A5C5FAAFCA1B2C.avi,55,1469,1125,344,30.577777777777776,morphological_dilation,3,2
0X43A5C5FAAFCA1B2C.avi,72,980,673,307,45.61664190193165,morphological_dilation,3,2
0X43A764414165A4A2.avi,57,1508,1152,356,30.90277777777778,morphological_dilation,3,2
0X43A764414165A4A2.avi,74,901,613,288,46.98205546492659,morphological_dilation,3,2
0X43AC858DBD11798A.avi,32,3195,2675,520,19.439252336448597,morphological_dilation,3,2
0X43AC858DBD11798A.avi,49,1917,1485,432,29.09090909090909,morphological_dilation,3,2
0X43B0DD69DEECF471.avi,50,2309,1881,428,22.7538543328017,morphological_dilation,3,2
0X43B0DD69DEECF471.avi,75,2039,1639,400,24.405125076266014,morphological_dilation,3,2
0X43B379583D0B5CB1.avi,73,2045,1633,412,25.229638701775876,morphological_dilation,3,2
0X43B379583D0B5CB1.avi,88,1232,908,324,35.68281938325991,morphological_dilation,3,2
0X43B733F38B1CBB9D.avi,43,1499,1147,352,30.688753269398433,morphological_dilation,3,2
0X43B733F38B1CBB9D.avi,64,1109,805,304,37.7639751552795,morphological_dilation,3,2
0X43BA107A8AF8080B.avi,32,1773,1405,368,26.19217081850534,morphological_dilation,3,2
0X43BA107A8AF8080B.avi,47,1597,1230,367,29.837398373983742,morphological_dilation,3,2
0X43BC7C82C6B0943F.avi,109,1898,1510,388,25.695364238410594,morphological_dilation,3,2
0X43BC7C82C6B0943F.avi,121,1284,952,332,34.87394957983193,morphological_dilation,3,2
0X43BE743B95734154.avi,2,2302,1886,416,22.057264050901377,morphological_dilation,3,2
0X43BE743B95734154.avi,18,1651,1299,352,27.097767513471897,morphological_dilation,3,2
0X43C9344873751202.avi,38,1216,900,316,35.11111111111111,morphological_dilation,3,2
0X43C9344873751202.avi,53,745,497,248,49.899396378269614,morphological_dilation,3,2
0X43D42D2CAFA7F36D.avi,49,1578,1206,372,30.845771144278604,morphological_dilation,3,2
0X43D42D2CAFA7F36D.avi,65,976,668,308,46.10778443113773,morphological_dilation,3,2
0X43D78A77C44A10E.avi,4,1551,1191,360,30.22670025188917,morphological_dilation,3,2
0X43D78A77C44A10E.avi,16,1192,872,320,36.69724770642202,morphological_dilation,3,2
0X43DA861ABE7A0720.avi,85,1405,1065,340,31.92488262910798,morphological_dilation,3,2
0X43DA861ABE7A0720.avi,103,897,613,284,46.32952691680261,morphological_dilation,3,2
0X43DDF013296DD5B7.avi,81,1134,830,304,36.626506024096386,morphological_dilation,3,2
0X43DDF013296DD5B7.avi,99,737,493,244,49.49290060851927,morphological_dilation,3,2
0X43DDF0E398EF559C.avi,38,2421,1957,464,23.709759836484416,morphological_dilation,3,2
0X43DDF0E398EF559C.avi,57,1994,1554,440,28.314028314028317,morphological_dilation,3,2
0X43DE853BD6E0C849.avi,50,1818,1414,404,28.57142857142857,morphological_dilation,3,2
0X43DE853BD6E0C849.avi,97,1591,1070,521,48.69158878504673,morphological_dilation,3,2
0X43E03104CE2A7E6C.avi,42,1795,1371,424,30.926331145149526,morphological_dilation,3,2
0X43E03104CE2A7E6C.avi,61,1063,743,320,43.06864064602961,morphological_dilation,3,2
0X43E1086D4D329A14.avi,126,1642,1275,367,28.784313725490197,morphological_dilation,3,2
0X43E1086D4D329A14.avi,142,1031,731,300,41.03967168262654,morphological_dilation,3,2
0X43E21822FFC80CAC.avi,121,3018,2514,504,20.047732696897373,morphological_dilation,3,2
0X43E21822FFC80CAC.avi,143,2345,1881,464,24.667729930887823,morphological_dilation,3,2
0X43EA065ECBFA9AD7.avi,95,1972,1572,400,25.44529262086514,morphological_dilation,3,2
0X43EA065ECBFA9AD7.avi,112,1197,865,332,38.38150289017341,morphological_dilation,3,2
0X43EB4B6F88339ECE.avi,158,1236,920,316,34.34782608695652,morphological_dilation,3,2
0X43EB4B6F88339ECE.avi,173,799,521,278,53.35892514395394,morphological_dilation,3,2
0X43F19DCFF6CA5A09.avi,0,1871,1491,380,25.486250838363517,morphological_dilation,3,2
0X43F19DCFF6CA5A09.avi,17,1433,1089,344,31.588613406795226,morphological_dilation,3,2
0X43F30BAC89739F29.avi,1,1913,1537,376,24.46324007807417,morphological_dilation,3,2
0X43F30BAC89739F29.avi,23,1166,858,308,35.8974358974359,morphological_dilation,3,2
0X43F4E26080A78B79.avi,116,2284,1852,432,23.326133909287257,morphological_dilation,3,2
0X43F4E26080A78B79.avi,129,1284,940,344,36.59574468085106,morphological_dilation,3,2
0X43F7687722616CE9.avi,72,1417,1050,367,34.95238095238095,morphological_dilation,3,2
0X43F7687722616CE9.avi,97,909,605,304,50.247933884297524,morphological_dilation,3,2
0X440008B474A3319D.avi,39,950,666,284,42.64264264264264,morphological_dilation,3,2
0X440008B474A3319D.avi,53,590,358,232,64.80446927374301,morphological_dilation,3,2
0X44015C0D217CCC6.avi,45,2222,1786,436,24.412094064949606,morphological_dilation,3,2
0X44015C0D217CCC6.avi,62,1450,1078,372,34.50834879406308,morphological_dilation,3,2
0X4402D6BAEB80060A.avi,105,1912,1475,437,29.627118644067796,morphological_dilation,3,2
0X4402D6BAEB80060A.avi,118,1134,767,367,47.84876140808344,morphological_dilation,3,2
0X44031EA0A99B3D73.avi,43,1325,995,330,33.165829145728644,morphological_dilation,3,2
0X44031EA0A99B3D73.avi,51,892,588,304,51.70068027210885,morphological_dilation,3,2
0X440900BA9598705F.avi,114,2778,2322,456,19.638242894056848,morphological_dilation,3,2
0X440900BA9598705F.avi,130,2558,2122,436,20.54665409990575,morphological_dilation,3,2
0X441412385377D690.avi,109,1490,1138,352,30.931458699472756,morphological_dilation,3,2
0X441412385377D690.avi,124,976,656,320,48.78048780487805,morphological_dilation,3,2
0X44150A0B561EEE19.avi,151,1454,1126,328,29.129662522202487,morphological_dilation,3,2
0X44150A0B561EEE19.avi,169,986,706,280,39.6600566572238,morphological_dilation,3,2
0X4415AD160E79F9B8.avi,99,2300,1884,416,22.080679405520172,morphological_dilation,3,2
0X4415AD160E79F9B8.avi,133,1497,1149,348,30.287206266318538,morphological_dilation,3,2
0X4419F57C64568EB3.avi,50,2446,1962,484,24.668705402650357,morphological_dilation,3,2
0X4419F57C64568EB3.avi,68,1423,1043,380,36.4333652924257,morphological_dilation,3,2
0X441A8CB3361C5CDB.avi,72,1334,986,348,35.294117647058826,morphological_dilation,3,2
0X441A8CB3361C5CDB.avi,82,1075,759,316,41.63372859025033,morphological_dilation,3,2
0X441E7CCDB720CE61.avi,49,2412,1960,452,23.06122448979592,morphological_dilation,3,2
0X441E7CCDB720CE61.avi,61,1497,1113,384,34.50134770889488,morphological_dilation,3,2
0X441F60FC358D26EF.avi,58,2913,2441,472,19.33633756657108,morphological_dilation,3,2
0X441F60FC358D26EF.avi,76,2192,1774,418,23.562570462232244,morphological_dilation,3,2
0X4428361A82F59F0D.avi,1,1658,1270,388,30.551181102362207,morphological_dilation,3,2
0X4428361A82F59F0D.avi,22,927,639,288,45.07042253521127,morphological_dilation,3,2
0X442C9DCF330755E.avi,55,1987,1575,412,26.158730158730158,morphological_dilation,3,2
0X442C9DCF330755E.avi,74,1363,1011,352,34.817012858555884,morphological_dilation,3,2
0X44323BC92DF07925.avi,116,2535,2083,452,21.69947191550648,morphological_dilation,3,2
0X44323BC92DF07925.avi,136,1729,1353,376,27.79009608277901,morphological_dilation,3,2
0X443438E2F2550D6A.avi,122,2049,1637,412,25.167990226023214,morphological_dilation,3,2
0X443438E2F2550D6A.avi,142,1382,1040,342,32.88461538461539,morphological_dilation,3,2
0X4435084D81702978.avi,89,2771,2268,503,22.178130511463845,morphological_dilation,3,2
0X4435084D81702978.avi,105,1787,1308,479,36.620795107033636,morphological_dilation,3,2
0X443E4C7ECF7C9423.avi,61,2031,1611,420,26.0707635009311,morphological_dilation,3,2
0X443E4C7ECF7C9423.avi,76,1314,946,368,38.90063424947146,morphological_dilation,3,2
0X443FEC9AB1D22316.avi,34,1634,1258,376,29.88871224165342,morphological_dilation,3,2
0X443FEC9AB1D22316.avi,46,1406,1058,348,32.89224952741021,morphological_dilation,3,2
0X444315D43840AAE1.avi,94,1615,1259,356,28.276409849086576,morphological_dilation,3,2
0X444315D43840AAE1.avi,109,888,620,268,43.225806451612904,morphological_dilation,3,2
0X4443C1C10CC3B13A.avi,97,1700,1340,360,26.865671641791046,morphological_dilation,3,2
0X4443C1C10CC3B13A.avi,107,1087,779,308,39.53786906290115,morphological_dilation,3,2
0X4448BE2B5EE675E.avi,55,1385,1029,356,34.59669582118562,morphological_dilation,3,2
0X4448BE2B5EE675E.avi,72,821,553,268,48.4629294755877,morphological_dilation,3,2
0X444AA630FB840A63.avi,80,2472,2016,456,22.61904761904762,morphological_dilation,3,2
0X444AA630FB840A63.avi,102,1609,1241,368,29.653505237711524,morphological_dilation,3,2
0X444C866E5B4D119A.avi,118,1527,1195,332,27.78242677824268,morphological_dilation,3,2
0X444C866E5B4D119A.avi,130,1072,776,296,38.144329896907216,morphological_dilation,3,2
0X444CC9F0CE8B22E5.avi,57,1822,1426,396,27.769985974754558,morphological_dilation,3,2
0X444CC9F0CE8B22E5.avi,76,1046,758,288,37.994722955145114,morphological_dilation,3,2
0X444E4604BB173900.avi,45,2535,2051,484,23.598244758654317,morphological_dilation,3,2
0X444E4604BB173900.avi,62,1450,1051,399,37.96384395813511,morphological_dilation,3,2
0X4450ACAA532729CC.avi,86,1674,1299,375,28.868360277136258,morphological_dilation,3,2
0X4450ACAA532729CC.avi,103,1001,709,292,41.18476727785614,morphological_dilation,3,2
0X44519EA71861508A.avi,73,2425,1985,440,22.16624685138539,morphological_dilation,3,2
0X44519EA71861508A.avi,86,1550,1194,356,29.81574539363484,morphological_dilation,3,2
0X4454A9B655CE4748.avi,52,2137,1705,432,25.33724340175953,morphological_dilation,3,2
0X4454A9B655CE4748.avi,71,1327,975,352,36.1025641025641,morphological_dilation,3,2
0X445575CFEECB0986.avi,103,1602,1225,377,30.775510204081634,morphological_dilation,3,2
0X445575CFEECB0986.avi,118,1040,724,316,43.646408839779006,morphological_dilation,3,2
0X4457399F82B0DB8B.avi,42,947,630,317,50.317460317460316,morphological_dilation,3,2
0X4457399F82B0DB8B.avi,54,615,347,268,77.23342939481267,morphological_dilation,3,2
0X4457792327507BF.avi,53,2468,1984,484,24.39516129032258,morphological_dilation,3,2
0X4457792327507BF.avi,74,1549,1153,396,34.34518647007806,morphological_dilation,3,2
0X44663DBC0CF673F5.avi,0,3094,2598,496,19.091608929946112,morphological_dilation,3,2
0X44663DBC0CF673F5.avi,21,1947,1511,436,28.85506287227002,morphological_dilation,3,2
0X44665B39EAC0DDA9.avi,88,1669,1305,364,27.892720306513407,morphological_dilation,3,2
0X44665B39EAC0DDA9.avi,103,1067,763,304,39.84272608125819,morphological_dilation,3,2
0X44687A734737EBA4.avi,97,1591,1219,372,30.516817063166528,morphological_dilation,3,2
0X44687A734737EBA4.avi,115,936,652,284,43.558282208588956,morphological_dilation,3,2
0X446B63558C3D8706.avi,54,1629,1249,380,30.424339471577262,morphological_dilation,3,2
0X446B63558C3D8706.avi,67,1039,714,325,45.51820728291317,morphological_dilation,3,2
0X446DAA2329C90ED6.avi,139,1701,1325,376,28.37735849056604,morphological_dilation,3,2
0X446DAA2329C90ED6.avi,166,1145,837,308,36.79808841099164,morphological_dilation,3,2
0X446DD98991C15E41.avi,55,1549,1197,352,29.406850459482037,morphological_dilation,3,2
0X446DD98991C15E41.avi,77,1112,812,300,36.94581280788177,morphological_dilation,3,2
0X446E8D1FC944760C.avi,46,2079,1659,420,25.31645569620253,morphological_dilation,3,2
0X446E8D1FC944760C.avi,58,1290,934,356,38.11563169164882,morphological_dilation,3,2
0X4471745EFED4FB8A.avi,0,2459,2011,448,22.27747389358528,morphological_dilation,3,2
0X4471745EFED4FB8A.avi,15,1465,1121,344,30.686886708296164,morphological_dilation,3,2
0X44720ED76ECBB413.avi,3,2035,1631,404,24.770079705702024,morphological_dilation,3,2
0X44720ED76ECBB413.avi,20,1295,963,332,34.47559709241953,morphological_dilation,3,2
0X447284A7BA9F97EE.avi,70,1757,1373,384,27.967953386744355,morphological_dilation,3,2
0X447284A7BA9F97EE.avi,83,1121,805,316,39.254658385093165,morphological_dilation,3,2
0X4477077E68BF47B2.avi,1,1576,1132,444,39.2226148409894,morphological_dilation,3,2
0X4477077E68BF47B2.avi,4,1558,1190,368,30.92436974789916,morphological_dilation,3,2
0X44791B99E952C4B6.avi,39,2397,1941,456,23.493044822256568,morphological_dilation,3,2
0X44791B99E952C4B6.avi,60,1495,1092,403,36.904761904761905,morphological_dilation,3,2
0X447A2F85FA084EC3.avi,63,1736,1368,368,26.900584795321635,morphological_dilation,3,2
0X447A2F85FA084EC3.avi,78,1136,828,308,37.19806763285024,morphological_dilation,3,2
0X447A53FC10CB6952.avi,35,1538,1142,396,34.676007005253936,morphological_dilation,3,2
0X447A53FC10CB6952.avi,49,1071,727,344,47.31774415405777,morphological_dilation,3,2
0X447E46029B268525.avi,60,1543,1175,368,31.319148936170212,morphological_dilation,3,2
0X447E46029B268525.avi,75,1051,739,312,42.2192151556157,morphological_dilation,3,2
0X447E50EF7BF3F9AA.avi,41,1906,1526,380,24.901703800786372,morphological_dilation,3,2
0X447E50EF7BF3F9AA.avi,59,1680,1320,360,27.27272727272727,morphological_dilation,3,2
0X448007F0DCEDA6EA.avi,39,1635,1205,430,35.684647302904565,morphological_dilation,3,2
0X448007F0DCEDA6EA.avi,53,1170,770,400,51.94805194805194,morphological_dilation,3,2
0X44805AD09697CF0E.avi,83,2322,1886,436,23.117709437963946,morphological_dilation,3,2
0X44805AD09697CF0E.avi,107,1583,1219,364,29.860541427399507,morphological_dilation,3,2
0X448282F7DD71CDEE.avi,96,2123,1715,408,23.79008746355685,morphological_dilation,3,2
0X448282F7DD71CDEE.avi,115,1365,1025,340,33.170731707317074,morphological_dilation,3,2
0X4484CF47B67B79.avi,45,1001,701,300,42.796005706134096,morphological_dilation,3,2
0X4484CF47B67B79.avi,55,626,386,240,62.17616580310881,morphological_dilation,3,2
0X448FCAC1F300393C.avi,111,2830,2326,504,21.668099742046433,morphological_dilation,3,2
0X448FCAC1F300393C.avi,128,1851,1423,428,30.077301475755448,morphological_dilation,3,2
0X4492BEA1A146BCEF.avi,51,1423,1067,356,33.364573570759134,morphological_dilation,3,2
0X4492BEA1A146BCEF.avi,69,890,610,280,45.90163934426229,morphological_dilation,3,2
0X44945BF0F44F4ED6.avi,160,1792,1412,380,26.912181303116146,morphological_dilation,3,2
0X44945BF0F44F4ED6.avi,177,1082,762,320,41.99475065616798,morphological_dilation,3,2
0X4494601784C9C2B5.avi,44,2243,1831,412,22.501365374112506,morphological_dilation,3,2
0X4494601784C9C2B5.avi,59,1406,1058,348,32.89224952741021,morphological_dilation,3,2
0X449BDE33FCD6216B.avi,69,1169,832,337,40.50480769230769,morphological_dilation,3,2
0X449BDE33FCD6216B.avi,87,736,476,260,54.621848739495796,morphological_dilation,3,2
0X449F4DBE528DB8E4.avi,36,1105,805,300,37.267080745341616,morphological_dilation,3,2
0X449F4DBE528DB8E4.avi,45,662,410,252,61.46341463414634,morphological_dilation,3,2
0X44A12BED8BD703D5.avi,102,2302,1870,432,23.101604278074866,morphological_dilation,3,2
0X44A12BED8BD703D5.avi,118,1362,1014,348,34.319526627218934,morphological_dilation,3,2
0X44A1DA7C5681687D.avi,102,3348,2808,540,19.230769230769234,morphological_dilation,3,2
0X44A1DA7C5681687D.avi,118,2055,1627,428,26.306084818684695,morphological_dilation,3,2
0X44A229D25A6D90F6.avi,87,1501,1129,372,32.94951284322409,morphological_dilation,3,2
0X44A229D25A6D90F6.avi,99,840,560,280,50.0,morphological_dilation,3,2
0X44A22A6AC83EAAE3.avi,0,2077,1646,431,26.18469015795869,morphological_dilation,3,2
0X44A22A6AC83EAAE3.avi,21,1342,984,358,36.38211382113821,morphological_dilation,3,2
0X44A388BE279381C5.avi,96,1205,901,304,33.74028856825749,morphological_dilation,3,2
0X44A388BE279381C5.avi,121,772,515,257,49.90291262135923,morphological_dilation,3,2
0X44A3EA77AFCBC602.avi,68,1230,887,343,38.66967305524239,morphological_dilation,3,2
0X44A3EA77AFCBC602.avi,79,773,497,276,55.53319919517102,morphological_dilation,3,2
0X44A4EFFB743B7EBA.avi,0,1462,1110,352,31.71171171171171,morphological_dilation,3,2
0X44A4EFFB743B7EBA.avi,22,912,628,284,45.22292993630573,morphological_dilation,3,2
0X44AAEEDEB27D7CD8.avi,60,1750,1362,388,28.487518355359764,morphological_dilation,3,2
0X44AAEEDEB27D7CD8.avi,77,1073,757,316,41.743725231175695,morphological_dilation,3,2
0X44ADA67E755F8482.avi,83,2539,2103,436,20.732287208749405,morphological_dilation,3,2
0X44ADA67E755F8482.avi,98,2289,1877,412,21.949920085242407,morphological_dilation,3,2
0X44AF62DCB1DC4329.avi,88,1963,1567,396,25.271218889597957,morphological_dilation,3,2
0X44AF62DCB1DC4329.avi,105,1646,1282,364,28.39313572542902,morphological_dilation,3,2
0X44B04DF0162F5E97.avi,42,1238,910,328,36.043956043956044,morphological_dilation,3,2
0X44B04DF0162F5E97.avi,60,825,533,292,54.78424015009381,morphological_dilation,3,2
0X44B6C59A842F6A21.avi,128,2862,2366,496,20.9636517328825,morphological_dilation,3,2
0X44B6C59A842F6A21.avi,149,1872,1452,420,28.92561983471074,morphological_dilation,3,2
0X44B83C6255383CDB.avi,97,1887,1491,396,26.559356136820927,morphological_dilation,3,2
0X44B83C6255383CDB.avi,107,1187,855,332,38.83040935672515,morphological_dilation,3,2
0X44BE0AE1373FE644.avi,32,1218,894,324,36.241610738255034,morphological_dilation,3,2
0X44BE0AE1373FE644.avi,42,771,499,272,54.50901803607214,morphological_dilation,3,2
0X44BF53A7F48527B1.avi,95,2314,1878,436,23.21618743343983,morphological_dilation,3,2
0X44BF53A7F48527B1.avi,115,1361,997,364,36.50952858575727,morphological_dilation,3,2
0X44BFFB354D8E21C9.avi,105,1262,938,324,34.54157782515991,morphological_dilation,3,2
0X44BFFB354D8E21C9.avi,115,914,638,276,43.260188087774296,morphological_dilation,3,2
0X44C16995297F2548.avi,145,2775,2264,511,22.570671378091873,morphological_dilation,3,2
0X44C16995297F2548.avi,162,1809,1381,428,30.99203475742216,morphological_dilation,3,2
0X44C18287CA978438.avi,51,3546,2536,1010,39.82649842271294,morphological_dilation,3,2
0X44C18287CA978438.avi,63,3293,2435,858,35.23613963039015,morphological_dilation,3,2
0X44C1C7FC939E2A3.avi,97,1799,1399,400,28.591851322373124,morphological_dilation,3,2
0X44C1C7FC939E2A3.avi,115,1139,807,332,41.14002478314746,morphological_dilation,3,2
0X44C2F41C10A2E2FE.avi,110,2171,1759,412,23.42239909039227,morphological_dilation,3,2
0X44C2F41C10A2E2FE.avi,127,1359,1019,340,33.36604514229637,morphological_dilation,3,2
0X44C35F9C8D4F230B.avi,112,2522,2074,448,21.600771456123432,morphological_dilation,3,2
0X44C35F9C8D4F230B.avi,131,1490,1146,344,30.017452006980804,morphological_dilation,3,2
0X44CB24B21421CE66.avi,50,1671,1295,376,29.034749034749037,morphological_dilation,3,2
0X44CB24B21421CE66.avi,65,878,586,292,49.829351535836174,morphological_dilation,3,2
0X44CB4ECD6A40E9C9.avi,127,1856,1485,371,24.983164983164983,morphological_dilation,3,2
0X44CB4ECD6A40E9C9.avi,143,1390,1062,328,30.88512241054614,morphological_dilation,3,2
0X44CBEE8CA4DECC80.avi,100,2450,2022,428,21.16716122650841,morphological_dilation,3,2
0X44CBEE8CA4DECC80.avi,117,2146,1738,408,23.475258918296895,morphological_dilation,3,2
0X44CC955D681B4488.avi,93,1683,1291,392,30.364058869093725,morphological_dilation,3,2
0X44CC955D681B4488.avi,111,1195,855,340,39.76608187134503,morphological_dilation,3,2
0X44D1529F884ADC65.avi,68,2577,2093,484,23.12470138557095,morphological_dilation,3,2
0X44D1529F884ADC65.avi,85,1995,1567,428,27.313337587747288,morphological_dilation,3,2
0X44D460005C844C04.avi,64,2116,1694,422,24.911452184179456,morphological_dilation,3,2
0X44D460005C844C04.avi,80,1695,1300,395,30.384615384615383,morphological_dilation,3,2
0X44D47829F06BD67F.avi,40,2464,1984,480,24.193548387096776,morphological_dilation,3,2
0X44D47829F06BD67F.avi,54,1832,1417,415,29.28722653493296,morphological_dilation,3,2
0X44D508496C453D89.avi,54,1776,1412,364,25.77903682719547,morphological_dilation,3,2
0X44D508496C453D89.avi,66,1634,1286,348,27.060653188180407,morphological_dilation,3,2
0X44DA3D8853AE917C.avi,48,2415,1979,436,22.03132895401718,morphological_dilation,3,2
0X44DA3D8853AE917C.avi,66,1589,1203,386,32.08645054031587,morphological_dilation,3,2
0X44DCF479544BA8C6.avi,56,1995,1587,408,25.708884688090738,morphological_dilation,3,2
0X44DCF479544BA8C6.avi,75,1227,903,324,35.880398671096344,morphological_dilation,3,2
0X44E27BC8B24601D5.avi,47,1951,1551,400,25.78981302385558,morphological_dilation,3,2
0X44E27BC8B24601D5.avi,62,1268,944,324,34.32203389830508,morphological_dilation,3,2
0X44EAC282A8452B0B.avi,133,2046,1642,404,24.604141291108405,morphological_dilation,3,2
0X44EAC282A8452B0B.avi,152,1282,950,332,34.94736842105263,morphological_dilation,3,2
0X44F675DB0863E29.avi,31,1941,1565,376,24.02555910543131,morphological_dilation,3,2
0X44F675DB0863E29.avi,44,1283,975,308,31.58974358974359,morphological_dilation,3,2
0X44F783F5B514A943.avi,29,1925,1533,392,25.570776255707763,morphological_dilation,3,2
0X44F783F5B514A943.avi,42,1422,1070,352,32.89719626168225,morphological_dilation,3,2
0X44F9A80B05DFC224.avi,74,2976,2485,491,19.758551307847082,morphological_dilation,3,2
0X44F9A80B05DFC224.avi,86,2240,1804,436,24.168514412416854,morphological_dilation,3,2
0X44FA43FAC7FE022.avi,103,1091,775,316,40.774193548387096,morphological_dilation,3,2
0X44FA43FAC7FE022.avi,118,716,453,263,58.05739514348785,morphological_dilation,3,2
0X44FDE6498A51E3BC.avi,66,1541,1153,388,33.651344319167386,morphological_dilation,3,2
0X44FDE6498A51E3BC.avi,85,985,661,324,49.016641452344935,morphological_dilation,3,2
0X4502CEC81747E7BD.avi,2,1871,1483,388,26.163182737693862,morphological_dilation,3,2
0X4502CEC81747E7BD.avi,16,1723,1347,376,27.91388270230141,morphological_dilation,3,2
0X45047F0D2B3DA0CC.avi,43,1007,731,276,37.75649794801642,morphological_dilation,3,2
0X45047F0D2B3DA0CC.avi,60,665,423,242,57.21040189125296,morphological_dilation,3,2
0X4506870DFECB082E.avi,106,1368,1016,352,34.645669291338585,morphological_dilation,3,2
0X4506870DFECB082E.avi,124,1061,749,312,41.655540720961284,morphological_dilation,3,2
0X4506A36DB51B7766.avi,87,2058,1638,420,25.64102564102564,morphological_dilation,3,2
0X4506A36DB51B7766.avi,103,1402,1050,352,33.523809523809526,morphological_dilation,3,2
0X450790A4885E9762.avi,116,1730,1334,396,29.685157421289354,morphological_dilation,3,2
0X450790A4885E9762.avi,132,978,662,316,47.73413897280967,morphological_dilation,3,2
0X4509E093754F0304.avi,48,1900,1484,416,28.03234501347709,morphological_dilation,3,2
0X4509E093754F0304.avi,66,1394,989,405,40.950455005055616,morphological_dilation,3,2
0X450BE2C78EC9B5EF.avi,58,1523,1179,344,29.17726887192536,morphological_dilation,3,2
0X450BE2C78EC9B5EF.avi,76,1120,808,312,38.613861386138616,morphological_dilation,3,2
0X4512900B884F5CB.avi,11,2390,1966,424,21.566632756866735,morphological_dilation,3,2
0X4512900B884F5CB.avi,21,2138,1734,404,23.298731257208765,morphological_dilation,3,2
0X4512AB205DE541B2.avi,126,1870,1466,404,27.55798090040928,morphological_dilation,3,2
0X4512AB205DE541B2.avi,143,1154,838,316,37.70883054892602,morphological_dilation,3,2
0X45169B4E6FA0A0A0.avi,3,1963,1555,408,26.237942122186496,morphological_dilation,3,2
0X45169B4E6FA0A0A0.avi,16,1170,854,316,37.00234192037471,morphological_dilation,3,2
0X451AAC4A666A91BF.avi,54,2114,1706,408,23.91559202813599,morphological_dilation,3,2
0X451AAC4A666A91BF.avi,66,1862,1478,384,25.98105548037889,morphological_dilation,3,2
0X451AEA20249EFD25.avi,48,1707,1335,372,27.86516853932584,morphological_dilation,3,2
0X451AEA20249EFD25.avi,67,1159,843,316,37.48517200474496,morphological_dilation,3,2
0X4521C31BFB79E41F.avi,53,1934,1542,392,25.421530479896237,morphological_dilation,3,2
0X4521C31BFB79E41F.avi,73,1420,1080,340,31.48148148148148,morphological_dilation,3,2
0X45239B4E5153E962.avi,34,1555,1176,379,32.22789115646258,morphological_dilation,3,2
0X45239B4E5153E962.avi,47,962,659,303,45.97875569044006,morphological_dilation,3,2
0X4523F8C611A32164.avi,115,1912,1524,388,25.45931758530184,morphological_dilation,3,2
0X4523F8C611A32164.avi,130,1142,838,304,36.27684964200477,morphological_dilation,3,2
0X4527BA99A25B80AA.avi,89,2500,2044,456,22.309197651663403,morphological_dilation,3,2
0X4527BA99A25B80AA.avi,117,1422,1057,365,34.53169347209082,morphological_dilation,3,2
0X45286C289D7A233D.avi,59,3580,3056,524,17.146596858638745,morphological_dilation,3,2
0X45286C289D7A233D.avi,77,2094,1682,412,24.494649227110582,morphological_dilation,3,2
0X45288341238CE3FD.avi,46,1610,1230,380,30.89430894308943,morphological_dilation,3,2
0X45288341238CE3FD.avi,58,983,659,324,49.165402124430955,morphological_dilation,3,2
0X452A08132F153B56.avi,54,2293,1834,459,25.027262813522356,morphological_dilation,3,2
0X452A08132F153B56.avi,68,1286,866,420,48.49884526558891,morphological_dilation,3,2
0X452FB515DC2DE477.avi,99,1759,1391,368,26.455787203450754,morphological_dilation,3,2
0X452FB515DC2DE477.avi,117,1007,727,280,38.514442916093536,morphological_dilation,3,2
0X45300281828E615A.avi,83,1542,1198,344,28.71452420701169,morphological_dilation,3,2
0X45300281828E615A.avi,102,981,693,288,41.55844155844156,morphological_dilation,3,2
0X4530203B198A87C6.avi,62,4914,4274,640,14.974262985493683,morphological_dilation,3,2
0X4530203B198A87C6.avi,77,2945,2409,536,22.249896222498965,morphological_dilation,3,2
0X45357AC4B9F02268.avi,71,1873,1465,408,27.84982935153584,morphological_dilation,3,2
0X45357AC4B9F02268.avi,87,1302,974,328,33.67556468172484,morphological_dilation,3,2
0X4536DCD1EF2AF7FF.avi,103,1777,1397,380,27.20114531138153,morphological_dilation,3,2
0X4536DCD1EF2AF7FF.avi,122,1055,767,288,37.54889178617992,morphological_dilation,3,2
0X453EC33BC6E96460.avi,67,1187,891,296,33.221099887766556,morphological_dilation,3,2
0X453EC33BC6E96460.avi,76,818,546,272,49.81684981684982,morphological_dilation,3,2
0X453F41898001E174.avi,95,2025,1629,396,24.30939226519337,morphological_dilation,3,2
0X453F41898001E174.avi,109,1237,905,332,36.68508287292818,morphological_dilation,3,2
0X45418C574D97027A.avi,1,1442,1086,356,32.78084714548803,morphological_dilation,3,2
0X45418C574D97027A.avi,16,965,661,304,45.99092284417549,morphological_dilation,3,2
0X4548ECB3A01FC674.avi,59,2340,1889,451,23.875066172578084,morphological_dilation,3,2
0X4548ECB3A01FC674.avi,76,1539,1159,380,32.78688524590164,morphological_dilation,3,2
0X4549C792D8239391.avi,42,2321,1885,436,23.129973474801062,morphological_dilation,3,2
0X4549C792D8239391.avi,59,1673,1302,371,28.49462365591398,morphological_dilation,3,2
0X454C1F4146B14E0E.avi,55,1403,1075,328,30.511627906976745,morphological_dilation,3,2
0X454C1F4146B14E0E.avi,56,1816,1313,503,38.309215536938304,morphological_dilation,3,2
0X4550086B27E8492F.avi,52,1711,1327,384,28.937452901281084,morphological_dilation,3,2
0X4550086B27E8492F.avi,66,989,701,288,41.08416547788873,morphological_dilation,3,2
0X4556F926DF2708B6.avi,98,2278,1846,432,23.401950162513543,morphological_dilation,3,2
0X4556F926DF2708B6.avi,114,1676,1284,392,30.529595015576323,morphological_dilation,3,2
0X455C2277C037ADFF.avi,47,2015,1583,432,27.28995578016424,morphological_dilation,3,2
0X455C2277C037ADFF.avi,60,1226,870,356,40.91954022988506,morphological_dilation,3,2
0X455EF2F2E407CBA9.avi,37,1795,1396,399,28.581661891117477,morphological_dilation,3,2
0X455EF2F2E407CBA9.avi,55,1091,775,316,40.774193548387096,morphological_dilation,3,2
0X45606D3650036C6B.avi,100,2043,1631,412,25.260576333537703,morphological_dilation,3,2
0X45606D3650036C6B.avi,115,1255,899,356,39.59955506117909,morphological_dilation,3,2
0X45632A2A3B1D4EC2.avi,78,2299,1835,464,25.286103542234333,morphological_dilation,3,2
0X45632A2A3B1D4EC2.avi,96,1451,1045,406,38.85167464114833,morphological_dilation,3,2
0X4563D5F18EF850.avi,50,3206,2670,536,20.074906367041198,morphological_dilation,3,2
0X4563D5F18EF850.avi,64,1969,1561,408,26.137091607943624,morphological_dilation,3,2
0X4569782F9EE65B79.avi,42,2740,2277,463,20.333772507685552,morphological_dilation,3,2
0X4569782F9EE65B79.avi,60,2374,1938,436,22.497420020639836,morphological_dilation,3,2
0X456A974FA4772464.avi,88,1514,1158,356,30.7426597582038,morphological_dilation,3,2
0X456A974FA4772464.avi,104,1048,744,304,40.86021505376344,morphological_dilation,3,2
0X456AF7E56AC662AA.avi,121,1681,1289,392,30.411171450737008,morphological_dilation,3,2
0X456AF7E56AC662AA.avi,133,938,623,315,50.56179775280899,morphological_dilation,3,2
0X456C5475063164C4.avi,79,2040,1632,408,25.0,morphological_dilation,3,2
0X456C5475063164C4.avi,94,1862,1474,388,26.322930800542743,morphological_dilation,3,2
0X456CF175454A3E15.avi,42,1669,1297,372,28.681572860447186,morphological_dilation,3,2
0X456CF175454A3E15.avi,61,986,690,296,42.89855072463768,morphological_dilation,3,2
0X4574E7735C7EC705.avi,62,3203,2687,516,19.203572757722366,morphological_dilation,3,2
0X4574E7735C7EC705.avi,80,1828,1420,408,28.732394366197184,morphological_dilation,3,2
0X4578EAE5AD6B92D6.avi,75,1902,1483,419,28.253540121375593,morphological_dilation,3,2
0X4578EAE5AD6B92D6.avi,89,1205,873,332,38.02978235967927,morphological_dilation,3,2
0X45797518BBA63676.avi,57,1656,1292,364,28.173374613003094,morphological_dilation,3,2
0X45797518BBA63676.avi,71,1106,782,324,41.432225063938624,morphological_dilation,3,2
0X457979CC6D12EBB8.avi,67,2209,1789,420,23.476802683063163,morphological_dilation,3,2
0X457979CC6D12EBB8.avi,90,1424,1084,340,31.365313653136536,morphological_dilation,3,2
0X457C7DD05898EC66.avi,137,1913,1489,424,28.475486903962388,morphological_dilation,3,2
0X457C7DD05898EC66.avi,150,1187,839,348,41.477949940405246,morphological_dilation,3,2
0X457D30606BC14265.avi,49,1633,1269,364,28.684003152088263,morphological_dilation,3,2
0X457D30606BC14265.avi,63,1100,784,316,40.30612244897959,morphological_dilation,3,2
0X457DAB4FF89AC668.avi,90,2051,1596,455,28.50877192982456,morphological_dilation,3,2
0X457DAB4FF89AC668.avi,111,1458,1066,392,36.772983114446525,morphological_dilation,3,2
0X457FA6E8CA802DC2.avi,104,1880,1496,384,25.668449197860966,morphological_dilation,3,2
0X457FA6E8CA802DC2.avi,121,1270,950,320,33.68421052631579,morphological_dilation,3,2
0X458076DDE5F2F78D.avi,145,1326,990,336,33.939393939393945,morphological_dilation,3,2
0X458076DDE5F2F78D.avi,163,714,438,276,63.013698630136986,morphological_dilation,3,2
0X4584371B4D8B2D39.avi,120,1459,1109,350,31.55996393146979,morphological_dilation,3,2
0X4584371B4D8B2D39.avi,134,909,611,298,48.772504091653026,morphological_dilation,3,2
0X458A3FC76A16F3CF.avi,67,3381,2869,512,17.845939351690486,morphological_dilation,3,2
0X458A3FC76A16F3CF.avi,83,2938,2458,480,19.528071602929213,morphological_dilation,3,2
0X458C107A05DAB733.avi,139,1943,1535,408,26.579804560260584,morphological_dilation,3,2
0X458C107A05DAB733.avi,152,1200,859,341,39.69732246798603,morphological_dilation,3,2
0X45980563E8E0859C.avi,78,1836,1448,388,26.795580110497237,morphological_dilation,3,2
0X45980563E8E0859C.avi,92,1098,778,320,41.131105398457585,morphological_dilation,3,2
0X459A709C0D875EEF.avi,128,1662,1291,371,28.737412858249417,morphological_dilation,3,2
0X459A709C0D875EEF.avi,144,1164,844,320,37.91469194312796,morphological_dilation,3,2
0X459F7C29B033C1D0.avi,85,1628,1259,369,29.30897537728356,morphological_dilation,3,2
0X459F7C29B033C1D0.avi,106,870,594,276,46.464646464646464,morphological_dilation,3,2
0X45A14722B0DFC1EA.avi,141,2082,1630,452,27.73006134969325,morphological_dilation,3,2
0X45A14722B0DFC1EA.avi,160,1250,882,368,41.723356009070294,morphological_dilation,3,2
0X45A28C1FB1A33FC5.avi,48,1707,1331,376,28.249436513899322,morphological_dilation,3,2
0X45A28C1FB1A33FC5.avi,64,1099,787,312,39.64421855146124,morphological_dilation,3,2
0X45A5D731A015ADBF.avi,119,2130,1675,455,27.164179104477608,morphological_dilation,3,2
0X45A5D731A015ADBF.avi,138,1672,1276,396,31.03448275862069,morphological_dilation,3,2
0X45A763EE890FBEA.avi,48,1413,1055,358,33.93364928909953,morphological_dilation,3,2
0X45A763EE890FBEA.avi,64,811,539,272,50.46382189239333,morphological_dilation,3,2
0X45A9015B761B40A9.avi,108,1706,1326,380,28.657616892911008,morphological_dilation,3,2
0X45A9015B761B40A9.avi,123,1244,912,332,36.40350877192983,morphological_dilation,3,2
0X45AD580B725C799E.avi,99,2289,1861,428,22.998387963460505,morphological_dilation,3,2
0X45AD580B725C799E.avi,121,1489,1137,352,30.958663148636763,morphological_dilation,3,2
0X45B2F88F92A460D5.avi,36,1614,1254,360,28.708133971291865,morphological_dilation,3,2
0X45B2F88F92A460D5.avi,50,976,680,296,43.529411764705884,morphological_dilation,3,2
0X45B5C4D9038D5F9E.avi,85,1626,1250,376,30.080000000000002,morphological_dilation,3,2
0X45B5C4D9038D5F9E.avi,98,1017,709,308,43.441466854724965,morphological_dilation,3,2
0X45BE0065FB0FEFD7.avi,56,1540,1188,352,29.629629629629626,morphological_dilation,3,2
0X45BE0065FB0FEFD7.avi,71,1046,737,309,41.926729986431475,morphological_dilation,3,2
0X45C0B5CB8EAC7CE3.avi,33,2384,1936,448,23.140495867768596,morphological_dilation,3,2
0X45C0B5CB8EAC7CE3.avi,45,1385,1021,364,35.6513222331048,morphological_dilation,3,2
0X45C3270D57E3DF4.avi,98,3510,2954,556,18.82193635748138,morphological_dilation,3,2
0X45C3270D57E3DF4.avi,119,2102,1631,471,28.877988963825874,morphological_dilation,3,2
0X45C47B88561016CD.avi,112,1930,1502,428,28.495339547270305,morphological_dilation,3,2
0X45C47B88561016CD.avi,133,1148,801,347,43.320848938826465,morphological_dilation,3,2
0X45CC26E182BB7C4.avi,74,2160,1728,432,25.0,morphological_dilation,3,2
0X45CC26E182BB7C4.avi,89,1395,1031,364,35.30552861299709,morphological_dilation,3,2
0X45CE057EC2EB577F.avi,110,2080,1668,412,24.700239808153476,morphological_dilation,3,2
0X45CE057EC2EB577F.avi,131,1663,1299,364,28.021555042340264,morphological_dilation,3,2
0X45CE6C8893A4E3A7.avi,35,1719,1343,376,27.997021593447506,morphological_dilation,3,2
0X45CE6C8893A4E3A7.avi,52,1085,785,300,38.21656050955414,morphological_dilation,3,2
0X45D646D50FEED577.avi,105,1993,1585,408,25.741324921135643,morphological_dilation,3,2
0X45D646D50FEED577.avi,116,1221,901,320,35.516093229744726,morphological_dilation,3,2
0X45D67C2F0E610EE.avi,11,715,463,252,54.42764578833693,morphological_dilation,3,2
0X45D67C2F0E610EE.avi,13,1006,660,346,52.42424242424243,morphological_dilation,3,2
0X45D733BB49E9C17D.avi,0,1644,1264,380,30.063291139240505,morphological_dilation,3,2
0X45D733BB49E9C17D.avi,14,948,640,308,48.125,morphological_dilation,3,2
0X45D79F6C97A51897.avi,149,1371,1035,336,32.463768115942024,morphological_dilation,3,2
0X45D79F6C97A51897.avi,165,902,618,284,45.9546925566343,morphological_dilation,3,2
0X45D7BE7523C46BB2.avi,113,1165,841,324,38.525564803805,morphological_dilation,3,2
0X45D7BE7523C46BB2.avi,129,786,514,272,52.918287937743195,morphological_dilation,3,2
0X45DF2459DF7D77B0.avi,44,1489,1129,360,31.886625332152345,morphological_dilation,3,2
0X45DF2459DF7D77B0.avi,56,917,627,290,46.25199362041467,morphological_dilation,3,2
0X45E20189E7AA1A4B.avi,106,895,619,276,44.58804523424879,morphological_dilation,3,2
0X45E20189E7AA1A4B.avi,113,571,339,232,68.43657817109144,morphological_dilation,3,2
0X45E3351DC2069AA3.avi,113,1742,1366,376,27.52562225475842,morphological_dilation,3,2
0X45E3351DC2069AA3.avi,127,1073,765,308,40.26143790849673,morphological_dilation,3,2
0X45E4438C079A69DF.avi,62,1632,1252,380,30.35143769968051,morphological_dilation,3,2
0X45E4438C079A69DF.avi,79,955,635,320,50.39370078740157,morphological_dilation,3,2
0X45E6F6924D4AA7C3.avi,39,1460,1128,332,29.432624113475175,morphological_dilation,3,2
0X45E6F6924D4AA7C3.avi,53,927,647,280,43.27666151468315,morphological_dilation,3,2
0X45E83530C042A5F4.avi,35,2555,2075,480,23.132530120481928,morphological_dilation,3,2
0X45E83530C042A5F4.avi,47,1472,1096,376,34.306569343065696,morphological_dilation,3,2
0X45E8B3791798B0BE.avi,35,1808,1440,368,25.555555555555554,morphological_dilation,3,2
0X45E8B3791798B0BE.avi,51,1477,1133,344,30.36187113857017,morphological_dilation,3,2
0X45EC30D3FE91D38D.avi,40,1963,1567,396,25.271218889597957,morphological_dilation,3,2
0X45EC30D3FE91D38D.avi,57,1185,863,322,37.3117033603708,morphological_dilation,3,2
0X45ED432FAE218EFD.avi,58,1766,1398,368,26.32331902718169,morphological_dilation,3,2
0X45ED432FAE218EFD.avi,81,1262,950,312,32.8421052631579,morphological_dilation,3,2
0X45ED7398E9C3AAEA.avi,203,1219,895,324,36.201117318435756,morphological_dilation,3,2
0X45ED7398E9C3AAEA.avi,220,855,573,282,49.21465968586388,morphological_dilation,3,2
0X45EEBFE43C183552.avi,107,2057,1653,404,24.440411373260737,morphological_dilation,3,2
0X45EEBFE43C183552.avi,123,1298,966,332,34.368530020703936,morphological_dilation,3,2
0X45EFEE60B0C9E31A.avi,87,1862,1482,380,25.64102564102564,morphological_dilation,3,2
0X45EFEE60B0C9E31A.avi,101,1202,890,312,35.056179775280896,morphological_dilation,3,2
0X45F32591DF9DFC34.avi,86,1747,1391,356,25.593098490294754,morphological_dilation,3,2
0X45F32591DF9DFC34.avi,101,1346,1022,324,31.702544031311152,morphological_dilation,3,2
0X45F39E3406B7CAA5.avi,38,1407,1050,357,34.0,morphological_dilation,3,2
0X45F39E3406B7CAA5.avi,51,829,553,276,49.90958408679928,morphological_dilation,3,2
0X45F50AF374B2D1E6.avi,130,1252,912,340,37.280701754385966,morphological_dilation,3,2
0X45F50AF374B2D1E6.avi,148,882,586,296,50.51194539249146,morphological_dilation,3,2
0X45F6B2D62CFBDD5A.avi,59,3400,2852,548,19.214586255259466,morphological_dilation,3,2
0X45F6B2D62CFBDD5A.avi,76,2180,1723,457,26.523505513639,morphological_dilation,3,2
0X46024CC33D00D4C6.avi,33,3639,2711,928,34.23091110291405,morphological_dilation,3,2
0X46024CC33D00D4C6.avi,48,3324,2447,877,35.839803841438496,morphological_dilation,3,2
0X4602E7CB509084C4.avi,86,2601,2125,476,22.400000000000002,morphological_dilation,3,2
0X4602E7CB509084C4.avi,98,1789,1389,400,28.797696184305256,morphological_dilation,3,2
0X460698918BEA659B.avi,62,1510,1146,364,31.762652705061083,morphological_dilation,3,2
0X460698918BEA659B.avi,84,934,650,284,43.69230769230769,morphological_dilation,3,2
0X460B910F3236924B.avi,39,1784,1409,375,26.614620298083747,morphological_dilation,3,2
0X460B910F3236924B.avi,55,1382,1042,340,32.629558541266796,morphological_dilation,3,2
0X46112A0A6AAA4A03.avi,124,1806,1422,384,27.004219409282697,morphological_dilation,3,2
0X46112A0A6AAA4A03.avi,147,1088,776,312,40.20618556701031,morphological_dilation,3,2
0X4611FC9B7FE4F50A.avi,61,1693,1317,376,28.549734244495063,morphological_dilation,3,2
0X4611FC9B7FE4F50A.avi,74,1469,1121,348,31.043710972346116,morphological_dilation,3,2
0X461758F43BB8187.avi,66,2508,2036,472,23.18271119842829,morphological_dilation,3,2
0X461758F43BB8187.avi,81,1505,1120,385,34.375,morphological_dilation,3,2
0X4623FC023AE07EE1.avi,64,2254,1834,420,22.900763358778626,morphological_dilation,3,2
0X4623FC023AE07EE1.avi,83,1416,1080,336,31.11111111111111,morphological_dilation,3,2
0X46258A8F882A3019.avi,49,3368,2808,560,19.943019943019944,morphological_dilation,3,2
0X46258A8F882A3019.avi,61,2048,1560,488,31.28205128205128,morphological_dilation,3,2
0X4635A6E545BAD9FD.avi,39,1920,1528,392,25.654450261780106,morphological_dilation,3,2
0X4635A6E545BAD9FD.avi,52,1177,857,320,37.33955659276546,morphological_dilation,3,2
0X463659CEAFA45073.avi,48,1866,1462,404,27.63337893296854,morphological_dilation,3,2
0X463659CEAFA45073.avi,65,1336,992,344,34.67741935483871,morphological_dilation,3,2
0X46380BAFF46D6E69.avi,54,2106,1706,400,23.446658851113718,morphological_dilation,3,2
0X46380BAFF46D6E69.avi,72,1588,1244,344,27.652733118971064,morphological_dilation,3,2
0X463A7B7D46C6CA4.avi,103,1903,1515,388,25.610561056105613,morphological_dilation,3,2
0X463A7B7D46C6CA4.avi,126,1417,1073,344,32.059645852749306,morphological_dilation,3,2
0X463C296E8E65DA97.avi,39,1820,1400,420,30.0,morphological_dilation,3,2
0X463C296E8E65DA97.avi,53,1083,739,344,46.54939106901218,morphological_dilation,3,2
0X4649CB5A58E805C6.avi,97,2327,1899,428,22.538177988414958,morphological_dilation,3,2
0X4649CB5A58E805C6.avi,113,1761,1397,364,26.055833929849676,morphological_dilation,3,2
0X464AFEA5B054D5B5.avi,35,1841,1453,388,26.703372333103925,morphological_dilation,3,2
0X464AFEA5B054D5B5.avi,47,1086,778,308,39.588688946015424,morphological_dilation,3,2
0X464B97C85D11DCC.avi,34,1405,1035,370,35.748792270531396,morphological_dilation,3,2
0X464B97C85D11DCC.avi,48,975,638,337,52.82131661442007,morphological_dilation,3,2
0X464C4B92D0C0CF58.avi,56,2242,1806,436,24.14174972314507,morphological_dilation,3,2
0X464C4B92D0C0CF58.avi,73,1491,1123,368,32.7693677649154,morphological_dilation,3,2
0X464D690506890716.avi,0,2057,1633,424,25.964482547458665,morphological_dilation,3,2
0X464D690506890716.avi,9,1235,907,328,36.163175303197356,morphological_dilation,3,2
0X464D8CFAA048566E.avi,104,2558,2090,468,22.392344497607656,morphological_dilation,3,2
0X464D8CFAA048566E.avi,119,1872,1452,420,28.92561983471074,morphological_dilation,3,2
0X464DF46257E5BDD.avi,27,1452,1084,368,33.94833948339483,morphological_dilation,3,2
0X464DF46257E5BDD.avi,38,917,605,312,51.570247933884296,morphological_dilation,3,2
0X464DFB5050226BDF.avi,119,1579,1198,381,31.803005008347245,morphological_dilation,3,2
0X464DFB5050226BDF.avi,135,1131,787,344,43.710292249047015,morphological_dilation,3,2
0X46540E51EA8D3CB3.avi,130,2071,1663,408,24.533974744437764,morphological_dilation,3,2
0X46540E51EA8D3CB3.avi,144,1483,1127,356,31.588287488908605,morphological_dilation,3,2
0X4654445DEC676C34.avi,32,1188,852,336,39.436619718309856,morphological_dilation,3,2
0X4654445DEC676C34.avi,44,748,486,262,53.90946502057613,morphological_dilation,3,2
0X4659B984370E6F6.avi,51,1718,1346,372,27.637444279346212,morphological_dilation,3,2
0X4659B984370E6F6.avi,66,991,695,296,42.589928057553955,morphological_dilation,3,2
0X465E263A2E3C4006.avi,41,1345,1025,320,31.21951219512195,morphological_dilation,3,2
0X465E263A2E3C4006.avi,57,899,635,264,41.574803149606296,morphological_dilation,3,2
0X465E766F162C7A19.avi,62,2289,1837,452,24.6053347849755,morphological_dilation,3,2
0X465E766F162C7A19.avi,74,2044,1604,440,27.431421446384043,morphological_dilation,3,2
0X465ED1F90846CB26.avi,32,2068,1648,420,25.485436893203882,morphological_dilation,3,2
0X465ED1F90846CB26.avi,52,1428,1052,376,35.741444866920155,morphological_dilation,3,2
0X4666116E3F120DF9.avi,104,1433,1065,368,34.55399061032864,morphological_dilation,3,2
0X4666116E3F120DF9.avi,120,856,564,292,51.77304964539007,morphological_dilation,3,2
0X46682D67FA3FE237.avi,64,1639,1279,360,28.146989835809226,morphological_dilation,3,2
0X46682D67FA3FE237.avi,82,1054,742,312,42.04851752021563,morphological_dilation,3,2
0X466EB4595EE4C15D.avi,43,4080,3508,572,16.305587229190422,morphological_dilation,3,2
0X466EB4595EE4C15D.avi,63,2208,1756,452,25.740318906605925,morphological_dilation,3,2
0X467280BF224215F.avi,100,1137,821,316,38.489646772228994,morphological_dilation,3,2
0X467280BF224215F.avi,116,755,491,264,53.76782077393075,morphological_dilation,3,2
0X4678C04CB6F6CC0B.avi,94,3100,2592,508,19.598765432098766,morphological_dilation,3,2
0X4678C04CB6F6CC0B.avi,109,1796,1408,388,27.556818181818183,morphological_dilation,3,2
0X467B292B5E1C740B.avi,80,1466,1130,336,29.734513274336283,morphological_dilation,3,2
0X467B292B5E1C740B.avi,98,974,682,292,42.81524926686217,morphological_dilation,3,2
0X467B7DC0FAEAAD97.avi,45,1647,1274,373,29.277864992150704,morphological_dilation,3,2
0X467B7DC0FAEAAD97.avi,61,997,713,284,39.83169705469846,morphological_dilation,3,2
0X467C4565D025C33B.avi,75,1520,1128,392,34.751773049645394,morphological_dilation,3,2
0X467C4565D025C33B.avi,97,944,624,320,51.28205128205128,morphological_dilation,3,2
0X467DCC27BC71B286.avi,85,1681,1329,352,26.486079759217457,morphological_dilation,3,2
0X467DCC27BC71B286.avi,101,969,689,280,40.638606676342526,morphological_dilation,3,2
0X4681E706E18BF21E.avi,80,1902,1495,407,27.224080267558527,morphological_dilation,3,2
0X4681E706E18BF21E.avi,94,1566,1182,384,32.48730964467005,morphological_dilation,3,2
0X468340D877F36659.avi,28,1315,955,360,37.696335078534034,morphological_dilation,3,2
0X468340D877F36659.avi,41,943,615,328,53.333333333333336,morphological_dilation,3,2
0X4686D15BB8789AC4.avi,4,1549,1178,371,31.494057724957553,morphological_dilation,3,2
0X4686D15BB8789AC4.avi,16,996,686,310,45.18950437317784,morphological_dilation,3,2
0X4692017DDC366859.avi,93,1546,1194,352,29.48073701842546,morphological_dilation,3,2
0X4692017DDC366859.avi,101,1253,933,320,34.29796355841372,morphological_dilation,3,2
0X4692C4D2FDB8FF33.avi,96,2608,2140,468,21.869158878504674,morphological_dilation,3,2
0X4692C4D2FDB8FF33.avi,113,1482,1122,360,32.0855614973262,morphological_dilation,3,2
0X469546878D04E5AF.avi,48,1840,1428,412,28.851540616246496,morphological_dilation,3,2
0X469546878D04E5AF.avi,55,2332,1869,463,24.772605671482076,morphological_dilation,3,2
0X4695711AF5D23C2F.avi,37,2373,1941,432,22.256568778979908,morphological_dilation,3,2
0X4695711AF5D23C2F.avi,51,2089,1669,420,25.164769322947873,morphological_dilation,3,2
0X46974CA9C1FAFF54.avi,37,1786,1374,412,29.985443959243085,morphological_dilation,3,2
0X46974CA9C1FAFF54.avi,54,1121,797,324,40.65244667503137,morphological_dilation,3,2
0X4699853F9A68420E.avi,38,1704,1332,372,27.927927927927925,morphological_dilation,3,2
0X4699853F9A68420E.avi,49,985,677,308,45.49483013293944,morphological_dilation,3,2
0X469F0E05A55908A4.avi,108,3173,2673,500,18.70557426112982,morphological_dilation,3,2
0X469F0E05A55908A4.avi,124,1924,1514,410,27.080581241743722,morphological_dilation,3,2
0X469F5261704011ED.avi,97,1659,1307,352,26.931905126243304,morphological_dilation,3,2
0X469F5261704011ED.avi,119,1090,802,288,35.910224438902745,morphological_dilation,3,2
0X46A60B1F1ACEE9FF.avi,31,1522,1162,360,30.98106712564544,morphological_dilation,3,2
0X46A60B1F1ACEE9FF.avi,49,1184,868,316,36.405529953917046,morphological_dilation,3,2
0X46A887F79BFB58DC.avi,53,1449,1097,352,32.087511394712855,morphological_dilation,3,2
0X46A887F79BFB58DC.avi,70,957,661,296,44.78063540090771,morphological_dilation,3,2
0X46A8BD539728F654.avi,87,1714,1338,376,28.101644245142005,morphological_dilation,3,2
0X46A8BD539728F654.avi,101,1164,840,324,38.57142857142858,morphological_dilation,3,2
0X46ACC9C2CF9CFB1E.avi,43,1906,1511,395,26.14162806088683,morphological_dilation,3,2
0X46ACC9C2CF9CFB1E.avi,104,1931,1306,625,47.85604900459418,morphological_dilation,3,2
0X46AE1D888EB482C9.avi,52,1537,1173,364,31.031543052003407,morphological_dilation,3,2
0X46AE1D888EB482C9.avi,68,1028,712,316,44.38202247191011,morphological_dilation,3,2
0X46AF7C10F61E0EA7.avi,70,1681,1305,376,28.812260536398465,morphological_dilation,3,2
0X46AF7C10F61E0EA7.avi,92,1182,866,316,36.489607390300236,morphological_dilation,3,2
0X46B0C3E74FBBA739.avi,88,1809,1433,376,26.238660153524073,morphological_dilation,3,2
0X46B0C3E74FBBA739.avi,99,1230,918,312,33.98692810457516,morphological_dilation,3,2
0X46B0E42A1E861C36.avi,92,1568,1224,344,28.104575163398692,morphological_dilation,3,2
0X46B0E42A1E861C36.avi,106,967,659,308,46.737481031866466,morphological_dilation,3,2
0X46B1CCE5B354B752.avi,24,1265,953,312,32.73871983210913,morphological_dilation,3,2
0X46B1CCE5B354B752.avi,37,790,530,260,49.056603773584904,morphological_dilation,3,2
0X46B2F29BE675B414.avi,113,2038,1630,408,25.030674846625768,morphological_dilation,3,2
0X46B2F29BE675B414.avi,133,1193,855,338,39.53216374269006,morphological_dilation,3,2
0X46B8BB5213CB1F0E.avi,50,1747,1347,400,29.695619896065327,morphological_dilation,3,2
0X46B8BB5213CB1F0E.avi,67,1048,708,340,48.0225988700565,morphological_dilation,3,2
0X46B96E600D63E220.avi,119,2365,1909,456,23.88685175484547,morphological_dilation,3,2
0X46B96E600D63E220.avi,135,1623,1244,379,30.466237942122188,morphological_dilation,3,2
0X46BBFEEF6D8F4FC7.avi,34,1843,1431,412,28.791055206149547,morphological_dilation,3,2
0X46BBFEEF6D8F4FC7.avi,47,929,620,309,49.83870967741936,morphological_dilation,3,2
0X46BCFDEAE8089A57.avi,64,2011,1603,408,25.45227698066126,morphological_dilation,3,2
0X46BCFDEAE8089A57.avi,80,1223,879,344,39.1353811149033,morphological_dilation,3,2
0X46C26D1B887FA60E.avi,55,1889,1501,388,25.849433710859426,morphological_dilation,3,2
0X46C26D1B887FA60E.avi,76,1315,995,320,32.1608040201005,morphological_dilation,3,2
0X46C848F34D9A1C52.avi,3,1732,1328,404,30.42168674698795,morphological_dilation,3,2
0X46C848F34D9A1C52.avi,18,1133,801,332,41.4481897627965,morphological_dilation,3,2
0X46C85F22B3CC9971.avi,46,2056,1632,424,25.98039215686275,morphological_dilation,3,2
0X46C85F22B3CC9971.avi,61,1277,929,348,37.45963401506997,morphological_dilation,3,2
0X46D2C668D5E324C4.avi,29,1017,741,276,37.24696356275304,morphological_dilation,3,2
0X46D2C668D5E324C4.avi,42,700,464,236,50.86206896551724,morphological_dilation,3,2
0X46D3DFF945D068E6.avi,45,2817,2337,480,20.539152759948653,morphological_dilation,3,2
0X46D3DFF945D068E6.avi,59,1601,1225,376,30.69387755102041,morphological_dilation,3,2
0X46D6ADEBB2724045.avi,68,1771,1379,392,28.426395939086298,morphological_dilation,3,2
0X46D6ADEBB2724045.avi,88,1100,800,300,37.5,morphological_dilation,3,2
0X46D6E363FD24E7D8.avi,74,2794,2286,508,22.22222222222222,morphological_dilation,3,2
0X46D6E363FD24E7D8.avi,90,1802,1374,428,31.149927219796215,morphological_dilation,3,2
0X46D8CDB35FD5072.avi,31,900,620,280,45.16129032258064,morphological_dilation,3,2
0X46D8CDB35FD5072.avi,43,615,387,228,58.91472868217055,morphological_dilation,3,2
0X46D9701BDA5EBEF4.avi,84,942,650,292,44.92307692307692,morphological_dilation,3,2
0X46D9701BDA5EBEF4.avi,104,590,350,240,68.57142857142857,morphological_dilation,3,2
0X46DAAD3656224448.avi,83,2732,2228,504,22.621184919210055,morphological_dilation,3,2
0X46DAAD3656224448.avi,95,1523,1143,380,33.24584426946632,morphological_dilation,3,2
0X46DD6F251FB476EC.avi,153,1461,1089,372,34.15977961432507,morphological_dilation,3,2
0X46DD6F251FB476EC.avi,170,872,534,338,63.29588014981273,morphological_dilation,3,2
0X46DDEFA74CDB0EBD.avi,0,1859,1467,392,26.7211997273347,morphological_dilation,3,2
0X46DDEFA74CDB0EBD.avi,26,1122,805,317,39.37888198757764,morphological_dilation,3,2
0X46E076385E2BD694.avi,90,3166,2630,536,20.380228136882128,morphological_dilation,3,2
0X46E076385E2BD694.avi,120,1793,1333,460,34.508627156789196,morphological_dilation,3,2
0X46E0DDFB5E35C490.avi,36,1758,1357,401,29.55047899778924,morphological_dilation,3,2
0X46E0DDFB5E35C490.avi,47,1124,796,328,41.20603015075377,morphological_dilation,3,2
0X46E335EDE6F8E5AD.avi,63,2696,2218,478,21.550946798917945,morphological_dilation,3,2
0X46E335EDE6F8E5AD.avi,79,1798,1398,400,28.612303290414882,morphological_dilation,3,2
0X46E845D4F2348D4.avi,139,1499,1159,340,29.335634167385678,morphological_dilation,3,2
0X46E845D4F2348D4.avi,161,1094,806,288,35.73200992555831,morphological_dilation,3,2
0X46EB0F531C3EE3A2.avi,68,2175,1755,420,23.931623931623932,morphological_dilation,3,2
0X46EB0F531C3EE3A2.avi,82,1441,1093,348,31.83897529734675,morphological_dilation,3,2
0X46EB76C70B65EA5B.avi,5,2360,1924,436,22.66112266112266,morphological_dilation,3,2
0X46EB76C70B65EA5B.avi,19,1639,1271,368,28.95357985837923,morphological_dilation,3,2
0X46F0756996349.avi,109,1496,1152,344,29.86111111111111,morphological_dilation,3,2
0X46F0756996349.avi,127,1175,863,312,36.152954808806484,morphological_dilation,3,2
0X46F177DC7B92CEA6.avi,102,3328,2804,524,18.687589158345222,morphological_dilation,3,2
0X46F177DC7B92CEA6.avi,121,1951,1539,412,26.77063027940221,morphological_dilation,3,2
0X46F641FCE4FFCF0B.avi,49,2441,1986,455,22.910372608257802,morphological_dilation,3,2
0X46F641FCE4FFCF0B.avi,62,1578,1206,372,30.845771144278604,morphological_dilation,3,2
0X46F890593D02A068.avi,75,1763,1371,392,28.592268417213713,morphological_dilation,3,2
0X46F890593D02A068.avi,89,1106,790,316,40.0,morphological_dilation,3,2
0X46F9633AC34FF38E.avi,102,2257,1841,416,22.596414991852253,morphological_dilation,3,2
0X46F9633AC34FF38E.avi,120,1890,1494,396,26.506024096385545,morphological_dilation,3,2
0X46F9944BBD295961.avi,82,2393,1953,440,22.529441884280594,morphological_dilation,3,2
0X46F9944BBD295961.avi,98,1438,1082,356,32.90203327171904,morphological_dilation,3,2
0X46FA0CE0A00866D0.avi,158,1679,1295,384,29.65250965250965,morphological_dilation,3,2
0X46FA0CE0A00866D0.avi,170,1069,757,312,41.21532364597093,morphological_dilation,3,2
0X46FA118F433C5C36.avi,36,1618,1262,356,28.209191759112517,morphological_dilation,3,2
0X46FA118F433C5C36.avi,55,1314,982,332,33.80855397148676,morphological_dilation,3,2
0X46FD77D3DC9F4026.avi,73,1430,1078,352,32.6530612244898,morphological_dilation,3,2
0X46FD77D3DC9F4026.avi,100,879,599,280,46.744574290484145,morphological_dilation,3,2
0X46FF014B4D866466.avi,79,1590,1232,358,29.05844155844156,morphological_dilation,3,2
0X46FF014B4D866466.avi,96,1139,843,296,35.11269276393831,morphological_dilation,3,2
0X4700367736428EE9.avi,54,1643,1275,368,28.862745098039216,morphological_dilation,3,2
0X4700367736428EE9.avi,72,1033,729,304,41.70096021947874,morphological_dilation,3,2
0X4700E4911EF3C56A.avi,100,2016,1608,408,25.37313432835821,morphological_dilation,3,2
0X4700E4911EF3C56A.avi,115,1206,890,316,35.50561797752809,morphological_dilation,3,2
0X4701B85B6B446BB8.avi,30,1940,1544,396,25.647668393782386,morphological_dilation,3,2
0X4701B85B6B446BB8.avi,43,1675,1303,372,28.54950115118956,morphological_dilation,3,2
0X470253DB6CB105B3.avi,125,1353,1029,324,31.486880466472307,morphological_dilation,3,2
0X470253DB6CB105B3.avi,141,910,634,276,43.53312302839117,morphological_dilation,3,2
0X4703E1BFF89C0301.avi,52,2506,2070,436,21.06280193236715,morphological_dilation,3,2
0X4703E1BFF89C0301.avi,69,1799,1423,376,26.423049894588896,morphological_dilation,3,2
0X4704159CFC29D4C3.avi,56,1590,1226,364,29.690048939641112,morphological_dilation,3,2
0X4704159CFC29D4C3.avi,67,1185,869,316,36.36363636363637,morphological_dilation,3,2
0X4707425BAF59515F.avi,71,1536,1184,352,29.72972972972973,morphological_dilation,3,2
0X4707425BAF59515F.avi,87,1238,901,337,37.40288568257492,morphological_dilation,3,2
0X4709E6A8CFF415E8.avi,85,1975,1571,404,25.716104392106935,morphological_dilation,3,2
0X4709E6A8CFF415E8.avi,100,1327,983,344,34.99491353001017,morphological_dilation,3,2
0X470C3A06C890B2B3.avi,65,1405,1073,332,30.941286113699906,morphological_dilation,3,2
0X470C3A06C890B2B3.avi,74,1169,869,300,34.52243958573072,morphological_dilation,3,2
0X470CD51F9B5DF85C.avi,76,956,684,272,39.76608187134503,morphological_dilation,3,2
0X470CD51F9B5DF85C.avi,94,767,527,240,45.54079696394687,morphological_dilation,3,2
0X470FA78D91CC7397.avi,93,1661,1293,368,28.46094354215004,morphological_dilation,3,2
0X470FA78D91CC7397.avi,113,985,693,292,42.13564213564214,morphological_dilation,3,2
0X471783E22BC7C7C1.avi,48,2064,1660,404,24.337349397590362,morphological_dilation,3,2
0X471783E22BC7C7C1.avi,65,1160,852,308,36.15023474178404,morphological_dilation,3,2
0X471837C15FA962D2.avi,27,2102,1718,384,22.351571594877765,morphological_dilation,3,2
0X471837C15FA962D2.avi,41,1336,1016,320,31.496062992125985,morphological_dilation,3,2
0X4722C9BF04CEEB25.avi,47,2262,1846,416,22.535211267605636,morphological_dilation,3,2
0X4722C9BF04CEEB25.avi,72,1659,1262,397,31.45800316957211,morphological_dilation,3,2
0X47241688479B3A90.avi,76,3804,3220,584,18.13664596273292,morphological_dilation,3,2
0X47241688479B3A90.avi,83,2291,1779,512,28.780213603147835,morphological_dilation,3,2
0X4724AC020BB043C4.avi,42,1560,1204,356,29.568106312292358,morphological_dilation,3,2
0X4724AC020BB043C4.avi,59,1022,726,296,40.77134986225895,morphological_dilation,3,2
0X4724EF4A6021488E.avi,142,4144,3568,576,16.143497757847534,morphological_dilation,3,2
0X4724EF4A6021488E.avi,162,2220,1764,456,25.850340136054424,morphological_dilation,3,2
0X4726A11E93B9DE90.avi,41,1326,982,344,35.03054989816701,morphological_dilation,3,2
0X4726A11E93B9DE90.avi,54,964,656,308,46.95121951219512,morphological_dilation,3,2
0X472BE363F86E6CDB.avi,79,1792,1392,400,28.735632183908045,morphological_dilation,3,2
0X472BE363F86E6CDB.avi,97,928,636,292,45.911949685534594,morphological_dilation,3,2
0X472DDCEC92FE7A59.avi,51,1532,1160,372,32.068965517241374,morphological_dilation,3,2
0X472DDCEC92FE7A59.avi,63,1144,828,316,38.164251207729464,morphological_dilation,3,2
0X472E440353556195.avi,92,2194,1747,447,25.586720091585573,morphological_dilation,3,2
0X472E440353556195.avi,112,1182,846,336,39.71631205673759,morphological_dilation,3,2
0X4735E8CE35BE2A3.avi,53,1353,1017,336,33.03834808259587,morphological_dilation,3,2
0X4735E8CE35BE2A3.avi,68,843,559,284,50.80500894454383,morphological_dilation,3,2
0X4742152D0E22F043.avi,103,1854,1458,396,27.160493827160494,morphological_dilation,3,2
0X4742152D0E22F043.avi,122,1142,826,316,38.256658595641646,morphological_dilation,3,2
0X4746C7E35E560E3F.avi,50,1347,1027,320,31.158714703018504,morphological_dilation,3,2
0X4746C7E35E560E3F.avi,65,898,630,268,42.53968253968254,morphological_dilation,3,2
0X4746D69940479A7.avi,61,3226,2714,512,18.865143699336773,morphological_dilation,3,2
0X4746D69940479A7.avi,72,1841,1457,384,26.355525051475638,morphological_dilation,3,2
0X474B0F4E6590E8A8.avi,50,1431,1083,348,32.13296398891966,morphological_dilation,3,2
0X474B0F4E6590E8A8.avi,64,914,618,296,47.896440129449836,morphological_dilation,3,2
0X474DD406384555D8.avi,148,1509,1149,360,31.33159268929504,morphological_dilation,3,2
0X474DD406384555D8.avi,161,1252,916,336,36.681222707423586,morphological_dilation,3,2
0X4751BDCD16AA2343.avi,35,1897,1505,392,26.046511627906977,morphological_dilation,3,2
0X4751BDCD16AA2343.avi,50,1626,1262,364,28.84310618066561,morphological_dilation,3,2
0X47525086CF1B329F.avi,65,1656,1264,392,31.0126582278481,morphological_dilation,3,2
0X47525086CF1B329F.avi,85,937,607,330,54.36573311367381,morphological_dilation,3,2
0X475268C075FF7737.avi,34,1717,1357,360,26.529108327192336,morphological_dilation,3,2
0X475268C075FF7737.avi,49,1252,932,320,34.33476394849785,morphological_dilation,3,2
0X47531256525CE22B.avi,48,1973,1573,400,25.429116338207248,morphological_dilation,3,2
0X47531256525CE22B.avi,67,1293,949,344,36.248682824025295,morphological_dilation,3,2
0X475585257AE2E722.avi,100,1874,1482,392,26.450742240215924,morphological_dilation,3,2
0X475585257AE2E722.avi,118,1377,1053,324,30.76923076923077,morphological_dilation,3,2
0X475685CC25B59A31.avi,95,1526,1157,369,31.892826274848744,morphological_dilation,3,2
0X475685CC25B59A31.avi,122,971,629,342,54.372019077901435,morphological_dilation,3,2
0X475911107C069CD2.avi,39,1235,923,312,33.80281690140845,morphological_dilation,3,2
0X475911107C069CD2.avi,49,1040,746,294,39.41018766756032,morphological_dilation,3,2
0X475B14E7CDFC143D.avi,46,1619,1239,380,30.669895076674734,morphological_dilation,3,2
0X475B14E7CDFC143D.avi,58,987,679,308,45.36082474226804,morphological_dilation,3,2
0X475BAF471615BAC2.avi,66,1143,837,306,36.55913978494624,morphological_dilation,3,2
0X475BAF471615BAC2.avi,81,667,427,240,56.20608899297424,morphological_dilation,3,2
0X475C1DE9B186E5D1.avi,56,1675,1312,363,27.66768292682927,morphological_dilation,3,2
0X475C1DE9B186E5D1.avi,73,1043,751,292,38.8814913448735,morphological_dilation,3,2
0X476320C5BDCD5BA6.avi,57,1669,1305,364,27.892720306513407,morphological_dilation,3,2
0X476320C5BDCD5BA6.avi,73,980,700,280,40.0,morphological_dilation,3,2
0X47652348BF1687F2.avi,52,1992,1560,432,27.692307692307693,morphological_dilation,3,2
0X47652348BF1687F2.avi,67,1291,932,359,38.51931330472103,morphological_dilation,3,2
0X476641FB702A0EDF.avi,45,1282,950,332,34.94736842105263,morphological_dilation,3,2
0X476641FB702A0EDF.avi,63,795,527,268,50.853889943074,morphological_dilation,3,2
0X476749AF0E3C3D5D.avi,40,1121,809,312,38.56613102595797,morphological_dilation,3,2
0X476749AF0E3C3D5D.avi,55,756,504,252,50.0,morphological_dilation,3,2
0X476AA915D8E928A.avi,90,1641,1269,372,29.314420803782504,morphological_dilation,3,2
0X476AA915D8E928A.avi,107,1015,713,302,42.3562412342216,morphological_dilation,3,2
0X476B330DE1073521.avi,4,1702,1336,366,27.395209580838326,morphological_dilation,3,2
0X476B330DE1073521.avi,18,1057,761,296,38.89618922470434,morphological_dilation,3,2
0X476B36561AE2A0D2.avi,81,1807,1423,384,26.985242445537594,morphological_dilation,3,2
0X476B36561AE2A0D2.avi,100,1208,880,328,37.27272727272727,morphological_dilation,3,2
0X476F7A75F09C0B5B.avi,84,1896,1493,403,26.992632283991963,morphological_dilation,3,2
0X476F7A75F09C0B5B.avi,97,1136,792,344,43.43434343434344,morphological_dilation,3,2
0X477211790541ED15.avi,37,2426,1986,440,22.15508559919436,morphological_dilation,3,2
0X477211790541ED15.avi,52,1396,1056,340,32.196969696969695,morphological_dilation,3,2
0X47760ED572E13C7A.avi,159,2135,1735,400,23.054755043227665,morphological_dilation,3,2
0X47760ED572E13C7A.avi,176,2061,1485,576,38.78787878787879,morphological_dilation,3,2
0X4776D370A544B906.avi,115,1110,810,300,37.03703703703704,morphological_dilation,3,2
0X4776D370A544B906.avi,141,683,426,257,60.328638497652584,morphological_dilation,3,2
0X4779BE071DEE725B.avi,44,765,529,236,44.61247637051039,morphological_dilation,3,2
0X4779BE071DEE725B.avi,58,538,342,196,57.30994152046783,morphological_dilation,3,2
0X477A5498A9228272.avi,38,2352,1897,455,23.985239852398525,morphological_dilation,3,2
0X477A5498A9228272.avi,52,1822,1418,404,28.49083215796897,morphological_dilation,3,2
0X47827D50EA4F700C.avi,46,1789,1423,366,25.720309205903018,morphological_dilation,3,2
0X47827D50EA4F700C.avi,66,1107,819,288,35.16483516483517,morphological_dilation,3,2
0X47847D0C76E816E7.avi,70,2665,2193,472,21.523027815777475,morphological_dilation,3,2
0X47847D0C76E816E7.avi,86,1650,1264,386,30.537974683544306,morphological_dilation,3,2
0X4785E9CF6784D185.avi,131,1805,1417,388,27.3817925194072,morphological_dilation,3,2
0X4785E9CF6784D185.avi,149,1261,921,340,36.91639522258415,morphological_dilation,3,2
0X47864FA3C28A0D7E.avi,34,2240,1832,408,22.270742358078603,morphological_dilation,3,2
0X47864FA3C28A0D7E.avi,52,1784,1412,372,26.345609065155806,morphological_dilation,3,2
0X47902A34F32E05B8.avi,47,1873,1497,376,25.116900467601873,morphological_dilation,3,2
0X47902A34F32E05B8.avi,65,1117,823,294,35.722964763061974,morphological_dilation,3,2
0X479254EA39F54EE8.avi,36,1147,839,308,36.7103694874851,morphological_dilation,3,2
0X479254EA39F54EE8.avi,55,656,420,236,56.19047619047619,morphological_dilation,3,2
0X4796B510866E9AF5.avi,156,1646,1270,376,29.606299212598426,morphological_dilation,3,2
0X4796B510866E9AF5.avi,176,1057,745,312,41.87919463087248,morphological_dilation,3,2
0X4797A8A850B26898.avi,77,1883,1499,384,25.617078052034692,morphological_dilation,3,2
0X4797A8A850B26898.avi,95,1212,904,308,34.070796460176986,morphological_dilation,3,2
0X47A36F58EC5766A0.avi,38,878,606,272,44.884488448844884,morphological_dilation,3,2
0X47A36F58EC5766A0.avi,55,606,344,262,76.16279069767442,morphological_dilation,3,2
0X47A97790F0C53CC4.avi,90,695,459,236,51.4161220043573,morphological_dilation,3,2
0X47A97790F0C53CC4.avi,104,460,251,209,83.26693227091634,morphological_dilation,3,2
0X47AB20C78E2DC818.avi,5,2561,2098,463,22.068636796949477,morphological_dilation,3,2
0X47AB20C78E2DC818.avi,18,1935,1535,400,26.058631921824105,morphological_dilation,3,2
0X47B3F561C23EFC83.avi,74,1644,1280,364,28.4375,morphological_dilation,3,2
0X47B3F561C23EFC83.avi,90,1093,777,316,40.66924066924067,morphological_dilation,3,2
0X47B7FB9C26D31A01.avi,155,1662,1250,412,32.96,morphological_dilation,3,2
0X47B7FB9C26D31A01.avi,167,1030,686,344,50.14577259475219,morphological_dilation,3,2
0X47B93384CF91E71E.avi,75,1351,1019,332,32.580961727183514,morphological_dilation,3,2
0X47B93384CF91E71E.avi,94,838,558,280,50.179211469534046,morphological_dilation,3,2
0X47C11DD3EBCA4358.avi,37,2112,1692,420,24.822695035460992,morphological_dilation,3,2
0X47C11DD3EBCA4358.avi,52,1629,1265,364,28.774703557312254,morphological_dilation,3,2
0X47C3A2C6F7337211.avi,124,2169,1733,436,25.158684362377382,morphological_dilation,3,2
0X47C3A2C6F7337211.avi,140,1405,1057,348,32.92336802270577,morphological_dilation,3,2
0X47C5BD5581B2636.avi,125,1905,1487,418,28.110289172831205,morphological_dilation,3,2
0X47C5BD5581B2636.avi,143,1074,742,332,44.74393530997305,morphological_dilation,3,2
0X47C61AE147E6645B.avi,1,1940,1544,396,25.647668393782386,morphological_dilation,3,2
0X47C61AE147E6645B.avi,18,1230,902,328,36.36363636363637,morphological_dilation,3,2
0X47C69408C25944D5.avi,43,1358,1030,328,31.844660194174757,morphological_dilation,3,2
0X47C69408C25944D5.avi,58,959,679,280,41.23711340206185,morphological_dilation,3,2
0X47D04CC0EEE7F1EC.avi,38,2369,1933,436,22.55561303673047,morphological_dilation,3,2
0X47D04CC0EEE7F1EC.avi,52,1607,1227,380,30.969845150774244,morphological_dilation,3,2
0X47DBEA2F11240016.avi,3,1569,1197,372,31.07769423558897,morphological_dilation,3,2
0X47DBEA2F11240016.avi,18,1056,736,320,43.47826086956522,morphological_dilation,3,2
0X47DE6565CC0A74F0.avi,75,1265,949,316,33.298208640674396,morphological_dilation,3,2
0X47DE6565CC0A74F0.avi,89,754,492,262,53.2520325203252,morphological_dilation,3,2
0X47E00F696D481DE7.avi,86,1647,1271,376,29.58300550747443,morphological_dilation,3,2
0X47E00F696D481DE7.avi,102,998,682,316,46.33431085043988,morphological_dilation,3,2
0X47E115F8D0A797EE.avi,49,2143,1713,430,25.102159953298308,morphological_dilation,3,2
0X47E115F8D0A797EE.avi,65,1210,866,344,39.722863741339495,morphological_dilation,3,2
0X47E5C10C8132FFB2.avi,44,1551,1207,344,28.500414250207122,morphological_dilation,3,2
0X47E5C10C8132FFB2.avi,67,1024,734,290,39.509536784741144,morphological_dilation,3,2
0X47EDDE2F8004F754.avi,0,1614,1258,356,28.298887122416534,morphological_dilation,3,2
0X47EDDE2F8004F754.avi,8,1143,843,300,35.587188612099645,morphological_dilation,3,2
0X47F00D882D730416.avi,36,1649,1285,364,28.326848249027236,morphological_dilation,3,2
0X47F00D882D730416.avi,52,1120,804,316,39.30348258706468,morphological_dilation,3,2
0X47F34619DCEFCDC9.avi,99,1913,1517,396,26.104152933421226,morphological_dilation,3,2
0X47F34619DCEFCDC9.avi,116,1094,770,324,42.077922077922075,morphological_dilation,3,2
0X47FC02860FC36935.avi,44,3401,2881,520,18.049288441513365,morphological_dilation,3,2
0X47FC02860FC36935.avi,59,2038,1610,428,26.583850931677016,morphological_dilation,3,2
0X47FC0610DB80051A.avi,150,2067,1635,432,26.422018348623855,morphological_dilation,3,2
0X47FC0610DB80051A.avi,163,1571,1171,400,34.158838599487616,morphological_dilation,3,2
0X47FC5FBFF53B0AD8.avi,47,2976,2464,512,20.77922077922078,morphological_dilation,3,2
0X47FC5FBFF53B0AD8.avi,59,1972,1532,440,28.720626631853786,morphological_dilation,3,2
0X47FCF3189BE29C79.avi,86,1631,1263,368,29.13697545526524,morphological_dilation,3,2
0X47FCF3189BE29C79.avi,103,1018,710,308,43.38028169014084,morphological_dilation,3,2
0X480291080E3DD3EE.avi,0,1779,1411,368,26.080793763288447,morphological_dilation,3,2
0X480291080E3DD3EE.avi,16,1107,811,296,36.49815043156597,morphological_dilation,3,2
0X4803F7D876C339CF.avi,30,1863,1463,400,27.34107997265892,morphological_dilation,3,2
0X4803F7D876C339CF.avi,44,1101,785,316,40.254777070063696,morphological_dilation,3,2
0X480A7B6D54009BF8.avi,44,1571,1207,364,30.15741507870754,morphological_dilation,3,2
0X480A7B6D54009BF8.avi,63,985,681,304,44.640234948605,morphological_dilation,3,2
0X480F3C8E8D43D621.avi,133,1736,1380,356,25.79710144927536,morphological_dilation,3,2
0X480F3C8E8D43D621.avi,148,1106,810,296,36.54320987654321,morphological_dilation,3,2
0X4812581D45B5FFC5.avi,100,1691,1327,364,27.43029389600603,morphological_dilation,3,2
0X4812581D45B5FFC5.avi,120,1036,732,304,41.53005464480874,morphological_dilation,3,2
0X4816823BCF1EDFC6.avi,122,1889,1493,396,26.52377762893503,morphological_dilation,3,2
0X4816823BCF1EDFC6.avi,141,1202,874,328,37.52860411899314,morphological_dilation,3,2
0X4817AC0DD12566F8.avi,51,1887,1495,392,26.220735785953174,morphological_dilation,3,2
0X4817AC0DD12566F8.avi,68,1150,826,324,39.22518159806295,morphological_dilation,3,2
0X4817C5B6DA01BD03.avi,84,1554,1186,368,31.02866779089376,morphological_dilation,3,2
0X4817C5B6DA01BD03.avi,99,947,627,320,51.03668261562998,morphological_dilation,3,2
0X48182B4ADA3FFE0E.avi,0,2514,2058,456,22.157434402332363,morphological_dilation,3,2
0X48182B4ADA3FFE0E.avi,18,1854,1446,408,28.21576763485477,morphological_dilation,3,2
0X481CC400687B5EBF.avi,77,1785,1401,384,27.40899357601713,morphological_dilation,3,2
0X481CC400687B5EBF.avi,93,1101,789,312,39.543726235741445,morphological_dilation,3,2
0X4821B047209D5A54.avi,36,2829,2322,507,21.834625322997418,morphological_dilation,3,2
0X4821B047209D5A54.avi,62,2551,2075,476,22.939759036144576,morphological_dilation,3,2
0X4827A66C595F8E76.avi,145,1592,1205,387,32.11618257261411,morphological_dilation,3,2
0X4827A66C595F8E76.avi,164,1098,766,332,43.34203655352481,morphological_dilation,3,2
0X482848939C63FAA8.avi,67,1938,1550,388,25.032258064516128,morphological_dilation,3,2
0X482848939C63FAA8.avi,87,1605,1245,360,28.915662650602407,morphological_dilation,3,2
0X482BB41895F1974D.avi,31,1187,875,312,35.65714285714286,morphological_dilation,3,2
0X482BB41895F1974D.avi,49,799,539,260,48.237476808905384,morphological_dilation,3,2
0X482E380A512BB6E4.avi,103,1400,1060,340,32.075471698113205,morphological_dilation,3,2
0X482E380A512BB6E4.avi,120,889,601,288,47.920133111480865,morphological_dilation,3,2
0X4834F567A2EAED1C.avi,71,2284,1864,420,22.532188841201716,morphological_dilation,3,2
0X4834F567A2EAED1C.avi,91,1722,1338,384,28.699551569506728,morphological_dilation,3,2
0X483BF2DFD6CDFD0A.avi,45,3488,2980,508,17.04697986577181,morphological_dilation,3,2
0X483BF2DFD6CDFD0A.avi,57,3096,2612,484,18.529862174578867,morphological_dilation,3,2
0X483D8D5364D95CAF.avi,57,2015,1591,424,26.64990571967316,morphological_dilation,3,2
0X483D8D5364D95CAF.avi,78,1306,948,358,37.76371308016878,morphological_dilation,3,2
0X483DBCA3562BA53B.avi,56,1215,875,340,38.857142857142854,morphological_dilation,3,2
0X483DBCA3562BA53B.avi,75,771,479,292,60.96033402922756,morphological_dilation,3,2
0X4840DCB7E1FD00F7.avi,133,1891,1499,392,26.150767178118745,morphological_dilation,3,2
0X4840DCB7E1FD00F7.avi,149,1136,816,320,39.21568627450981,morphological_dilation,3,2
0X48451904D8FEA4C6.avi,83,1592,1204,388,32.22591362126246,morphological_dilation,3,2
0X48451904D8FEA4C6.avi,96,1066,734,332,45.23160762942779,morphological_dilation,3,2
0X484A7AD1C7FCF417.avi,45,1565,1213,352,29.018961253091508,morphological_dilation,3,2
0X484A7AD1C7FCF417.avi,59,1021,729,292,40.054869684499316,morphological_dilation,3,2
0X484B7E454D147B.avi,61,1439,1111,328,29.522952295229523,morphological_dilation,3,2
0X484B7E454D147B.avi,82,915,651,264,40.55299539170507,morphological_dilation,3,2
0X484D1623FDD8A749.avi,64,2258,1817,441,24.27077600440286,morphological_dilation,3,2
0X484D1623FDD8A749.avi,77,1993,1573,420,26.70057215511761,morphological_dilation,3,2
0X484D532533D59798.avi,44,1820,1424,396,27.808988764044944,morphological_dilation,3,2
0X484D532533D59798.avi,64,1197,861,336,39.02439024390244,morphological_dilation,3,2
0X484F1CB40EAD34A9.avi,53,1408,1064,344,32.33082706766917,morphological_dilation,3,2
0X484F1CB40EAD34A9.avi,68,894,613,281,45.840130505709624,morphological_dilation,3,2
0X4851ABCA6F1C46AD.avi,37,1843,1455,388,26.666666666666668,morphological_dilation,3,2
0X4851ABCA6F1C46AD.avi,45,1219,899,320,35.595105672969964,morphological_dilation,3,2
0X4859CCA5F75542D1.avi,129,1284,960,324,33.75,morphological_dilation,3,2
0X4859CCA5F75542D1.avi,153,853,571,282,49.38704028021016,morphological_dilation,3,2
0X485A11110AA338D0.avi,92,2112,1700,412,24.235294117647058,morphological_dilation,3,2
0X485A11110AA338D0.avi,108,1340,1012,328,32.41106719367589,morphological_dilation,3,2
0X485CE172721DFD8.avi,66,2093,1685,408,24.213649851632045,morphological_dilation,3,2
0X485CE172721DFD8.avi,88,1239,909,330,36.303630363036305,morphological_dilation,3,2
0X4860838E68AACEB4.avi,93,2587,2131,456,21.398404504927264,morphological_dilation,3,2
0X4860838E68AACEB4.avi,110,1615,1227,388,31.62184189079055,morphological_dilation,3,2
0X4868DEBC55A12E1B.avi,56,1749,1373,376,27.385287691187184,morphological_dilation,3,2
0X4868DEBC55A12E1B.avi,78,1112,810,302,37.28395061728395,morphological_dilation,3,2
0X4868F081436C4E7F.avi,1,1437,1101,336,30.517711171662125,morphological_dilation,3,2
0X4868F081436C4E7F.avi,18,924,636,288,45.28301886792453,morphological_dilation,3,2
0X486FA2FEA63A167A.avi,37,1805,1409,396,28.105039034776436,morphological_dilation,3,2
0X486FA2FEA63A167A.avi,55,1193,861,332,38.55981416957027,morphological_dilation,3,2
0X48761851D94C1763.avi,77,949,661,288,43.57034795763994,morphological_dilation,3,2
0X48761851D94C1763.avi,93,610,349,261,74.78510028653295,morphological_dilation,3,2
0X487AD58712D5936A.avi,121,2000,1592,408,25.628140703517587,morphological_dilation,3,2
0X487AD58712D5936A.avi,135,1185,865,320,36.99421965317919,morphological_dilation,3,2
0X487B52623BC14C25.avi,84,3191,2643,548,20.734014377601213,morphological_dilation,3,2
0X487B52623BC14C25.avi,101,1796,1381,415,30.050687907313538,morphological_dilation,3,2
0X487BE41D13192D63.avi,69,2092,1684,408,24.228028503562946,morphological_dilation,3,2
0X487BE41D13192D63.avi,81,1511,1147,364,31.734960767218833,morphological_dilation,3,2
0X487CC25D3120FE8D.avi,58,3104,2612,492,18.83614088820827,morphological_dilation,3,2
0X487CC25D3120FE8D.avi,73,2608,2137,471,22.040243331773514,morphological_dilation,3,2
0X487D527B99627548.avi,110,1474,1130,344,30.442477876106196,morphological_dilation,3,2
0X487D527B99627548.avi,122,934,650,284,43.69230769230769,morphological_dilation,3,2
0X488191DE8CF0E63B.avi,54,1700,1312,388,29.573170731707314,morphological_dilation,3,2
0X488191DE8CF0E63B.avi,71,1298,946,352,37.2093023255814,morphological_dilation,3,2
0X48832D83C5EA9C32.avi,67,2595,2115,480,22.69503546099291,morphological_dilation,3,2
0X48832D83C5EA9C32.avi,83,2004,1545,459,29.708737864077673,morphological_dilation,3,2
0X4886855CBADF5BB3.avi,40,2075,1651,424,25.681405208964264,morphological_dilation,3,2
0X4886855CBADF5BB3.avi,57,1435,1058,377,35.63327032136106,morphological_dilation,3,2
0X4887AAE8BCAC9286.avi,50,2952,2472,480,19.41747572815534,morphological_dilation,3,2
0X4887AAE8BCAC9286.avi,65,1780,1396,384,27.507163323782237,morphological_dilation,3,2
0X4888320B67665CA8.avi,32,2362,1922,440,22.892819979188346,morphological_dilation,3,2
0X4888320B67665CA8.avi,45,1456,1084,372,34.31734317343174,morphological_dilation,3,2
0X48886D77793F5850.avi,143,1519,1163,356,30.61049011177988,morphological_dilation,3,2
0X48886D77793F5850.avi,168,952,644,308,47.82608695652174,morphological_dilation,3,2
0X48888B44E3758571.avi,1,2247,1815,432,23.801652892561982,morphological_dilation,3,2
0X48888B44E3758571.avi,15,1239,895,344,38.435754189944134,morphological_dilation,3,2
0X4889B480C7F3DE83.avi,49,1753,1373,380,27.676620538965768,morphological_dilation,3,2
0X4889B480C7F3DE83.avi,61,1669,1297,372,28.681572860447186,morphological_dilation,3,2
0X488A8BD8F6A78FF8.avi,93,1519,1147,372,32.432432432432435,morphological_dilation,3,2
0X488A8BD8F6A78FF8.avi,105,990,678,312,46.017699115044245,morphological_dilation,3,2
0X488A9E8C9FA6EB57.avi,93,3294,2750,544,19.78181818181818,morphological_dilation,3,2
0X488A9E8C9FA6EB57.avi,112,1868,1432,436,30.446927374301673,morphological_dilation,3,2
0X488B0786FF0F086A.avi,276,3383,2871,512,17.833507488679903,morphological_dilation,3,2
0X488B0786FF0F086A.avi,292,3001,2521,480,19.040063466878223,morphological_dilation,3,2
0X488B410FB47B4A07.avi,77,915,623,292,46.869983948635635,morphological_dilation,3,2
0X488B410FB47B4A07.avi,92,629,369,260,70.46070460704607,morphological_dilation,3,2
0X48905E6FBAB24E3E.avi,45,1988,1588,400,25.188916876574307,morphological_dilation,3,2
0X48905E6FBAB24E3E.avi,64,1574,1222,352,28.805237315875615,morphological_dilation,3,2
0X489167E14B9C014A.avi,36,1977,1589,388,24.417872876022656,morphological_dilation,3,2
0X489167E14B9C014A.avi,49,1682,1330,352,26.466165413533833,morphological_dilation,3,2
0X4891812FCC8C95E2.avi,40,1457,1113,344,30.90745732255166,morphological_dilation,3,2
0X4891812FCC8C95E2.avi,54,897,625,272,43.519999999999996,morphological_dilation,3,2
0X4892E16D5D95CD31.avi,37,1844,1468,376,25.61307901907357,morphological_dilation,3,2
0X4892E16D5D95CD31.avi,53,1099,799,300,37.546933667083856,morphological_dilation,3,2
0X489D45892048716E.avi,66,2727,2251,476,21.14615726343847,morphological_dilation,3,2
0X489D45892048716E.avi,86,1832,1428,404,28.291316526610643,morphological_dilation,3,2
0X489D6ED1143046F2.avi,47,1975,1575,400,25.396825396825395,morphological_dilation,3,2
0X489D6ED1143046F2.avi,67,1179,847,332,39.19716646989374,morphological_dilation,3,2
0X48A48CC20E69F8E2.avi,83,1794,1402,392,27.960057061340944,morphological_dilation,3,2
0X48A48CC20E69F8E2.avi,98,1125,809,316,39.060568603213845,morphological_dilation,3,2
0X48A4F255004328E7.avi,95,946,686,260,37.90087463556851,morphological_dilation,3,2
0X48A4F255004328E7.avi,107,626,414,212,51.20772946859904,morphological_dilation,3,2
0X48A59BC77070770F.avi,51,2047,1635,412,25.198776758409785,morphological_dilation,3,2
0X48A59BC77070770F.avi,68,1288,956,332,34.72803347280335,morphological_dilation,3,2
0X48AB3B6BB64769CF.avi,32,3398,2838,560,19.732205778717407,morphological_dilation,3,2
0X48AB3B6BB64769CF.avi,51,2039,1568,471,30.038265306122447,morphological_dilation,3,2
0X48AEC7223D38243F.avi,28,2379,1943,436,22.439526505404015,morphological_dilation,3,2
0X48AEC7223D38243F.avi,40,1992,1592,400,25.125628140703515,morphological_dilation,3,2
0X48B303AFA90A828C.avi,50,1215,911,304,33.36992316136114,morphological_dilation,3,2
0X48B303AFA90A828C.avi,71,760,512,248,48.4375,morphological_dilation,3,2
0X48B308E0C21D4B85.avi,0,1587,1239,348,28.087167070217916,morphological_dilation,3,2
0X48B308E0C21D4B85.avi,16,979,703,276,39.26031294452347,morphological_dilation,3,2
0X48B321DB37448DE9.avi,122,1508,1148,360,31.3588850174216,morphological_dilation,3,2
0X48B321DB37448DE9.avi,141,912,644,268,41.61490683229814,morphological_dilation,3,2
0X48B6FCFA36098E11.avi,66,1360,1012,348,34.387351778656125,morphological_dilation,3,2
0X48B6FCFA36098E11.avi,89,975,671,304,45.30551415797318,morphological_dilation,3,2
0X48BBF30A7546656A.avi,27,1711,1327,384,28.937452901281084,morphological_dilation,3,2
0X48BBF30A7546656A.avi,54,1133,777,356,45.81724581724582,morphological_dilation,3,2
0X48BD9C2CC57340F5.avi,46,2117,1705,412,24.164222873900293,morphological_dilation,3,2
0X48BD9C2CC57340F5.avi,61,1320,984,336,34.146341463414636,morphological_dilation,3,2
0X48BFAB6CDE750792.avi,40,2254,1803,451,25.013865779256793,morphological_dilation,3,2
0X48BFAB6CDE750792.avi,55,1454,1074,380,35.38175046554935,morphological_dilation,3,2
0X48C35748D6FE9BD.avi,32,1012,704,308,43.75,morphological_dilation,3,2
0X48C35748D6FE9BD.avi,50,655,403,252,62.531017369727046,morphological_dilation,3,2
0X48C5E7FC78E0B3C3.avi,73,3762,3214,548,17.050404480398257,morphological_dilation,3,2
0X48C5E7FC78E0B3C3.avi,90,2260,1812,448,24.724061810154527,morphological_dilation,3,2
0X48C692E19E840EB8.avi,94,1715,1359,356,26.19573215599706,morphological_dilation,3,2
0X48C692E19E840EB8.avi,115,1018,738,280,37.94037940379404,morphological_dilation,3,2
0X48C706997F5917E1.avi,97,2412,1932,480,24.84472049689441,morphological_dilation,3,2
0X48C706997F5917E1.avi,112,1260,856,404,47.19626168224299,morphological_dilation,3,2
0X48CBBF7A0777B553.avi,94,2058,1612,446,27.667493796526056,morphological_dilation,3,2
0X48CBBF7A0777B553.avi,112,1385,1021,364,35.6513222331048,morphological_dilation,3,2
0X48D0C45E9175BCE4.avi,45,1621,1257,364,28.957836117740655,morphological_dilation,3,2
0X48D0C45E9175BCE4.avi,62,938,652,286,43.86503067484663,morphological_dilation,3,2
0X48DFC126ECE35F6.avi,80,1129,801,328,40.94881398252185,morphological_dilation,3,2
0X48DFC126ECE35F6.avi,96,687,423,264,62.4113475177305,morphological_dilation,3,2
0X48E089AA482624B6.avi,35,1741,1353,388,28.6770140428677,morphological_dilation,3,2
0X48E089AA482624B6.avi,44,1071,747,324,43.373493975903614,morphological_dilation,3,2
0X48E948163E52C138.avi,132,2062,1630,432,26.50306748466258,morphological_dilation,3,2
0X48E948163E52C138.avi,144,1274,902,372,41.24168514412417,morphological_dilation,3,2
0X48E96C890A4B8718.avi,106,2775,2259,516,22.84196547144754,morphological_dilation,3,2
0X48E96C890A4B8718.avi,137,1983,1571,412,26.225334182049647,morphological_dilation,3,2
0X48ECC3432A84187D.avi,57,1795,1399,396,28.305932809149393,morphological_dilation,3,2
0X48ECC3432A84187D.avi,70,1188,852,336,39.436619718309856,morphological_dilation,3,2
0X48EE9F14AAE3EE3F.avi,108,1487,1107,380,34.32700993676603,morphological_dilation,3,2
0X48EE9F14AAE3EE3F.avi,124,906,598,308,51.50501672240802,morphological_dilation,3,2
0X48EF4B8D2F830E37.avi,81,1209,877,332,37.8563283922463,morphological_dilation,3,2
0X48EF4B8D2F830E37.avi,100,833,545,288,52.84403669724771,morphological_dilation,3,2
0X48EF57DA13FC7FB.avi,2,1842,1462,380,25.99179206566348,morphological_dilation,3,2
0X48EF57DA13FC7FB.avi,18,1152,844,308,36.492890995260666,morphological_dilation,3,2
0X48F44CF772604CB1.avi,60,1653,1293,360,27.842227378190255,morphological_dilation,3,2
0X48F44CF772604CB1.avi,74,1084,767,317,41.329856584093875,morphological_dilation,3,2
0X48F785ADBEE3A124.avi,57,2135,1735,400,23.054755043227665,morphological_dilation,3,2
0X48F785ADBEE3A124.avi,73,1659,1307,352,26.931905126243304,morphological_dilation,3,2
0X48FB28BF9BD812DE.avi,54,1427,1083,344,31.763619575253927,morphological_dilation,3,2
0X48FB28BF9BD812DE.avi,69,956,668,288,43.11377245508982,morphological_dilation,3,2
0X48FDAE89721A2522.avi,45,1732,1344,388,28.869047619047617,morphological_dilation,3,2
0X48FDAE89721A2522.avi,63,1260,908,352,38.76651982378855,morphological_dilation,3,2
0X48FEAA4071907A5F.avi,59,2553,2109,444,21.052631578947366,morphological_dilation,3,2
0X48FEAA4071907A5F.avi,78,2082,1684,398,23.634204275534444,morphological_dilation,3,2
0X490155F11EF9C102.avi,140,1740,1352,388,28.698224852071007,morphological_dilation,3,2
0X490155F11EF9C102.avi,155,1531,1175,356,30.29787234042553,morphological_dilation,3,2
0X490212526E6630EF.avi,3,1319,987,332,33.63728470111449,morphological_dilation,3,2
0X490212526E6630EF.avi,16,856,580,276,47.58620689655172,morphological_dilation,3,2
0X49055E259A033164.avi,43,1980,1580,400,25.31645569620253,morphological_dilation,3,2
0X49055E259A033164.avi,64,1282,954,328,34.38155136268344,morphological_dilation,3,2
0X490D0EA790DF7EE.avi,61,1756,1380,376,27.246376811594203,morphological_dilation,3,2
0X490D0EA790DF7EE.avi,75,1131,831,300,36.101083032490976,morphological_dilation,3,2
0X490FC9C6C17960BD.avi,49,1916,1524,392,25.72178477690289,morphological_dilation,3,2
0X490FC9C6C17960BD.avi,69,1210,882,328,37.188208616780045,morphological_dilation,3,2
0X49110DEED5E41E90.avi,39,2484,2008,476,23.705179282868528,morphological_dilation,3,2
0X49110DEED5E41E90.avi,55,1635,1221,414,33.90663390663391,morphological_dilation,3,2
0X491140370364F803.avi,55,1859,1475,384,26.033898305084747,morphological_dilation,3,2
0X491140370364F803.avi,64,1111,795,316,39.74842767295598,morphological_dilation,3,2
0X491631C533031846.avi,52,1798,1394,404,28.98134863701578,morphological_dilation,3,2
0X491631C533031846.avi,69,1224,872,352,40.36697247706422,morphological_dilation,3,2
0X4917A8741F962DC4.avi,48,2013,1591,422,26.524198617221874,morphological_dilation,3,2
0X4917A8741F962DC4.avi,68,1389,1020,369,36.17647058823529,morphological_dilation,3,2
0X4918DDB4B3AE8FC7.avi,50,2900,2368,532,22.466216216216218,morphological_dilation,3,2
0X4918DDB4B3AE8FC7.avi,68,2158,1706,452,26.494724501758498,morphological_dilation,3,2
0X49215CF6782C83B3.avi,38,2781,2309,472,20.441749675184063,morphological_dilation,3,2
0X49215CF6782C83B3.avi,55,1816,1424,392,27.52808988764045,morphological_dilation,3,2
0X49219BA9202C833A.avi,60,1920,1532,388,25.326370757180154,morphological_dilation,3,2
0X49219BA9202C833A.avi,76,1156,840,316,37.61904761904762,morphological_dilation,3,2
0X4922C566511C69B.avi,59,1590,1234,356,28.84927066450567,morphological_dilation,3,2
0X4922C566511C69B.avi,79,1003,711,292,41.068917018284104,morphological_dilation,3,2
0X49258D5237927836.avi,36,1815,1415,400,28.26855123674912,morphological_dilation,3,2
0X49258D5237927836.avi,46,1081,741,340,45.883940620782724,morphological_dilation,3,2
0X492686F58624C49.avi,93,1752,1364,388,28.445747800586513,morphological_dilation,3,2
0X492686F58624C49.avi,110,1084,756,328,43.386243386243386,morphological_dilation,3,2
0X492B188B388D9C73.avi,43,1229,921,308,33.441910966340934,morphological_dilation,3,2
0X492B188B388D9C73.avi,55,754,506,248,49.01185770750988,morphological_dilation,3,2
0X492F0DE600BCCCF6.avi,37,2293,1845,448,24.281842818428185,morphological_dilation,3,2
0X492F0DE600BCCCF6.avi,54,1705,1313,392,29.855293221629854,morphological_dilation,3,2
0X49326C4925025FBA.avi,43,1709,1339,370,27.632561613144134,morphological_dilation,3,2
0X49326C4925025FBA.avi,58,1293,957,336,35.10971786833856,morphological_dilation,3,2
0X4932FA4F98E5A311.avi,0,1758,1402,356,25.392296718972894,morphological_dilation,3,2
0X4932FA4F98E5A311.avi,22,1151,859,292,33.993015133876604,morphological_dilation,3,2
0X4937270C8599D8E3.avi,114,1885,1489,396,26.595030221625255,morphological_dilation,3,2
0X4937270C8599D8E3.avi,132,1130,810,320,39.50617283950617,morphological_dilation,3,2
0X493771B14EDCFD4E.avi,54,1985,1577,408,25.8719086873811,morphological_dilation,3,2
0X493771B14EDCFD4E.avi,72,1265,909,356,39.16391639163916,morphological_dilation,3,2
0X4937A3E14F356EA8.avi,158,1909,1493,416,27.863362357669125,morphological_dilation,3,2
0X4937A3E14F356EA8.avi,175,1212,864,348,40.27777777777778,morphological_dilation,3,2
0X4937EFDC69F9E448.avi,72,1808,1412,396,28.04532577903683,morphological_dilation,3,2
0X4937EFDC69F9E448.avi,87,1121,794,327,41.183879093198996,morphological_dilation,3,2
0X49390CABDE34F630.avi,59,2720,2232,488,21.863799283154123,morphological_dilation,3,2
0X49390CABDE34F630.avi,81,1673,1275,398,31.215686274509803,morphological_dilation,3,2
0X493E34208D40DBB5.avi,91,1289,949,340,35.82718651211802,morphological_dilation,3,2
0X493E34208D40DBB5.avi,101,1003,693,310,44.733044733044736,morphological_dilation,3,2
0X493FECF89E87F1D0.avi,55,1374,1050,324,30.857142857142854,morphological_dilation,3,2
0X493FECF89E87F1D0.avi,75,885,621,264,42.51207729468599,morphological_dilation,3,2
0X4941EC81FA24A165.avi,50,1501,1133,368,32.4801412180053,morphological_dilation,3,2
0X4941EC81FA24A165.avi,64,837,545,292,53.57798165137615,morphological_dilation,3,2
0X49422B590F116D76.avi,31,1262,954,308,32.28511530398323,morphological_dilation,3,2
0X49422B590F116D76.avi,42,878,608,270,44.40789473684211,morphological_dilation,3,2
0X49469A3E124DF90E.avi,41,1610,1246,364,29.213483146067414,morphological_dilation,3,2
0X49469A3E124DF90E.avi,64,1211,891,320,35.91470258136925,morphological_dilation,3,2
0X49493213513922AB.avi,89,1608,1240,368,29.677419354838708,morphological_dilation,3,2
0X49493213513922AB.avi,102,1030,718,312,43.45403899721448,morphological_dilation,3,2
0X49494A45C6E49E0A.avi,0,2925,2414,511,21.16818558409279,morphological_dilation,3,2
0X49494A45C6E49E0A.avi,18,1704,1288,416,32.298136645962735,morphological_dilation,3,2
0X49551699F203E3F.avi,96,1674,1278,396,30.985915492957744,morphological_dilation,3,2
0X49551699F203E3F.avi,113,964,637,327,51.33437990580848,morphological_dilation,3,2
0X495E462D0A659507.avi,55,1485,1131,354,31.29973474801061,morphological_dilation,3,2
0X495E462D0A659507.avi,74,912,624,288,46.15384615384615,morphological_dilation,3,2
0X496081D42911B9B3.avi,57,1753,1371,382,27.862873814733767,morphological_dilation,3,2
0X496081D42911B9B3.avi,72,1426,1073,353,32.898415657036345,morphological_dilation,3,2
0X4961E7D210D25ED8.avi,2,1321,993,328,33.03121852970796,morphological_dilation,3,2
0X4961E7D210D25ED8.avi,15,771,511,260,50.88062622309197,morphological_dilation,3,2
0X49620F7B3E4CA28A.avi,61,1402,939,463,49.30777422790202,morphological_dilation,3,2
0X49620F7B3E4CA28A.avi,65,929,629,300,47.69475357710652,morphological_dilation,3,2
0X49644314B8335790.avi,52,2844,2328,516,22.164948453608247,morphological_dilation,3,2
0X49644314B8335790.avi,70,2236,1768,468,26.47058823529412,morphological_dilation,3,2
0X49678CDE9243313E.avi,79,1780,1392,388,27.873563218390807,morphological_dilation,3,2
0X49678CDE9243313E.avi,93,1256,932,324,34.763948497854074,morphological_dilation,3,2
0X496A6570C645044C.avi,44,1968,1564,404,25.831202046035806,morphological_dilation,3,2
0X496A6570C645044C.avi,63,1192,864,328,37.96296296296296,morphological_dilation,3,2
0X496C4F738B83C8FB.avi,48,1475,1139,336,29.499561018437227,morphological_dilation,3,2
0X496C4F738B83C8FB.avi,58,974,670,304,45.37313432835821,morphological_dilation,3,2
0X4970B5821D88BFCC.avi,75,1021,696,325,46.695402298850574,morphological_dilation,3,2
0X4970B5821D88BFCC.avi,89,631,367,264,71.93460490463215,morphological_dilation,3,2
0X4975C1A2007A07F5.avi,45,1681,1321,360,27.252081756245268,morphological_dilation,3,2
0X4975C1A2007A07F5.avi,63,1151,835,316,37.84431137724551,morphological_dilation,3,2
0X4977ADFA42FCC6F2.avi,82,2535,2075,460,22.16867469879518,morphological_dilation,3,2
0X4977ADFA42FCC6F2.avi,102,1740,1316,424,32.21884498480243,morphological_dilation,3,2
0X4979A9E814D3706E.avi,49,1534,1174,360,30.664395229982965,morphological_dilation,3,2
0X4979A9E814D3706E.avi,64,990,678,312,46.017699115044245,morphological_dilation,3,2
0X497E354B515F4FE.avi,100,896,637,259,40.65934065934066,morphological_dilation,3,2
0X497E354B515F4FE.avi,110,745,517,228,44.10058027079304,morphological_dilation,3,2
0X497E9DBC82C3D62C.avi,50,1243,915,328,35.84699453551913,morphological_dilation,3,2
0X497E9DBC82C3D62C.avi,65,762,502,260,51.79282868525896,morphological_dilation,3,2
0X49801A85ABE0FDEE.avi,40,2570,2110,460,21.80094786729858,morphological_dilation,3,2
0X49801A85ABE0FDEE.avi,66,2102,1678,424,25.26817640047676,morphological_dilation,3,2
0X4980924D1EFF7026.avi,80,1488,1132,356,31.448763250883395,morphological_dilation,3,2
0X4980924D1EFF7026.avi,90,942,635,307,48.346456692913385,morphological_dilation,3,2
0X4981E927C1497B77.avi,47,2275,1847,428,23.17271250676773,morphological_dilation,3,2
0X4981E927C1497B77.avi,65,1320,984,336,34.146341463414636,morphological_dilation,3,2
0X4984EEE2795FCC18.avi,71,3145,2601,544,20.915032679738562,morphological_dilation,3,2
0X4984EEE2795FCC18.avi,85,2205,1737,468,26.94300518134715,morphological_dilation,3,2
0X49852F59C8BEB29B.avi,62,1594,1238,356,28.75605815831987,morphological_dilation,3,2
0X49852F59C8BEB29B.avi,78,1263,923,340,36.83640303358614,morphological_dilation,3,2
0X498E73266178CB27.avi,74,2007,1595,412,25.830721003134798,morphological_dilation,3,2
0X498E73266178CB27.avi,94,1237,905,332,36.68508287292818,morphological_dilation,3,2
0X498F356AD182EFAA.avi,59,1580,1236,344,27.831715210355988,morphological_dilation,3,2
0X498F356AD182EFAA.avi,75,972,674,298,44.21364985163205,morphological_dilation,3,2
0X499747D399335BDA.avi,92,1525,1145,380,33.18777292576419,morphological_dilation,3,2
0X499747D399335BDA.avi,110,1017,673,344,51.114413075780085,morphological_dilation,3,2
0X499BA59C531FFB3D.avi,42,1702,1310,392,29.923664122137406,morphological_dilation,3,2
0X499BA59C531FFB3D.avi,58,1078,754,324,42.97082228116711,morphological_dilation,3,2
0X499DF9F90F827205.avi,48,2767,2273,494,21.733391992960847,morphological_dilation,3,2
0X499DF9F90F827205.avi,69,1530,1127,403,35.7586512866016,morphological_dilation,3,2
0X49A0A8D281B8EA27.avi,46,1571,1211,360,29.72749793559042,morphological_dilation,3,2
0X49A0A8D281B8EA27.avi,61,1055,747,308,41.231593038821956,morphological_dilation,3,2
0X49A2D5E5E1DAB5D0.avi,42,3069,2545,524,20.589390962671906,morphological_dilation,3,2
0X49A2D5E5E1DAB5D0.avi,50,1873,1441,432,29.979181124219288,morphological_dilation,3,2
0X49AA5AE78CD7E71F.avi,40,1469,1141,328,28.7467134092901,morphological_dilation,3,2
0X49AA5AE78CD7E71F.avi,50,1159,843,316,37.48517200474496,morphological_dilation,3,2
0X49ACC5C1965C1584.avi,77,3118,2626,492,18.735719725818736,morphological_dilation,3,2
0X49ACC5C1965C1584.avi,93,1834,1442,392,27.184466019417474,morphological_dilation,3,2
0X49B0D943B9388FB6.avi,45,3000,2492,508,20.38523274478331,morphological_dilation,3,2
0X49B0D943B9388FB6.avi,62,2221,1773,448,25.267907501410043,morphological_dilation,3,2
0X49B360CA6BB04B97.avi,78,1858,1447,411,28.403593642017967,morphological_dilation,3,2
0X49B360CA6BB04B97.avi,94,1201,849,352,41.46054181389871,morphological_dilation,3,2
0X49B7A10D057F78CC.avi,42,1619,1235,384,31.093117408906885,morphological_dilation,3,2
0X49B7A10D057F78CC.avi,57,912,612,300,49.01960784313725,morphological_dilation,3,2
0X49B7DDE85ED0816F.avi,2,1910,1510,400,26.490066225165563,morphological_dilation,3,2
0X49B7DDE85ED0816F.avi,15,1283,943,340,36.05514316012725,morphological_dilation,3,2
0X49BA35AEA9408653.avi,31,1917,1533,384,25.048923679060664,morphological_dilation,3,2
0X49BA35AEA9408653.avi,50,1647,1295,352,27.181467181467184,morphological_dilation,3,2
0X49BD5FBFC1A1E10A.avi,66,1558,1174,384,32.70868824531516,morphological_dilation,3,2
0X49BD5FBFC1A1E10A.avi,82,1291,939,352,37.48668796592119,morphological_dilation,3,2
0X49BDFC05CEC434.avi,77,1635,1279,356,27.834245504300238,morphological_dilation,3,2
0X49BDFC05CEC434.avi,90,986,710,276,38.87323943661972,morphological_dilation,3,2
0X49BE2A3124C97300.avi,36,1112,812,300,36.94581280788177,morphological_dilation,3,2
0X49BE2A3124C97300.avi,49,783,527,256,48.57685009487666,morphological_dilation,3,2
0X49BF970124381C81.avi,1,2525,2057,468,22.75157997083131,morphological_dilation,3,2
0X49BF970124381C81.avi,21,1528,1156,372,32.17993079584775,morphological_dilation,3,2
0X49C36B1EE9B8899C.avi,43,2564,2088,476,22.796934865900383,morphological_dilation,3,2
0X49C36B1EE9B8899C.avi,64,2221,1789,432,24.147568474007823,morphological_dilation,3,2
0X49C3F8C98AD65DEF.avi,124,1680,1300,380,29.230769230769234,morphological_dilation,3,2
0X49C3F8C98AD65DEF.avi,138,963,675,288,42.66666666666667,morphological_dilation,3,2
0X49C47E44816223A9.avi,74,1480,1132,348,30.742049469964666,morphological_dilation,3,2
0X49C47E44816223A9.avi,88,967,675,292,43.25925925925926,morphological_dilation,3,2
0X49C62C647514D46A.avi,50,2041,1633,408,24.98469075321494,morphological_dilation,3,2
0X49C62C647514D46A.avi,63,1481,1133,348,30.71491615180936,morphological_dilation,3,2
0X49C65367B00E4D2A.avi,105,1829,1437,392,27.279053583855255,morphological_dilation,3,2
0X49C65367B00E4D2A.avi,122,1102,754,348,46.15384615384615,morphological_dilation,3,2
0X49C74443F2369C33.avi,36,1625,1247,378,30.312750601443465,morphological_dilation,3,2
0X49C74443F2369C33.avi,50,1073,760,313,41.18421052631579,morphological_dilation,3,2
0X49CAA8810D3D80CD.avi,52,3908,3356,552,16.448152562574496,morphological_dilation,3,2
0X49CAA8810D3D80CD.avi,69,3392,2876,516,17.941585535465926,morphological_dilation,3,2
0X49CE160322B691A7.avi,81,1438,1102,336,30.490018148820326,morphological_dilation,3,2
0X49CE160322B691A7.avi,98,875,603,272,45.107794361525706,morphological_dilation,3,2
0X49CEF0778309C672.avi,117,1619,1223,396,32.379394930498776,morphological_dilation,3,2
0X49CEF0778309C672.avi,136,952,640,312,48.75,morphological_dilation,3,2
0X49D808E62B917785.avi,112,1766,1402,364,25.962910128388017,morphological_dilation,3,2
0X49D808E62B917785.avi,134,1262,938,324,34.54157782515991,morphological_dilation,3,2
0X49DBF6C7D320DBB9.avi,94,1413,1046,367,35.08604206500956,morphological_dilation,3,2
0X49DBF6C7D320DBB9.avi,120,934,598,336,56.187290969899664,morphological_dilation,3,2
0X49E1293560BCBC12.avi,3,3112,2600,512,19.692307692307693,morphological_dilation,3,2
0X49E1293560BCBC12.avi,23,1952,1524,428,28.083989501312335,morphological_dilation,3,2
0X49E22F656F26A6EB.avi,48,1855,1487,368,24.747814391392065,morphological_dilation,3,2
0X49E22F656F26A6EB.avi,62,1124,824,300,36.407766990291265,morphological_dilation,3,2
0X49EC1927F5747B19.avi,107,1541,1181,360,30.482641828958513,morphological_dilation,3,2
0X49EC1927F5747B19.avi,110,2202,1618,584,36.093943139678615,morphological_dilation,3,2
0X49EC1EFA6775E370.avi,66,1562,1186,376,31.703204047217536,morphological_dilation,3,2
0X49EC1EFA6775E370.avi,79,1102,778,324,41.645244215938305,morphological_dilation,3,2
0X49EC98DBE77F6C94.avi,116,2225,1797,428,23.817473567056204,morphological_dilation,3,2
0X49EC98DBE77F6C94.avi,134,1414,1062,352,33.14500941619586,morphological_dilation,3,2
0X49EDDBE4F26EB4E9.avi,71,548,340,208,61.1764705882353,morphological_dilation,3,2
0X49EDDBE4F26EB4E9.avi,128,1043,755,288,38.145695364238414,morphological_dilation,3,2
0X49F240B6D6F355F.avi,30,1210,890,320,35.95505617977528,morphological_dilation,3,2
0X49F240B6D6F355F.avi,43,963,679,284,41.82621502209131,morphological_dilation,3,2
0X49F9930439F79E9A.avi,55,1835,1459,376,25.77107607950651,morphological_dilation,3,2
0X49F9930439F79E9A.avi,82,1431,1083,348,32.13296398891966,morphological_dilation,3,2
0X49FD1A0005AA0D07.avi,148,2320,1880,440,23.404255319148938,morphological_dilation,3,2
0X49FD1A0005AA0D07.avi,177,1303,971,332,34.19155509783728,morphological_dilation,3,2
0X4A02A8CE52565FB9.avi,43,925,649,276,42.526964560862865,morphological_dilation,3,2
0X4A02A8CE52565FB9.avi,56,632,388,244,62.88659793814433,morphological_dilation,3,2
0X4A063C378FE634E1.avi,128,1430,1066,364,34.146341463414636,morphological_dilation,3,2
0X4A063C378FE634E1.avi,145,901,613,288,46.98205546492659,morphological_dilation,3,2
0X4A0B8B249A18FC1C.avi,68,2345,1913,432,22.582331416623106,morphological_dilation,3,2
0X4A0B8B249A18FC1C.avi,88,1536,1172,364,31.058020477815703,morphological_dilation,3,2
0X4A0C7C0FE8253F6E.avi,120,1939,1540,399,25.90909090909091,morphological_dilation,3,2
0X4A0C7C0FE8253F6E.avi,141,1352,1010,342,33.86138613861387,morphological_dilation,3,2
0X4A0CD8CE170B824A.avi,34,1219,915,304,33.224043715846996,morphological_dilation,3,2
0X4A0CD8CE170B824A.avi,52,1072,784,288,36.734693877551024,morphological_dilation,3,2
0X4A0E87C1BB42B16D.avi,90,2047,1639,408,24.893227577791336,morphological_dilation,3,2
0X4A0E87C1BB42B16D.avi,108,1404,1068,336,31.46067415730337,morphological_dilation,3,2
0X4A0E967B4D0C7A71.avi,57,2023,1619,404,24.953675108091414,morphological_dilation,3,2
0X4A0E967B4D0C7A71.avi,70,1254,922,332,36.00867678958785,morphological_dilation,3,2
0X4A11C148E80CABDE.avi,32,788,530,258,48.679245283018865,morphological_dilation,3,2
0X4A11C148E80CABDE.avi,52,469,281,188,66.90391459074732,morphological_dilation,3,2
0X4A120EA254F8C48B.avi,131,2195,1751,444,25.35693889206168,morphological_dilation,3,2
0X4A120EA254F8C48B.avi,145,1222,870,352,40.45977011494253,morphological_dilation,3,2
0X4A121E9371A35313.avi,55,1935,1499,436,29.086057371581052,morphological_dilation,3,2
0X4A121E9371A35313.avi,67,1506,1123,383,34.10507569011576,morphological_dilation,3,2
0X4A134402A0DA7805.avi,73,1320,996,324,32.53012048192771,morphological_dilation,3,2
0X4A134402A0DA7805.avi,89,944,666,278,41.74174174174174,morphological_dilation,3,2
0X4A18018C9EB31709.avi,48,1502,1142,360,31.523642732049034,morphological_dilation,3,2
0X4A18018C9EB31709.avi,64,1140,798,342,42.857142857142854,morphological_dilation,3,2
0X4A1A9413B0697A3D.avi,129,2029,1633,396,24.24984690753215,morphological_dilation,3,2
0X4A1A9413B0697A3D.avi,149,1030,734,296,40.32697547683924,morphological_dilation,3,2
0X4A1E66BA1F5A32CB.avi,54,2803,2327,476,20.455522131499784,morphological_dilation,3,2
0X4A1E66BA1F5A32CB.avi,67,2207,1787,420,23.503077783995526,morphological_dilation,3,2
0X4A2A840A571C7468.avi,83,1883,1493,390,26.1219022103148,morphological_dilation,3,2
0X4A2A840A571C7468.avi,99,1200,884,316,35.74660633484163,morphological_dilation,3,2
0X4A2C2049EAB5E378.avi,1,2032,1584,448,28.28282828282828,morphological_dilation,3,2
0X4A2C2049EAB5E378.avi,19,1270,922,348,37.744034707158356,morphological_dilation,3,2
0X4A2D1333CC39F29B.avi,120,3044,2548,496,19.46624803767661,morphological_dilation,3,2
0X4A2D1333CC39F29B.avi,135,1811,1399,412,29.44960686204432,morphological_dilation,3,2
0X4A31252226254DF.avi,40,2116,1672,444,26.555023923444978,morphological_dilation,3,2
0X4A31252226254DF.avi,51,1342,962,380,39.5010395010395,morphological_dilation,3,2
0X4A317939C584CC0D.avi,57,1660,1268,392,30.914826498422716,morphological_dilation,3,2
0X4A317939C584CC0D.avi,72,1085,746,339,45.44235924932976,morphological_dilation,3,2
0X4A3198A53976E7B3.avi,33,1692,1320,372,28.18181818181818,morphological_dilation,3,2
0X4A3198A53976E7B3.avi,48,1162,858,304,35.43123543123543,morphological_dilation,3,2
0X4A33F1C96141477.avi,51,1717,1346,371,27.563150074294207,morphological_dilation,3,2
0X4A33F1C96141477.avi,69,1108,784,324,41.3265306122449,morphological_dilation,3,2
0X4A35EEBF2751AE5C.avi,52,1632,1264,368,29.11392405063291,morphological_dilation,3,2
0X4A35EEBF2751AE5C.avi,70,1024,716,308,43.01675977653631,morphological_dilation,3,2
0X4A3623EE62D009F0.avi,57,1601,1249,352,28.182546036829464,morphological_dilation,3,2
0X4A3623EE62D009F0.avi,75,980,704,276,39.20454545454545,morphological_dilation,3,2
0X4A3A43D8373D9CB2.avi,85,1801,1421,380,26.74173117522871,morphological_dilation,3,2
0X4A3A43D8373D9CB2.avi,102,1468,1122,346,30.83778966131907,morphological_dilation,3,2
0X4A4190933DB9D3F2.avi,47,1679,1307,372,28.46212700841622,morphological_dilation,3,2
0X4A4190933DB9D3F2.avi,65,1138,838,300,35.79952267303103,morphological_dilation,3,2
0X4A423F4A126B0CC0.avi,81,1253,933,320,34.29796355841372,morphological_dilation,3,2
0X4A423F4A126B0CC0.avi,97,883,607,276,45.46952224052718,morphological_dilation,3,2
0X4A497C867371D86.avi,154,1611,1231,380,30.869212022745735,morphological_dilation,3,2
0X4A497C867371D86.avi,170,1009,705,304,43.12056737588652,morphological_dilation,3,2
0X4A49AE73D48ED549.avi,2,2028,1620,408,25.185185185185183,morphological_dilation,3,2
0X4A49AE73D48ED549.avi,17,1557,1209,348,28.78411910669975,morphological_dilation,3,2
0X4A4BAD2CF6E771EF.avi,101,2166,1706,460,26.963657678780773,morphological_dilation,3,2
0X4A4BAD2CF6E771EF.avi,114,1324,928,396,42.672413793103445,morphological_dilation,3,2
0X4A4F385A385C35E8.avi,65,1879,1479,400,27.045300878972277,morphological_dilation,3,2
0X4A4F385A385C35E8.avi,78,1230,898,332,36.97104677060133,morphological_dilation,3,2
0X4A50992FC6CE05CB.avi,149,1899,1507,392,26.011944260119442,morphological_dilation,3,2
0X4A50992FC6CE05CB.avi,167,1071,751,320,42.60985352862849,morphological_dilation,3,2
0X4A51D81E85B39997.avi,0,2402,1970,432,21.928934010152286,morphological_dilation,3,2
0X4A51D81E85B39997.avi,14,1955,1567,388,24.760689215060623,morphological_dilation,3,2
0X4A59A40F68222623.avi,44,1855,1463,392,26.794258373205743,morphological_dilation,3,2
0X4A59A40F68222623.avi,58,1211,883,328,37.14609286523216,morphological_dilation,3,2
0X4A59BE63FB51A4C4.avi,48,1715,1339,376,28.0806572068708,morphological_dilation,3,2
0X4A59BE63FB51A4C4.avi,65,1242,922,320,34.70715835140998,morphological_dilation,3,2
0X4A5B9DD5E6B03105.avi,70,3101,2541,560,22.03856749311295,morphological_dilation,3,2
0X4A5B9DD5E6B03105.avi,90,1834,1383,451,32.610267534345624,morphological_dilation,3,2
0X4A5C8A696DE2C287.avi,123,2372,1920,452,23.541666666666668,morphological_dilation,3,2
0X4A5C8A696DE2C287.avi,137,1458,1090,368,33.76146788990826,morphological_dilation,3,2
0X4A6184500426A482.avi,113,1856,1453,403,27.735719201651754,morphological_dilation,3,2
0X4A6184500426A482.avi,135,1179,851,328,38.54289071680376,morphological_dilation,3,2
0X4A6300E2E21BB965.avi,42,2314,1882,432,22.954303931987248,morphological_dilation,3,2
0X4A6300E2E21BB965.avi,58,1424,1088,336,30.88235294117647,morphological_dilation,3,2
0X4A6673C3B23FE5D4.avi,64,1779,1384,395,28.540462427745666,morphological_dilation,3,2
0X4A6673C3B23FE5D4.avi,82,1110,798,312,39.097744360902254,morphological_dilation,3,2
0X4A66A42C88E9C43E.avi,132,2105,1685,420,24.92581602373887,morphological_dilation,3,2
0X4A66A42C88E9C43E.avi,155,1255,907,348,38.36824696802646,morphological_dilation,3,2
0X4A67C7061D12E437.avi,121,1336,1008,328,32.53968253968254,morphological_dilation,3,2
0X4A67C7061D12E437.avi,139,1134,838,296,35.32219570405728,morphological_dilation,3,2
0X4A6B1963809D914F.avi,0,1766,1382,384,27.785817655571638,morphological_dilation,3,2
0X4A6B1963809D914F.avi,15,910,610,300,49.18032786885246,morphological_dilation,3,2
0X4A6B7B77F43D03BF.avi,42,1256,897,359,40.022296544035676,morphological_dilation,3,2
0X4A6B7B77F43D03BF.avi,59,1033,709,324,45.6981664315938,morphological_dilation,3,2
0X4A74EC6C63124A3D.avi,83,1512,1156,356,30.79584775086505,morphological_dilation,3,2
0X4A74EC6C63124A3D.avi,102,971,679,292,43.004418262150224,morphological_dilation,3,2
0X4A792B82556BDA0A.avi,50,1464,1088,376,34.55882352941176,morphological_dilation,3,2
0X4A792B82556BDA0A.avi,69,888,581,307,52.83993115318416,morphological_dilation,3,2
0X4A79886D8A617331.avi,47,2370,1914,456,23.824451410658305,morphological_dilation,3,2
0X4A79886D8A617331.avi,65,1345,997,348,34.90471414242728,morphological_dilation,3,2
0X4A7A08B4859C2466.avi,85,2018,1614,404,25.03097893432466,morphological_dilation,3,2
0X4A7A08B4859C2466.avi,108,1731,1351,380,28.127313101406365,morphological_dilation,3,2
0X4A7A4FAAE293863A.avi,49,1047,755,292,38.675496688741724,morphological_dilation,3,2
0X4A7A4FAAE293863A.avi,62,670,438,232,52.96803652968036,morphological_dilation,3,2
0X4A82F51E7B0BD0B3.avi,55,2025,1605,420,26.168224299065418,morphological_dilation,3,2
0X4A82F51E7B0BD0B3.avi,70,1194,866,328,37.87528868360277,morphological_dilation,3,2
0X4A86772242CB975.avi,30,1466,1134,332,29.276895943562607,morphological_dilation,3,2
0X4A86772242CB975.avi,43,1303,983,320,32.55340793489319,morphological_dilation,3,2
0X4A86B3D9A1460493.avi,53,1510,1130,380,33.6283185840708,morphological_dilation,3,2
0X4A86B3D9A1460493.avi,72,901,605,296,48.925619834710744,morphological_dilation,3,2
0X4A8AD1EA88C671DE.avi,78,1248,910,338,37.142857142857146,morphological_dilation,3,2
0X4A8AD1EA88C671DE.avi,92,1772,1388,384,27.6657060518732,morphological_dilation,3,2
0X4A8BD43F7D5D5A1D.avi,37,1173,877,296,33.75142531356899,morphological_dilation,3,2
0X4A8BD43F7D5D5A1D.avi,51,708,468,240,51.28205128205128,morphological_dilation,3,2
0X4A8E2CDD51954420.avi,50,4456,3860,596,15.44041450777202,morphological_dilation,3,2
0X4A8E2CDD51954420.avi,74,3847,3299,548,16.61109427099121,morphological_dilation,3,2
0X4A8E3E2FB03F2A52.avi,87,1783,1411,372,26.364280652019843,morphological_dilation,3,2
0X4A8E3E2FB03F2A52.avi,103,1099,781,318,40.71702944942381,morphological_dilation,3,2
0X4A90CC99C48AC524.avi,58,1170,862,308,35.730858468677496,morphological_dilation,3,2
0X4A90CC99C48AC524.avi,68,802,538,264,49.07063197026022,morphological_dilation,3,2
0X4A922ED4E6FD062E.avi,106,1684,1328,356,26.80722891566265,morphological_dilation,3,2
0X4A922ED4E6FD062E.avi,128,994,702,292,41.5954415954416,morphological_dilation,3,2
0X4A94E80ECE238D5D.avi,32,1819,1427,392,27.470217238962856,morphological_dilation,3,2
0X4A94E80ECE238D5D.avi,43,1087,775,312,40.25806451612903,morphological_dilation,3,2
0X4AAB5FF288E161A4.avi,89,2545,2077,468,22.532498796340878,morphological_dilation,3,2
0X4AAB5FF288E161A4.avi,112,1579,1207,372,30.820215410107703,morphological_dilation,3,2
0X4AAB72A545D59B3C.avi,220,1334,1014,320,31.558185404339252,morphological_dilation,3,2
0X4AAB72A545D59B3C.avi,235,802,540,262,48.51851851851852,morphological_dilation,3,2
0X4AAE1006E3BED4E3.avi,39,2210,1794,416,23.18840579710145,morphological_dilation,3,2
0X4AAE1006E3BED4E3.avi,52,1417,1065,352,33.051643192488264,morphological_dilation,3,2
0X4AB5A5C9DDFB0619.avi,95,1932,1540,392,25.454545454545453,morphological_dilation,3,2
0X4AB5A5C9DDFB0619.avi,115,1136,816,320,39.21568627450981,morphological_dilation,3,2
0X4AB6898CED6FCBF7.avi,38,1409,1077,332,30.8263695450325,morphological_dilation,3,2
0X4AB6898CED6FCBF7.avi,54,853,565,288,50.97345132743363,morphological_dilation,3,2
0X4AB89A6D9C9B4EAC.avi,50,2528,2045,483,23.618581907090462,morphological_dilation,3,2
0X4AB89A6D9C9B4EAC.avi,65,2141,1693,448,26.4619019492026,morphological_dilation,3,2
0X4AB98BB972E5ACEB.avi,89,1534,1166,368,31.56089193825043,morphological_dilation,3,2
0X4AB98BB972E5ACEB.avi,107,935,636,299,47.0125786163522,morphological_dilation,3,2
0X4ABB170F5E95C0A0.avi,42,1444,1060,384,36.22641509433962,morphological_dilation,3,2
0X4ABB170F5E95C0A0.avi,52,941,613,328,53.507340946166394,morphological_dilation,3,2
0X4ABC1176D3D625B4.avi,43,1938,1546,392,25.35575679172057,morphological_dilation,3,2
0X4ABC1176D3D625B4.avi,62,1232,912,320,35.08771929824561,morphological_dilation,3,2
0X4AC474B089EFC824.avi,93,1744,1364,380,27.859237536656888,morphological_dilation,3,2
0X4AC474B089EFC824.avi,110,1087,783,304,38.8250319284802,morphological_dilation,3,2
0X4AC8A1036351CD7A.avi,100,1917,1529,388,25.376062786134728,morphological_dilation,3,2
0X4AC8A1036351CD7A.avi,119,1379,1020,359,35.19607843137255,morphological_dilation,3,2
0X4ACCB4F9F816D5E9.avi,4,1100,812,288,35.467980295566505,morphological_dilation,3,2
0X4ACCB4F9F816D5E9.avi,22,807,558,249,44.623655913978496,morphological_dilation,3,2
0X4AD47C3103D9FD6D.avi,55,5236,4572,664,14.52318460192476,morphological_dilation,3,2
0X4AD47C3103D9FD6D.avi,75,2959,2423,536,22.12133718530747,morphological_dilation,3,2
0X4AD48990409BEA7F.avi,49,1276,948,328,34.59915611814346,morphological_dilation,3,2
0X4AD48990409BEA7F.avi,68,794,534,260,48.68913857677903,morphological_dilation,3,2
0X4AD5767864F972AF.avi,43,2161,1749,412,23.556317895940538,morphological_dilation,3,2
0X4AD5767864F972AF.avi,59,1375,1035,340,32.850241545893724,morphological_dilation,3,2
0X4AE10D9EF94811BA.avi,2,1840,1462,378,25.85499316005472,morphological_dilation,3,2
0X4AE10D9EF94811BA.avi,17,1539,1195,344,28.78661087866109,morphological_dilation,3,2
0X4AE13510C2FEE40E.avi,39,904,594,310,52.18855218855219,morphological_dilation,3,2
0X4AE13510C2FEE40E.avi,50,747,479,268,55.94989561586638,morphological_dilation,3,2
0X4AE44D9414344C78.avi,37,1505,1153,352,30.529054640069386,morphological_dilation,3,2
0X4AE44D9414344C78.avi,55,1011,691,320,46.30969609261939,morphological_dilation,3,2
0X4AE4981D62FD4A2F.avi,104,1440,1075,365,33.95348837209302,morphological_dilation,3,2
0X4AE4981D62FD4A2F.avi,126,904,604,300,49.668874172185426,morphological_dilation,3,2
0X4AE79DABBD8D1F6D.avi,49,1667,1283,384,29.929851909586908,morphological_dilation,3,2
0X4AE79DABBD8D1F6D.avi,66,1101,774,327,42.248062015503876,morphological_dilation,3,2
0X4AE815B9D7942730.avi,64,1020,724,296,40.88397790055249,morphological_dilation,3,2
0X4AE815B9D7942730.avi,80,780,524,256,48.854961832061065,morphological_dilation,3,2
0X4AE85C73AA12C02F.avi,99,2989,2501,488,19.51219512195122,morphological_dilation,3,2
0X4AE85C73AA12C02F.avi,118,2630,2170,460,21.19815668202765,morphological_dilation,3,2
0X4AEB420BC16F865B.avi,40,1270,948,322,33.9662447257384,morphological_dilation,3,2
0X4AEB420BC16F865B.avi,53,808,528,280,53.03030303030303,morphological_dilation,3,2
0X4AF0B1C1E9B8A1A1.avi,89,1447,1083,364,33.61034164358264,morphological_dilation,3,2
0X4AF0B1C1E9B8A1A1.avi,105,997,687,310,45.12372634643377,morphological_dilation,3,2
0X4AF13F1F6DDCD882.avi,75,1022,742,280,37.735849056603776,morphological_dilation,3,2
0X4AF13F1F6DDCD882.avi,90,708,460,248,53.91304347826087,morphological_dilation,3,2
0X4AF15C56DD02C3C0.avi,119,1623,1263,360,28.50356294536817,morphological_dilation,3,2
0X4AF15C56DD02C3C0.avi,139,1234,922,312,33.839479392624725,morphological_dilation,3,2
0X4AFA0E75120A4E8D.avi,29,2357,1894,463,24.44561774023231,morphological_dilation,3,2
0X4AFA0E75120A4E8D.avi,41,1558,1162,396,34.07917383820998,morphological_dilation,3,2
0X4AFA30A014892014.avi,89,1256,936,320,34.18803418803419,morphological_dilation,3,2
0X4AFA30A014892014.avi,102,896,620,276,44.516129032258064,morphological_dilation,3,2
0X4AFFD0B23897952C.avi,56,1917,1521,396,26.035502958579883,morphological_dilation,3,2
0X4AFFD0B23897952C.avi,75,1095,783,312,39.84674329501915,morphological_dilation,3,2
0X4B071CB75AAF67A7.avi,1,2587,2095,492,23.484486873508352,morphological_dilation,3,2
0X4B071CB75AAF67A7.avi,20,1786,1362,424,31.130690161527163,morphological_dilation,3,2
0X4B07B1AA398DDD94.avi,52,1657,1281,376,29.352068696330992,morphological_dilation,3,2
0X4B07B1AA398DDD94.avi,69,1047,747,300,40.16064257028113,morphological_dilation,3,2
0X4B082E613A87C172.avi,79,2017,1625,392,24.123076923076923,morphological_dilation,3,2
0X4B082E613A87C172.avi,96,1304,968,336,34.710743801652896,morphological_dilation,3,2
0X4B09D05622E61B48.avi,34,879,619,260,42.003231017770595,morphological_dilation,3,2
0X4B09D05622E61B48.avi,44,644,420,224,53.333333333333336,morphological_dilation,3,2
0X4B0A82F5ED5679DA.avi,47,1601,1237,364,29.426030719482622,morphological_dilation,3,2
0X4B0A82F5ED5679DA.avi,66,1033,721,312,43.27323162274618,morphological_dilation,3,2
0X4B0FE3095BD77020.avi,40,933,669,264,39.46188340807175,morphological_dilation,3,2
0X4B0FE3095BD77020.avi,52,601,381,220,57.74278215223097,morphological_dilation,3,2
0X4B11E88B93EDBFDC.avi,72,1141,821,320,38.976857490864795,morphological_dilation,3,2
0X4B11E88B93EDBFDC.avi,90,667,403,264,65.50868486352357,morphological_dilation,3,2
0X4B122FA0EEEDA898.avi,1,2031,1627,404,24.830977258758452,morphological_dilation,3,2
0X4B122FA0EEEDA898.avi,19,1297,965,332,34.4041450777202,morphological_dilation,3,2
0X4B1424E2649E16B1.avi,60,2827,2324,503,21.64371772805508,morphological_dilation,3,2
0X4B1424E2649E16B1.avi,68,1822,1398,424,30.32904148783977,morphological_dilation,3,2
0X4B166078B705F934.avi,71,2237,1801,436,24.208772903942254,morphological_dilation,3,2
0X4B166078B705F934.avi,90,1459,1083,376,34.71837488457987,morphological_dilation,3,2
0X4B19A8E80BA019E9.avi,99,1859,1459,400,27.416038382453735,morphological_dilation,3,2
0X4B19A8E80BA019E9.avi,121,1145,805,340,42.2360248447205,morphological_dilation,3,2
0X4B1A9E16A188C018.avi,120,1711,1337,374,27.973074046372474,morphological_dilation,3,2
0X4B1A9E16A188C018.avi,145,1117,809,308,38.0716934487021,morphological_dilation,3,2
0X4B1E3D75434F6785.avi,75,1519,1151,368,31.97219808861859,morphological_dilation,3,2
0X4B1E3D75434F6785.avi,91,996,669,327,48.87892376681614,morphological_dilation,3,2
0X4B1EC0E5119B249C.avi,49,1769,1405,364,25.90747330960854,morphological_dilation,3,2
0X4B1EC0E5119B249C.avi,68,1284,972,312,32.098765432098766,morphological_dilation,3,2
0X4B21BE4FEAF4ABC1.avi,128,3802,3246,556,17.128773875539125,morphological_dilation,3,2
0X4B21BE4FEAF4ABC1.avi,146,2723,2247,476,21.18380062305296,morphological_dilation,3,2
0X4B2656CCE4C71467.avi,99,1982,1578,404,25.602027883396705,morphological_dilation,3,2
0X4B2656CCE4C71467.avi,116,1242,914,328,35.886214442013134,morphological_dilation,3,2
0X4B2690203CB2F7BB.avi,48,1457,1109,348,31.379621280432822,morphological_dilation,3,2
0X4B2690203CB2F7BB.avi,65,901,625,276,44.16,morphological_dilation,3,2
0X4B26F81BD69BD461.avi,118,1725,1349,376,27.87249814677539,morphological_dilation,3,2
0X4B26F81BD69BD461.avi,137,1031,735,296,40.27210884353741,morphological_dilation,3,2
0X4B29EC30C3786EBC.avi,56,3518,2966,552,18.61092380310182,morphological_dilation,3,2
0X4B29EC30C3786EBC.avi,74,1839,1431,408,28.511530398322847,morphological_dilation,3,2
0X4B2E0364719FD6A9.avi,116,2030,1598,432,27.033792240300375,morphological_dilation,3,2
0X4B2E0364719FD6A9.avi,136,1304,932,372,39.91416309012876,morphological_dilation,3,2
0X4B2FC6E0DEDCA073.avi,93,2312,1872,440,23.504273504273502,morphological_dilation,3,2
0X4B2FC6E0DEDCA073.avi,111,1589,1217,372,30.56696795398521,morphological_dilation,3,2
0X4B39E73ABDB57B68.avi,67,1487,1139,348,30.553116769095702,morphological_dilation,3,2
0X4B39E73ABDB57B68.avi,82,866,598,268,44.81605351170568,morphological_dilation,3,2
0X4B3A70F6BD40224B.avi,54,1275,943,332,35.2067868504772,morphological_dilation,3,2
0X4B3A70F6BD40224B.avi,112,1949,1402,547,39.015691868758914,morphological_dilation,3,2
0X4B40434A5615B2BA.avi,108,2167,1743,424,24.325874928284566,morphological_dilation,3,2
0X4B40434A5615B2BA.avi,126,1301,973,328,33.710174717368965,morphological_dilation,3,2
0X4B41FE94F65ED4FC.avi,66,2249,1829,420,22.963367960634226,morphological_dilation,3,2
0X4B41FE94F65ED4FC.avi,82,1433,1093,340,31.10704483074108,morphological_dilation,3,2
0X4B47B78A1356F3A8.avi,2,2350,1910,440,23.036649214659686,morphological_dilation,3,2
0X4B47B78A1356F3A8.avi,18,1525,1157,368,31.80639585133967,morphological_dilation,3,2
0X4B4A468566EB1E0E.avi,5,3774,3238,536,16.553428042001237,morphological_dilation,3,2
0X4B4A468566EB1E0E.avi,14,3185,2689,496,18.445518780215693,morphological_dilation,3,2
0X4B5151BFF0CF1234.avi,46,1252,916,336,36.681222707423586,morphological_dilation,3,2
0X4B5151BFF0CF1234.avi,62,832,552,280,50.72463768115942,morphological_dilation,3,2
0X4B525C2573A90917.avi,3,1470,1118,352,31.48479427549195,morphological_dilation,3,2
0X4B525C2573A90917.avi,16,1110,790,320,40.50632911392405,morphological_dilation,3,2
0X4B5599EB2B1B6383.avi,104,3312,2760,552,20.0,morphological_dilation,3,2
0X4B5599EB2B1B6383.avi,125,1820,1392,428,30.747126436781606,morphological_dilation,3,2
0X4B565D14EC8C7DB6.avi,112,2665,2181,484,22.191655204034845,morphological_dilation,3,2
0X4B565D14EC8C7DB6.avi,150,1641,1241,400,32.232070910556004,morphological_dilation,3,2
0X4B584BB69E09EAD1.avi,75,2675,2196,479,21.812386156648454,morphological_dilation,3,2
0X4B584BB69E09EAD1.avi,90,2430,1958,472,24.106230847803882,morphological_dilation,3,2
0X4B58EABEDE38896B.avi,29,2332,1884,448,23.7791932059448,morphological_dilation,3,2
0X4B58EABEDE38896B.avi,45,2086,1662,424,25.511432009626954,morphological_dilation,3,2
0X4B59AFFC9928548B.avi,46,1909,1513,396,26.17316589557171,morphological_dilation,3,2
0X4B59AFFC9928548B.avi,67,1130,806,324,40.198511166253105,morphological_dilation,3,2
0X4B5BEC383832FB9F.avi,55,2175,1739,436,25.071880391029328,morphological_dilation,3,2
0X4B5BEC383832FB9F.avi,73,1404,1044,360,34.48275862068966,morphological_dilation,3,2
0X4B5F467657C70230.avi,71,1979,1591,388,24.387177875549966,morphological_dilation,3,2
0X4B5F467657C70230.avi,88,1152,856,296,34.57943925233645,morphological_dilation,3,2
0X4B64537E074E1D57.avi,50,2054,1646,408,24.787363304981774,morphological_dilation,3,2
0X4B64537E074E1D57.avi,70,1470,1122,348,31.016042780748666,morphological_dilation,3,2
0X4B64ED4B0848592.avi,53,1396,1052,344,32.69961977186312,morphological_dilation,3,2
0X4B64ED4B0848592.avi,70,912,628,284,45.22292993630573,morphological_dilation,3,2
0X4B68039EFC700669.avi,92,1447,1093,354,32.38792314730101,morphological_dilation,3,2
0X4B68039EFC700669.avi,104,1061,757,304,40.158520475561424,morphological_dilation,3,2
0X4B698168EA103F9.avi,42,3273,2761,512,18.544005795001812,morphological_dilation,3,2
0X4B698168EA103F9.avi,59,2081,1657,424,25.588412794206395,morphological_dilation,3,2
0X4B79F74D02C77B91.avi,81,2001,1609,392,24.362958359229335,morphological_dilation,3,2
0X4B79F74D02C77B91.avi,93,1285,941,344,36.55685441020191,morphological_dilation,3,2
0X4B7C480E6B6C5F4C.avi,55,2123,1719,404,23.502036067481093,morphological_dilation,3,2
0X4B7C480E6B6C5F4C.avi,75,1804,1424,380,26.685393258426966,morphological_dilation,3,2
0X4B7D5DF79FE55378.avi,69,2298,1866,432,23.15112540192926,morphological_dilation,3,2
0X4B7D5DF79FE55378.avi,85,1716,1336,380,28.443113772455092,morphological_dilation,3,2
0X4B847FE977316E0.avi,71,1938,1510,428,28.344370860927153,morphological_dilation,3,2
0X4B847FE977316E0.avi,95,1273,925,348,37.62162162162162,morphological_dilation,3,2
0X4B87A05615A53E5F.avi,65,1556,1196,360,30.100334448160538,morphological_dilation,3,2
0X4B87A05615A53E5F.avi,79,1011,711,300,42.19409282700422,morphological_dilation,3,2
0X4B89B49E15E14D26.avi,37,1698,1330,368,27.669172932330827,morphological_dilation,3,2
0X4B89B49E15E14D26.avi,59,1463,1123,340,30.27604630454141,morphological_dilation,3,2
0X4B8CD0B98CEB8EAB.avi,184,2331,1835,496,27.029972752043598,morphological_dilation,3,2
0X4B8CD0B98CEB8EAB.avi,214,1445,1032,413,40.019379844961236,morphological_dilation,3,2
0X4B95C69A063EB22D.avi,105,2088,1680,408,24.285714285714285,morphological_dilation,3,2
0X4B95C69A063EB22D.avi,124,1372,1036,336,32.432432432432435,morphological_dilation,3,2
0X4B9C09C64E8081E1.avi,45,1938,1526,412,26.998689384010483,morphological_dilation,3,2
0X4B9C09C64E8081E1.avi,77,1654,1268,386,30.441640378548897,morphological_dilation,3,2
0X4BA70A790EF786BE.avi,126,2265,1833,432,23.567921440261866,morphological_dilation,3,2
0X4BA70A790EF786BE.avi,145,1465,1111,354,31.863186318631865,morphological_dilation,3,2
0X4BA8D894A4CAC20A.avi,106,1193,877,316,36.03192702394527,morphological_dilation,3,2
0X4BA8D894A4CAC20A.avi,123,789,529,260,49.14933837429111,morphological_dilation,3,2
0X4BA9D17E8AB2AF4E.avi,43,1729,1337,392,29.31937172774869,morphological_dilation,3,2
0X4BA9D17E8AB2AF4E.avi,59,1032,700,332,47.42857142857143,morphological_dilation,3,2
0X4BAA83546BB9380D.avi,58,1860,1436,424,29.526462395543174,morphological_dilation,3,2
0X4BAA83546BB9380D.avi,74,1059,747,312,41.76706827309237,morphological_dilation,3,2
0X4BB050017DDF609.avi,36,1968,1548,420,27.131782945736433,morphological_dilation,3,2
0X4BB050017DDF609.avi,47,1378,1014,364,35.8974358974359,morphological_dilation,3,2
0X4BB3993C8A5A8977.avi,78,2721,2241,480,21.4190093708166,morphological_dilation,3,2
0X4BB3993C8A5A8977.avi,100,2106,1690,416,24.615384615384617,morphological_dilation,3,2
0X4BB8DC3E68BEB02F.avi,42,1694,1334,360,26.986506746626688,morphological_dilation,3,2
0X4BB8DC3E68BEB02F.avi,60,1294,974,320,32.85420944558521,morphological_dilation,3,2
0X4BBA9C8FB485C9AB.avi,0,816,564,252,44.680851063829785,morphological_dilation,3,2
0X4BBA9C8FB485C9AB.avi,71,929,597,332,55.61139028475712,morphological_dilation,3,2
0X4BC28F2815304567.avi,93,1192,868,324,37.327188940092164,morphological_dilation,3,2
0X4BC28F2815304567.avi,106,781,503,278,55.26838966202783,morphological_dilation,3,2
0X4BC813EAB8928F95.avi,73,1023,739,284,38.43031123139377,morphological_dilation,3,2
0X4BC813EAB8928F95.avi,84,756,512,244,47.65625,morphological_dilation,3,2
0X4BCA2D411679E784.avi,40,1588,1210,378,31.239669421487605,morphological_dilation,3,2
0X4BCA2D411679E784.avi,51,892,586,306,52.218430034129696,morphological_dilation,3,2
0X4BCC5BA7C5470944.avi,58,2012,1588,424,26.700251889168765,morphological_dilation,3,2
0X4BCC5BA7C5470944.avi,73,1191,847,344,40.61393152302244,morphological_dilation,3,2
0X4BDB73AF3B7D95B0.avi,29,1629,1228,401,32.65472312703583,morphological_dilation,3,2
0X4BDB73AF3B7D95B0.avi,41,1114,766,348,45.43080939947781,morphological_dilation,3,2
0X4BDC800A2389AD0C.avi,0,2023,1635,388,23.730886850152906,morphological_dilation,3,2
0X4BDC800A2389AD0C.avi,11,1333,1009,324,32.11100099108028,morphological_dilation,3,2
0X4BE3ED1D238EEAB9.avi,37,1547,1195,352,29.456066945606697,morphological_dilation,3,2
0X4BE3ED1D238EEAB9.avi,54,1325,1001,324,32.36763236763237,morphological_dilation,3,2
0X4BE905008004907A.avi,38,1222,910,312,34.285714285714285,morphological_dilation,3,2
0X4BE905008004907A.avi,49,790,530,260,49.056603773584904,morphological_dilation,3,2
0X4BF0DB86A9010424.avi,42,2488,2028,460,22.682445759368836,morphological_dilation,3,2
0X4BF0DB86A9010424.avi,60,1972,1553,419,26.980038634900193,morphological_dilation,3,2
0X4BF119F934981194.avi,146,1552,1204,348,28.903654485049834,morphological_dilation,3,2
0X4BF119F934981194.avi,161,1017,729,288,39.50617283950617,morphological_dilation,3,2
0X4BF33294A3CAE042.avi,163,2528,2036,492,24.165029469548134,morphological_dilation,3,2
0X4BF33294A3CAE042.avi,181,1596,1212,384,31.683168316831683,morphological_dilation,3,2
0X4BF3DE30B4F6B86.avi,89,2856,2364,492,20.812182741116754,morphological_dilation,3,2
0X4BF3DE30B4F6B86.avi,109,1841,1437,404,28.114126652748784,morphological_dilation,3,2
0X4BF459CB177B8BE1.avi,54,1920,1508,412,27.320954907161806,morphological_dilation,3,2
0X4BF459CB177B8BE1.avi,71,1138,787,351,44.5997458703939,morphological_dilation,3,2
0X4BF559BFA7DAD2E0.avi,99,2945,2453,492,20.05707297187118,morphological_dilation,3,2
0X4BF559BFA7DAD2E0.avi,115,1632,1268,364,28.706624605678233,morphological_dilation,3,2
0X4BF6DA4F93352E9F.avi,40,1809,1429,380,26.592022393282015,morphological_dilation,3,2
0X4BF6DA4F93352E9F.avi,59,1046,766,280,36.55352480417754,morphological_dilation,3,2
0X4BFB0BF04447A0DD.avi,58,2277,1853,424,22.881813275769023,morphological_dilation,3,2
0X4BFB0BF04447A0DD.avi,83,1532,1172,360,30.716723549488055,morphological_dilation,3,2
0X4BFC06E24046BAC2.avi,133,2144,1720,424,24.651162790697676,morphological_dilation,3,2
0X4BFC06E24046BAC2.avi,149,1346,1002,344,34.3313373253493,morphological_dilation,3,2
0X4BFD23141A6091C5.avi,0,716,476,240,50.42016806722689,morphological_dilation,3,2
0X4BFD23141A6091C5.avi,14,566,338,228,67.45562130177515,morphological_dilation,3,2
0X4BFD28E76C66C41C.avi,71,2244,1832,412,22.489082969432314,morphological_dilation,3,2
0X4BFD28E76C66C41C.avi,93,1521,1181,340,28.789161727349704,morphological_dilation,3,2
0X4BFDE46ED7B401A1.avi,43,2412,1932,480,24.84472049689441,morphological_dilation,3,2
0X4BFDE46ED7B401A1.avi,57,1505,1081,424,39.222941720629045,morphological_dilation,3,2
0X4BFE78C4BEC7AA93.avi,168,2667,2195,472,21.503416856492027,morphological_dilation,3,2
0X4BFE78C4BEC7AA93.avi,192,1775,1371,404,29.46754194018964,morphological_dilation,3,2
0X4BFFC22FACA59CF4.avi,61,1824,1428,396,27.73109243697479,morphological_dilation,3,2
0X4BFFC22FACA59CF4.avi,77,1443,1077,366,33.98328690807799,morphological_dilation,3,2
0X4C017259B103AAEE.avi,98,1598,1219,379,31.091058244462676,morphological_dilation,3,2
0X4C017259B103AAEE.avi,113,957,649,308,47.45762711864407,morphological_dilation,3,2
0X4C02937ED93C6C82.avi,79,1186,855,331,38.71345029239766,morphological_dilation,3,2
0X4C02937ED93C6C82.avi,105,779,472,307,65.04237288135593,morphological_dilation,3,2
0X4C03123EFAA5067B.avi,107,1990,1550,440,28.387096774193548,morphological_dilation,3,2
0X4C03123EFAA5067B.avi,126,964,636,328,51.57232704402516,morphological_dilation,3,2
0X4C03A878AB261E5.avi,84,1153,825,328,39.75757575757576,morphological_dilation,3,2
0X4C03A878AB261E5.avi,101,722,466,256,54.93562231759657,morphological_dilation,3,2
0X4C0A0D74EBABE209.avi,75,1951,1539,412,26.77063027940221,morphological_dilation,3,2
0X4C0A0D74EBABE209.avi,89,1153,810,343,42.34567901234568,morphological_dilation,3,2
0X4C10037D22ABEC73.avi,39,1247,907,340,37.48621830209482,morphological_dilation,3,2
0X4C10037D22ABEC73.avi,49,795,523,272,52.00764818355641,morphological_dilation,3,2
0X4C1361334313836F.avi,64,3399,2879,520,18.06182702327197,morphological_dilation,3,2
0X4C1361334313836F.avi,82,2178,1738,440,25.31645569620253,morphological_dilation,3,2
0X4C1780A7FE432F57.avi,47,1567,1223,344,28.12755519215045,morphological_dilation,3,2
0X4C1780A7FE432F57.avi,60,1337,1017,320,31.465093411996065,morphological_dilation,3,2
0X4C1851D41B1A615A.avi,27,1864,1476,388,26.287262872628723,morphological_dilation,3,2
0X4C1851D41B1A615A.avi,39,1454,1106,348,31.464737793851715,morphological_dilation,3,2
0X4C2335075A96DD85.avi,54,2391,1907,484,25.380178290508653,morphological_dilation,3,2
0X4C2335075A96DD85.avi,72,1390,999,391,39.13913913913914,morphological_dilation,3,2
0X4C237A567F5002FC.avi,3,1745,1373,372,27.093954843408596,morphological_dilation,3,2
0X4C237A567F5002FC.avi,20,1070,768,302,39.32291666666667,morphological_dilation,3,2
0X4C26D3921A0BB05C.avi,55,2016,1444,572,39.612188365650965,morphological_dilation,3,2
0X4C26D3921A0BB05C.avi,69,1175,705,470,66.66666666666666,morphological_dilation,3,2
0X4C28BDBE546E6B12.avi,143,1870,1482,388,26.180836707152494,morphological_dilation,3,2
0X4C28BDBE546E6B12.avi,160,1476,1130,346,30.619469026548675,morphological_dilation,3,2
0X4C340319107C4943.avi,83,1951,1543,408,26.441996111471163,morphological_dilation,3,2
0X4C340319107C4943.avi,101,1108,804,304,37.81094527363184,morphological_dilation,3,2
0X4C371F553F658F4A.avi,55,1212,912,300,32.89473684210527,morphological_dilation,3,2
0X4C371F553F658F4A.avi,76,840,584,256,43.83561643835616,morphological_dilation,3,2
0X4C3886781B19B953.avi,3,2796,2328,468,20.103092783505154,morphological_dilation,3,2
0X4C3886781B19B953.avi,18,1654,1274,380,29.82731554160126,morphological_dilation,3,2
0X4C3D1288ECBB8117.avi,44,1022,718,304,42.33983286908078,morphological_dilation,3,2
0X4C3D1288ECBB8117.avi,57,708,435,273,62.758620689655174,morphological_dilation,3,2
0X4C3FFA0312ADF0DA.avi,35,1772,1404,368,26.21082621082621,morphological_dilation,3,2
0X4C3FFA0312ADF0DA.avi,55,1113,793,320,40.3530895334174,morphological_dilation,3,2
0X4C4591D9CB3DDDE8.avi,0,2998,2502,496,19.82414068745004,morphological_dilation,3,2
0X4C4591D9CB3DDDE8.avi,17,1793,1385,408,29.45848375451264,morphological_dilation,3,2
0X4C4655AD4584F866.avi,47,1716,1336,380,28.443113772455092,morphological_dilation,3,2
0X4C4655AD4584F866.avi,62,1203,879,324,36.86006825938566,morphological_dilation,3,2
0X4C468BD8DD069AA8.avi,89,2056,1628,428,26.289926289926292,morphological_dilation,3,2
0X4C468BD8DD069AA8.avi,102,1191,835,356,42.634730538922156,morphological_dilation,3,2
0X4C49B523268655BE.avi,128,2013,1598,415,25.96996245306633,morphological_dilation,3,2
0X4C49B523268655BE.avi,144,1335,987,348,35.25835866261398,morphological_dilation,3,2
0X4C4AB1371DF72873.avi,91,1060,776,284,36.597938144329895,morphological_dilation,3,2
0X4C4AB1371DF72873.avi,107,854,598,256,42.80936454849498,morphological_dilation,3,2
0X4C4D6F2D3455F022.avi,105,1711,1351,360,26.646928201332347,morphological_dilation,3,2
0X4C4D6F2D3455F022.avi,123,1245,941,304,32.30605738575983,morphological_dilation,3,2
0X4C52576367EDE50B.avi,67,2443,1947,496,25.475089881869543,morphological_dilation,3,2
0X4C52576367EDE50B.avi,84,1447,1031,416,40.34917555771096,morphological_dilation,3,2
0X4C53CDD47193BEC7.avi,49,1693,1317,376,28.549734244495063,morphological_dilation,3,2
0X4C53CDD47193BEC7.avi,65,1062,740,322,43.513513513513516,morphological_dilation,3,2
0X4C568666D11BB71.avi,112,1416,1088,328,30.14705882352941,morphological_dilation,3,2
0X4C568666D11BB71.avi,125,860,596,264,44.29530201342282,morphological_dilation,3,2
0X4C576D3B38DCAF3B.avi,57,1284,960,324,33.75,morphological_dilation,3,2
0X4C576D3B38DCAF3B.avi,71,843,571,272,47.635726795096325,morphological_dilation,3,2
0X4C5B58DD6DEE9F41.avi,53,1429,1101,328,29.791099000908268,morphological_dilation,3,2
0X4C5B58DD6DEE9F41.avi,72,938,674,264,39.16913946587537,morphological_dilation,3,2
0X4C5EA0992F006638.avi,60,2109,1713,396,23.117338003502628,morphological_dilation,3,2
0X4C5EA0992F006638.avi,76,1808,1440,368,25.555555555555554,morphological_dilation,3,2
0X4C6A28C4F6FAF44D.avi,48,2458,1986,472,23.76636455186304,morphological_dilation,3,2
0X4C6A28C4F6FAF44D.avi,62,1474,1086,388,35.727440147329645,morphological_dilation,3,2
0X4C6B4EA851FB7CD5.avi,104,1502,1146,356,31.064572425828967,morphological_dilation,3,2
0X4C6B4EA851FB7CD5.avi,117,937,641,296,46.17784711388456,morphological_dilation,3,2
0X4C765C6A4C61E31.avi,106,2144,1696,448,26.41509433962264,morphological_dilation,3,2
0X4C765C6A4C61E31.avi,124,1412,1052,360,34.22053231939163,morphological_dilation,3,2
0X4C78FD4E271DC686.avi,83,1738,1331,407,30.57851239669421,morphological_dilation,3,2
0X4C78FD4E271DC686.avi,97,912,627,285,45.45454545454545,morphological_dilation,3,2
0X4C79C1C85A865778.avi,38,1614,1242,372,29.951690821256037,morphological_dilation,3,2
0X4C79C1C85A865778.avi,55,1095,779,316,40.564826700898585,morphological_dilation,3,2
0X4C7BB6C1C92781B0.avi,64,1927,1504,423,28.125,morphological_dilation,3,2
0X4C7BB6C1C92781B0.avi,75,1146,807,339,42.00743494423792,morphological_dilation,3,2
0X4C7CA272E540FDDE.avi,83,1513,1165,348,29.871244635193133,morphological_dilation,3,2
0X4C7CA272E540FDDE.avi,100,1028,711,317,44.585091420534454,morphological_dilation,3,2
0X4C81F018685C5333.avi,0,2323,1903,420,22.07041513399895,morphological_dilation,3,2
0X4C81F018685C5333.avi,12,1762,1378,384,27.866473149492016,morphological_dilation,3,2
0X4C8DA84ECA696012.avi,102,1346,1006,340,33.79721669980119,morphological_dilation,3,2
0X4C8DA84ECA696012.avi,118,920,620,300,48.38709677419355,morphological_dilation,3,2
0X4C8EB73366ADC960.avi,6,1999,1607,392,24.393279402613565,morphological_dilation,3,2
0X4C8EB73366ADC960.avi,24,1344,1016,328,32.28346456692913,morphological_dilation,3,2
0X4C940AC8C0605D65.avi,43,1955,1551,404,26.047711154094134,morphological_dilation,3,2
0X4C940AC8C0605D65.avi,56,1156,844,312,36.96682464454976,morphological_dilation,3,2
0X4C9A1284B8E67C07.avi,112,1895,1507,388,25.746516257465164,morphological_dilation,3,2
0X4C9A1284B8E67C07.avi,125,1172,860,312,36.27906976744186,morphological_dilation,3,2
0X4C9BF2EEFE6D8E03.avi,57,1517,1165,352,30.21459227467811,morphological_dilation,3,2
0X4C9BF2EEFE6D8E03.avi,73,1032,724,308,42.5414364640884,morphological_dilation,3,2
0X4CA58914A47D6EB8.avi,77,2103,1687,416,24.659158269116777,morphological_dilation,3,2
0X4CA58914A47D6EB8.avi,97,1346,998,348,34.86973947895792,morphological_dilation,3,2
0X4CA5974AE29AD2C2.avi,75,2069,1669,400,23.96644697423607,morphological_dilation,3,2
0X4CA5974AE29AD2C2.avi,95,1394,1054,340,32.25806451612903,morphological_dilation,3,2
0X4CA6C598613CA480.avi,59,1388,1060,328,30.943396226415093,morphological_dilation,3,2
0X4CA6C598613CA480.avi,70,937,661,276,41.75491679273828,morphological_dilation,3,2
0X4CAF7FFD0699140A.avi,124,1389,1057,332,31.409649952696313,morphological_dilation,3,2
0X4CAF7FFD0699140A.avi,142,875,603,272,45.107794361525706,morphological_dilation,3,2
0X4CB123C86AF06E35.avi,34,2404,1976,428,21.65991902834008,morphological_dilation,3,2
0X4CB123C86AF06E35.avi,44,2146,1742,404,23.19173363949483,morphological_dilation,3,2
0X4CB1C43A0DA06048.avi,3,1621,1245,376,30.200803212851408,morphological_dilation,3,2
0X4CB1C43A0DA06048.avi,18,1054,733,321,43.79263301500682,morphological_dilation,3,2
0X4CB68B0128EC8BB8.avi,88,1407,1063,344,32.36124176857949,morphological_dilation,3,2
0X4CB68B0128EC8BB8.avi,98,904,616,288,46.75324675324675,morphological_dilation,3,2
0X4CB87C3FC67B831.avi,50,1369,1041,328,31.508165225744477,morphological_dilation,3,2
0X4CB87C3FC67B831.avi,67,908,640,268,41.875,morphological_dilation,3,2
0X4CB88DECE22155BA.avi,83,1942,1558,384,24.646983311938385,morphological_dilation,3,2
0X4CB88DECE22155BA.avi,95,1578,1234,344,27.876823338735818,morphological_dilation,3,2
0X4CBB408C0D18223.avi,98,2119,1703,416,24.427480916030532,morphological_dilation,3,2
0X4CBB408C0D18223.avi,115,1237,917,320,34.89640130861505,morphological_dilation,3,2
0X4CBF0A6F0C972863.avi,51,2195,1755,440,25.071225071225072,morphological_dilation,3,2
0X4CBF0A6F0C972863.avi,71,1409,1049,360,34.31839847473784,morphological_dilation,3,2
0X4CC16E6750678D36.avi,47,1679,1311,368,28.07017543859649,morphological_dilation,3,2
0X4CC16E6750678D36.avi,65,1046,742,304,40.97035040431267,morphological_dilation,3,2
0X4CC17C774BE7BE21.avi,91,3494,2946,548,18.601493550577054,morphological_dilation,3,2
0X4CC17C774BE7BE21.avi,109,2090,1666,424,25.45018007202881,morphological_dilation,3,2
0X4CC6569F80929A0E.avi,73,2146,1730,416,24.046242774566473,morphological_dilation,3,2
0X4CC6569F80929A0E.avi,90,1425,1077,348,32.31197771587744,morphological_dilation,3,2
0X4CC65CE3ECC83EDD.avi,98,1060,710,350,49.29577464788733,morphological_dilation,3,2
0X4CC65CE3ECC83EDD.avi,117,767,488,279,57.17213114754098,morphological_dilation,3,2
0X4CC680B82F171A82.avi,46,3184,2665,519,19.474671669793622,morphological_dilation,3,2
0X4CC680B82F171A82.avi,61,2077,1633,444,27.18922229026332,morphological_dilation,3,2
0X4CCB0ABB54AAD290.avi,312,1417,1073,344,32.059645852749306,morphological_dilation,3,2
0X4CCB0ABB54AAD290.avi,329,973,677,296,43.72230428360414,morphological_dilation,3,2
0X4CD499A12AA116A9.avi,46,2356,1932,424,21.94616977225673,morphological_dilation,3,2
0X4CD499A12AA116A9.avi,64,2010,1618,392,24.2274412855377,morphological_dilation,3,2
0X4CD637D93B06D6A7.avi,113,1804,1412,392,27.762039660056658,morphological_dilation,3,2
0X4CD637D93B06D6A7.avi,135,1194,862,332,38.51508120649652,morphological_dilation,3,2
0X4CD7A96E08866F11.avi,46,1913,1537,376,24.46324007807417,morphological_dilation,3,2
0X4CD7A96E08866F11.avi,60,1121,825,296,35.878787878787875,morphological_dilation,3,2
0X4CD93C570A5BAD1B.avi,0,1536,1176,360,30.612244897959183,morphological_dilation,3,2
0X4CD93C570A5BAD1B.avi,15,989,700,289,41.285714285714285,morphological_dilation,3,2
0X4CDA2C041B3645A3.avi,90,2145,1721,424,24.63683904706566,morphological_dilation,3,2
0X4CDA2C041B3645A3.avi,108,1376,1008,368,36.507936507936506,morphological_dilation,3,2
0X4CDEDC3CA72436A1.avi,54,3271,2732,539,19.72913616398243,morphological_dilation,3,2
0X4CDEDC3CA72436A1.avi,73,1985,1496,489,32.68716577540107,morphological_dilation,3,2
0X4CDFBF74BE06CD79.avi,46,1544,1177,367,31.180968564146134,morphological_dilation,3,2
0X4CDFBF74BE06CD79.avi,63,942,626,316,50.47923322683706,morphological_dilation,3,2
0X4CDFD3195FA16B22.avi,40,1655,1295,360,27.7992277992278,morphological_dilation,3,2
0X4CDFD3195FA16B22.avi,56,1199,883,316,35.78708946772367,morphological_dilation,3,2
0X4CE086FD09C0C80E.avi,76,2346,1906,440,23.084994753410285,morphological_dilation,3,2
0X4CE086FD09C0C80E.avi,92,1417,1065,352,33.051643192488264,morphological_dilation,3,2
0X4CE0E0E7010773C4.avi,86,1874,1482,392,26.450742240215924,morphological_dilation,3,2
0X4CE0E0E7010773C4.avi,107,1242,906,336,37.086092715231786,morphological_dilation,3,2
0X4CE54541BBDDE3E.avi,88,2349,1905,444,23.30708661417323,morphological_dilation,3,2
0X4CE54541BBDDE3E.avi,110,1434,1078,356,33.024118738404454,morphological_dilation,3,2
0X4CE57216AF8F1E10.avi,4,2262,1822,440,24.149286498353458,morphological_dilation,3,2
0X4CE57216AF8F1E10.avi,17,1306,954,352,36.897274633123686,morphological_dilation,3,2
0X4CE72E5392DFF72E.avi,71,1613,1229,384,31.244914564686738,morphological_dilation,3,2
0X4CE72E5392DFF72E.avi,96,2098,1666,432,25.930372148859544,morphological_dilation,3,2
0X4CEA5093E58402D2.avi,42,1366,1006,360,35.785288270377734,morphological_dilation,3,2
0X4CEA5093E58402D2.avi,60,824,528,296,56.060606060606055,morphological_dilation,3,2
0X4CEDA292EED01C94.avi,4,1219,880,339,38.52272727272727,morphological_dilation,3,2
0X4CEDA292EED01C94.avi,15,819,512,307,59.9609375,morphological_dilation,3,2
0X4CF1BE8C472DCA51.avi,74,975,683,292,42.75256222547584,morphological_dilation,3,2
0X4CF1BE8C472DCA51.avi,87,671,389,282,72.49357326478149,morphological_dilation,3,2
0X4CF43EB60D67F4FA.avi,29,1394,1038,356,34.296724470134876,morphological_dilation,3,2
0X4CF43EB60D67F4FA.avi,42,903,607,296,48.76441515650741,morphological_dilation,3,2
0X4CF5A561E4FD6401.avi,112,2109,1677,432,25.760286225402506,morphological_dilation,3,2
0X4CF5A561E4FD6401.avi,130,1274,901,373,41.3984461709212,morphological_dilation,3,2
0X4CF9BACA68AB1338.avi,52,2287,1851,436,23.55483522420313,morphological_dilation,3,2
0X4CF9BACA68AB1338.avi,72,1452,1084,368,33.94833948339483,morphological_dilation,3,2
0X4CFB6BEA6D0C437F.avi,41,1335,1011,324,32.047477744807125,morphological_dilation,3,2
0X4CFB6BEA6D0C437F.avi,54,786,522,264,50.57471264367817,morphological_dilation,3,2
0X4CFBE71C31434362.avi,41,1412,1057,355,33.58561967833491,morphological_dilation,3,2
0X4CFBE71C31434362.avi,55,905,613,292,47.63458401305057,morphological_dilation,3,2
0X4D01E74191B49611.avi,90,1274,934,340,36.402569593147746,morphological_dilation,3,2
0X4D01E74191B49611.avi,106,804,536,268,50.0,morphological_dilation,3,2
0X4D0222E0ECAF62B5.avi,102,1486,1126,360,31.97158081705151,morphological_dilation,3,2
0X4D0222E0ECAF62B5.avi,117,919,606,313,51.650165016501646,morphological_dilation,3,2
0X4D0291520E75CD23.avi,57,2068,1660,408,24.57831325301205,morphological_dilation,3,2
0X4D0291520E75CD23.avi,71,1304,964,340,35.26970954356847,morphological_dilation,3,2
0X4D05415F9703CA47.avi,54,2971,2461,510,20.723283218203985,morphological_dilation,3,2
0X4D05415F9703CA47.avi,83,2073,1622,451,27.805178791615287,morphological_dilation,3,2
0X4D09A013097FCCB2.avi,182,1667,1291,376,29.124709527498066,morphological_dilation,3,2
0X4D09A013097FCCB2.avi,204,933,630,303,48.095238095238095,morphological_dilation,3,2
0X4D0A1712CDE848D1.avi,3,1390,1054,336,31.87855787476281,morphological_dilation,3,2
0X4D0A1712CDE848D1.avi,10,1041,753,288,38.24701195219124,morphological_dilation,3,2
0X4D0F3CBCB6A77DD3.avi,57,1574,1214,360,29.654036243822073,morphological_dilation,3,2
0X4D0F3CBCB6A77DD3.avi,76,1074,770,304,39.48051948051948,morphological_dilation,3,2
0X4D13B86CE7623A02.avi,140,1578,1216,362,29.769736842105267,morphological_dilation,3,2
0X4D13B86CE7623A02.avi,158,950,654,296,45.25993883792049,morphological_dilation,3,2
0X4D160D96C3F7E1FC.avi,38,1415,1055,360,34.12322274881517,morphological_dilation,3,2
0X4D160D96C3F7E1FC.avi,43,1157,837,320,38.23178016726404,morphological_dilation,3,2
0X4D17A70DB464D7EB.avi,36,1455,1099,356,32.39308462238398,morphological_dilation,3,2
0X4D17A70DB464D7EB.avi,55,1120,812,308,37.93103448275862,morphological_dilation,3,2
0X4D1EDDDF9C8A03B1.avi,53,2685,2190,495,22.602739726027394,morphological_dilation,3,2
0X4D1EDDDF9C8A03B1.avi,72,1705,1297,408,31.45720894371627,morphological_dilation,3,2
0X4D1FA00A1C115E77.avi,118,1822,1418,404,28.49083215796897,morphological_dilation,3,2
0X4D1FA00A1C115E77.avi,133,1439,1079,360,33.364226135310474,morphological_dilation,3,2
0X4D28224289EE89D5.avi,159,1551,1187,364,30.66554338668913,morphological_dilation,3,2
0X4D28224289EE89D5.avi,172,1287,959,328,34.20229405630866,morphological_dilation,3,2
0X4D2A1A1E92532688.avi,81,1640,1264,376,29.746835443037973,morphological_dilation,3,2
0X4D2A1A1E92532688.avi,96,982,666,316,47.44744744744745,morphological_dilation,3,2
0X4D2A66B9939577A8.avi,155,1521,1177,344,29.226847918436704,morphological_dilation,3,2
0X4D2A66B9939577A8.avi,178,888,624,264,42.30769230769231,morphological_dilation,3,2
0X4D2EB11276654447.avi,64,2117,1709,408,23.87361029842013,morphological_dilation,3,2
0X4D2EB11276654447.avi,74,1904,1516,388,25.593667546174142,morphological_dilation,3,2
0X4D2EDFADE5E20671.avi,79,1434,1098,336,30.601092896174865,morphological_dilation,3,2
0X4D2EDFADE5E20671.avi,95,920,644,276,42.857142857142854,morphological_dilation,3,2
0X4D2FF488DD4EC6BD.avi,30,899,643,256,39.813374805598755,morphological_dilation,3,2
0X4D2FF488DD4EC6BD.avi,40,577,357,220,61.62464985994398,morphological_dilation,3,2
0X4D382FD37FF3BE9A.avi,34,1120,820,300,36.58536585365854,morphological_dilation,3,2
0X4D382FD37FF3BE9A.avi,42,755,479,276,57.62004175365344,morphological_dilation,3,2
0X4D383DD98BD6CD12.avi,50,3116,2612,504,19.29555895865237,morphological_dilation,3,2
0X4D383DD98BD6CD12.avi,68,2398,1934,464,23.991726990692865,morphological_dilation,3,2
0X4D386EB1CFBBF2E0.avi,45,1456,1124,332,29.537366548042705,morphological_dilation,3,2
0X4D386EB1CFBBF2E0.avi,61,1245,929,316,34.01506996770721,morphological_dilation,3,2
0X4D3941FA34D265A1.avi,56,2179,1767,412,23.316355404640635,morphological_dilation,3,2
0X4D3941FA34D265A1.avi,72,1738,1346,392,29.123328380386333,morphological_dilation,3,2
0X4D45DB40C07ABDB4.avi,82,1431,1091,340,31.164069660861593,morphological_dilation,3,2
0X4D45DB40C07ABDB4.avi,95,978,674,304,45.103857566765576,morphological_dilation,3,2
0X4D49F2F1D9FCA7B1.avi,99,1072,766,306,39.947780678851174,morphological_dilation,3,2
0X4D49F2F1D9FCA7B1.avi,112,686,430,256,59.53488372093023,morphological_dilation,3,2
0X4D4A878E7156F2F5.avi,96,2262,1826,436,23.877327491785323,morphological_dilation,3,2
0X4D4A878E7156F2F5.avi,116,1480,1116,364,32.61648745519714,morphological_dilation,3,2
0X4D4AD8BFA119E9C6.avi,52,1589,1213,376,30.99752679307502,morphological_dilation,3,2
0X4D4AD8BFA119E9C6.avi,67,821,505,316,62.57425742574257,morphological_dilation,3,2
0X4D4EB3BBA778944F.avi,33,1088,776,312,40.20618556701031,morphological_dilation,3,2
0X4D4EB3BBA778944F.avi,43,971,667,304,45.57721139430285,morphological_dilation,3,2
0X4D5698D867CAB134.avi,45,2013,1621,392,24.18260333127699,morphological_dilation,3,2
0X4D5698D867CAB134.avi,58,1789,1421,368,25.8972554539057,morphological_dilation,3,2
0X4D5875A78CDB6134.avi,93,1767,1387,380,27.397260273972602,morphological_dilation,3,2
0X4D5875A78CDB6134.avi,114,1224,912,312,34.21052631578947,morphological_dilation,3,2
0X4D5A130C23487046.avi,122,2041,1645,396,24.072948328267476,morphological_dilation,3,2
0X4D5A130C23487046.avi,139,1256,932,324,34.763948497854074,morphological_dilation,3,2
0X4D5D1CAEDFF330B3.avi,51,1742,1366,376,27.52562225475842,morphological_dilation,3,2
0X4D5D1CAEDFF330B3.avi,69,1096,788,308,39.08629441624365,morphological_dilation,3,2
0X4D5F0870E57D20B0.avi,46,2146,1734,412,23.760092272203,morphological_dilation,3,2
0X4D5F0870E57D20B0.avi,62,1286,959,327,34.09801876955162,morphological_dilation,3,2
0X4D5F56A5E5E65A2D.avi,33,1321,985,336,34.11167512690355,morphological_dilation,3,2
0X4D5F56A5E5E65A2D.avi,46,900,620,280,45.16129032258064,morphological_dilation,3,2
0X4D62E04895FF6E99.avi,140,1371,1019,352,34.543670264965655,morphological_dilation,3,2
0X4D62E04895FF6E99.avi,159,892,596,296,49.664429530201346,morphological_dilation,3,2
0X4D632FF0483C23DC.avi,91,1789,1413,376,26.610049539985848,morphological_dilation,3,2
0X4D632FF0483C23DC.avi,110,1047,747,300,40.16064257028113,morphological_dilation,3,2
0X4D63E7433E03AD51.avi,135,3810,3234,576,17.810760667903523,morphological_dilation,3,2
0X4D63E7433E03AD51.avi,152,2303,1835,468,25.50408719346049,morphological_dilation,3,2
0X4D7581C48FA515A6.avi,55,1927,1519,408,26.85977616853193,morphological_dilation,3,2
0X4D7581C48FA515A6.avi,72,1149,829,320,38.600723763570564,morphological_dilation,3,2
0X4D7A36B4D79C91BE.avi,56,1635,1279,356,27.834245504300238,morphological_dilation,3,2
0X4D7A36B4D79C91BE.avi,69,1189,865,324,37.45664739884393,morphological_dilation,3,2
0X4D7DE24F07975B44.avi,107,1638,1278,360,28.169014084507044,morphological_dilation,3,2
0X4D7DE24F07975B44.avi,127,972,696,276,39.6551724137931,morphological_dilation,3,2
0X4D7F997CE6456E59.avi,1,1545,1189,356,29.941126997476868,morphological_dilation,3,2
0X4D7F997CE6456E59.avi,17,1043,741,302,40.7557354925776,morphological_dilation,3,2
0X4D9831DA52FD3036.avi,37,1266,942,324,34.394904458598724,morphological_dilation,3,2
0X4D9831DA52FD3036.avi,50,777,505,272,53.86138613861387,morphological_dilation,3,2
0X4D98AD1D14520724.avi,99,1828,1424,404,28.370786516853936,morphological_dilation,3,2
0X4D98AD1D14520724.avi,112,1431,1071,360,33.61344537815126,morphological_dilation,3,2
0X4D99A73E71A323B8.avi,61,2207,1755,452,25.754985754985753,morphological_dilation,3,2
0X4D99A73E71A323B8.avi,79,1289,939,350,37.273695420660275,morphological_dilation,3,2
0X4D9BF9D205C0FB63.avi,58,1910,1514,396,26.1558784676354,morphological_dilation,3,2
0X4D9BF9D205C0FB63.avi,75,1101,789,312,39.543726235741445,morphological_dilation,3,2
0X4D9D753FBE44EB57.avi,41,1382,1058,324,30.623818525519848,morphological_dilation,3,2
0X4D9D753FBE44EB57.avi,53,897,617,280,45.38087520259319,morphological_dilation,3,2
0X4D9DC3BA4B7C8E52.avi,128,1809,1413,396,28.02547770700637,morphological_dilation,3,2
0X4D9DC3BA4B7C8E52.avi,146,1070,740,330,44.5945945945946,morphological_dilation,3,2
0X4D9E5AC44BA7A1A2.avi,50,1708,1308,400,30.58103975535168,morphological_dilation,3,2
0X4D9E5AC44BA7A1A2.avi,62,1001,681,320,46.98972099853157,morphological_dilation,3,2
0X4DA5545E836ACC84.avi,77,1476,1125,351,31.2,morphological_dilation,3,2
0X4DA5545E836ACC84.avi,94,950,639,311,48.6697965571205,morphological_dilation,3,2
0X4DA7FB1F092BD92B.avi,42,1328,996,332,33.33333333333333,morphological_dilation,3,2
0X4DA7FB1F092BD92B.avi,59,940,648,292,45.06172839506173,morphological_dilation,3,2
0X4DA94E47D07B0048.avi,65,2319,1899,420,22.11690363349131,morphological_dilation,3,2
0X4DA94E47D07B0048.avi,87,1720,1325,395,29.81132075471698,morphological_dilation,3,2
0X4DAA75CD814E3D63.avi,66,1641,1281,360,28.10304449648712,morphological_dilation,3,2
0X4DAA75CD814E3D63.avi,87,1014,714,300,42.016806722689076,morphological_dilation,3,2
0X4DAA863D22C7C527.avi,42,1541,1165,376,32.27467811158798,morphological_dilation,3,2
0X4DAA863D22C7C527.avi,56,955,659,296,44.916540212443095,morphological_dilation,3,2
0X4DAC23C28ADA5AD4.avi,33,1601,1225,376,30.69387755102041,morphological_dilation,3,2
0X4DAC23C28ADA5AD4.avi,61,972,680,292,42.94117647058823,morphological_dilation,3,2
0X4DAE17608E513F21.avi,40,1238,930,308,33.11827956989247,morphological_dilation,3,2
0X4DAE17608E513F21.avi,60,858,578,280,48.44290657439446,morphological_dilation,3,2
0X4DAF2BC7AD5242BF.avi,131,1299,971,328,33.77960865087539,morphological_dilation,3,2
0X4DAF2BC7AD5242BF.avi,148,850,575,275,47.82608695652174,morphological_dilation,3,2
0X4DB13082260E993.avi,92,1443,1101,342,31.062670299727518,morphological_dilation,3,2
0X4DB13082260E993.avi,110,961,667,294,44.07796101949025,morphological_dilation,3,2
0X4DB4EF7CCB391976.avi,44,1447,1111,336,30.243024302430243,morphological_dilation,3,2
0X4DB4EF7CCB391976.avi,64,980,670,310,46.26865671641791,morphological_dilation,3,2
0X4DB983F2F26967CD.avi,27,1221,905,316,34.91712707182321,morphological_dilation,3,2
0X4DB983F2F26967CD.avi,36,687,435,252,57.931034482758626,morphological_dilation,3,2
0X4DBB637F38A94042.avi,101,2758,2282,476,20.858895705521473,morphological_dilation,3,2
0X4DBB637F38A94042.avi,118,1590,1226,364,29.690048939641112,morphological_dilation,3,2
0X4DBBB860A9E16B60.avi,98,1328,1000,328,32.800000000000004,morphological_dilation,3,2
0X4DBBB860A9E16B60.avi,112,860,596,264,44.29530201342282,morphological_dilation,3,2
0X4DC29CB827A32F23.avi,48,1565,1201,364,30.308076602830976,morphological_dilation,3,2
0X4DC29CB827A32F23.avi,65,1023,727,296,40.715268225584595,morphological_dilation,3,2
0X4DC2A9679CFE55D6.avi,95,1556,1208,348,28.807947019867548,morphological_dilation,3,2
0X4DC2A9679CFE55D6.avi,121,1226,918,308,33.551198257080614,morphological_dilation,3,2
0X4DC501859B8AD03A.avi,49,2683,2203,480,21.788470267816614,morphological_dilation,3,2
0X4DC501859B8AD03A.avi,73,1600,1212,388,32.01320132013201,morphological_dilation,3,2
0X4DC564B166185106.avi,155,1896,1504,392,26.063829787234045,morphological_dilation,3,2
0X4DC564B166185106.avi,173,1299,955,344,36.02094240837697,morphological_dilation,3,2
0X4DC5C0B02078DAA5.avi,37,1747,1352,395,29.21597633136095,morphological_dilation,3,2
0X4DC5C0B02078DAA5.avi,46,1165,818,347,42.42053789731051,morphological_dilation,3,2
0X4DCB41CC1C9FA1DB.avi,54,1622,1262,360,28.526148969889064,morphological_dilation,3,2
0X4DCB41CC1C9FA1DB.avi,70,962,664,298,44.87951807228915,morphological_dilation,3,2
0X4DCB44704D75BCB4.avi,32,1421,1073,348,32.432432432432435,morphological_dilation,3,2
0X4DCB44704D75BCB4.avi,56,977,685,292,42.627737226277375,morphological_dilation,3,2
0X4DCC1EBE5B2828F7.avi,72,1351,999,352,35.23523523523524,morphological_dilation,3,2
0X4DCC1EBE5B2828F7.avi,87,923,623,300,48.154093097913325,morphological_dilation,3,2
0X4DCDEBC261FBDD2C.avi,64,2528,2072,456,22.00772200772201,morphological_dilation,3,2
0X4DCDEBC261FBDD2C.avi,76,1797,1417,380,26.81721947776994,morphological_dilation,3,2
0X4DD35ADBF5157AE9.avi,102,1052,744,308,41.39784946236559,morphological_dilation,3,2
0X4DD35ADBF5157AE9.avi,130,1751,1387,364,26.24369142033165,morphological_dilation,3,2
0X4DD6FBB2172E0495.avi,3,1579,1187,392,33.02443133951137,morphological_dilation,3,2
0X4DD6FBB2172E0495.avi,19,1026,710,316,44.50704225352113,morphological_dilation,3,2
0X4DD7357E4FC5C36C.avi,3,1777,1373,404,29.42461762563729,morphological_dilation,3,2
0X4DD7357E4FC5C36C.avi,17,967,659,308,46.737481031866466,morphological_dilation,3,2
0X4DD8B4E886B58857.avi,51,1955,1551,404,26.047711154094134,morphological_dilation,3,2
0X4DD8B4E886B58857.avi,67,1285,950,335,35.26315789473684,morphological_dilation,3,2
0X4DD8FD6672F5D940.avi,3,1590,1226,364,29.690048939641112,morphological_dilation,3,2
0X4DD8FD6672F5D940.avi,12,990,706,284,40.226628895184135,morphological_dilation,3,2
0X4DDA207C5F52679D.avi,97,2805,2337,468,20.025673940949936,morphological_dilation,3,2
0X4DDA207C5F52679D.avi,113,1606,1234,372,30.14586709886548,morphological_dilation,3,2
0X4DDD7E9274D55C14.avi,93,1511,1139,372,32.660228270412645,morphological_dilation,3,2
0X4DDD7E9274D55C14.avi,108,824,512,312,60.9375,morphological_dilation,3,2
0X4DE81216AF40A1C6.avi,60,1331,999,332,33.233233233233236,morphological_dilation,3,2
0X4DE81216AF40A1C6.avi,79,1010,702,308,43.87464387464387,morphological_dilation,3,2
0X4DE88A7BC4B1CDCF.avi,52,1346,1006,340,33.79721669980119,morphological_dilation,3,2
0X4DE88A7BC4B1CDCF.avi,69,839,567,272,47.97178130511463,morphological_dilation,3,2
0X4DEAED0369D251DE.avi,82,2082,1646,436,26.48845686512758,morphological_dilation,3,2
0X4DEAED0369D251DE.avi,109,1343,1007,336,33.36643495531281,morphological_dilation,3,2
0X4DEF7AC168F77831.avi,3,2243,1815,428,23.581267217630856,morphological_dilation,3,2
0X4DEF7AC168F77831.avi,18,1657,1289,368,28.549262994569435,morphological_dilation,3,2
0X4DF2096646154C2C.avi,151,1853,1461,392,26.830937713894592,morphological_dilation,3,2
0X4DF2096646154C2C.avi,174,1390,1050,340,32.38095238095238,morphological_dilation,3,2
0X4DF27EE90B259A5.avi,281,1651,1295,356,27.49034749034749,morphological_dilation,3,2
0X4DF27EE90B259A5.avi,310,1039,751,288,38.348868175765645,morphological_dilation,3,2
0X4DF45F03A54748E8.avi,51,1769,1397,372,26.628489620615603,morphological_dilation,3,2
0X4DF45F03A54748E8.avi,64,1116,808,308,38.11881188118812,morphological_dilation,3,2
0X4E002858AD8C3D79.avi,69,2337,1905,432,22.677165354330707,morphological_dilation,3,2
0X4E002858AD8C3D79.avi,93,1301,953,348,36.51626442812172,morphological_dilation,3,2
0X4E028970F071735B.avi,4,2393,1961,432,22.02957674655788,morphological_dilation,3,2
0X4E028970F071735B.avi,15,1922,1542,380,24.643320363164722,morphological_dilation,3,2
0X4E04DE86F469A5F.avi,62,2529,2077,452,21.762156957149735,morphological_dilation,3,2
0X4E04DE86F469A5F.avi,75,2226,1814,412,22.712238147739804,morphological_dilation,3,2
0X4E071B7E41E2AD3C.avi,59,2566,2086,480,23.010546500479386,morphological_dilation,3,2
0X4E071B7E41E2AD3C.avi,78,1452,1069,383,35.827876520112255,morphological_dilation,3,2
0X4E08FFB6EE737DF7.avi,127,1314,986,328,33.2657200811359,morphological_dilation,3,2
0X4E08FFB6EE737DF7.avi,144,785,517,268,51.83752417794971,morphological_dilation,3,2
0X4E0955151AB91800.avi,160,2680,2216,464,20.938628158844764,morphological_dilation,3,2
0X4E0955151AB91800.avi,180,1799,1404,395,28.133903133903132,morphological_dilation,3,2
0X4E0BC2C036E928B1.avi,45,2437,1962,475,24.20998980632008,morphological_dilation,3,2
0X4E0BC2C036E928B1.avi,58,1701,1277,424,33.20281910728269,morphological_dilation,3,2
0X4E0D41E5066CDE8A.avi,40,2277,1805,472,26.14958448753463,morphological_dilation,3,2
0X4E0D41E5066CDE8A.avi,52,1454,1074,380,35.38175046554935,morphological_dilation,3,2
0X4E0EC31DCD9CFD67.avi,47,3282,2754,528,19.172113289760347,morphological_dilation,3,2
0X4E0EC31DCD9CFD67.avi,63,2572,2104,468,22.24334600760456,morphological_dilation,3,2
0X4E10843EF877019F.avi,100,1549,1205,344,28.54771784232365,morphological_dilation,3,2
0X4E10843EF877019F.avi,113,1016,724,292,40.331491712707184,morphological_dilation,3,2
0X4E10CC5FB8883477.avi,44,1748,1380,368,26.666666666666668,morphological_dilation,3,2
0X4E10CC5FB8883477.avi,57,1077,781,296,37.900128040973115,morphological_dilation,3,2
0X4E165469F6219CA.avi,62,1989,1589,400,25.173064820641912,morphological_dilation,3,2
0X4E165469F6219CA.avi,80,1306,970,336,34.63917525773196,morphological_dilation,3,2
0X4E16DBD27618153.avi,65,1523,1159,364,31.406384814495254,morphological_dilation,3,2
0X4E16DBD27618153.avi,78,913,629,284,45.151033386327505,morphological_dilation,3,2
0X4E1BF109C3950D1A.avi,49,1243,899,344,38.26473859844272,morphological_dilation,3,2
0X4E1BF109C3950D1A.avi,59,771,467,304,65.0963597430407,morphological_dilation,3,2
0X4E1CF95FB15B1B41.avi,45,1754,1346,408,30.312035661218424,morphological_dilation,3,2
0X4E1CF95FB15B1B41.avi,60,988,603,385,63.847429519071305,morphological_dilation,3,2
0X4E20A4C205622D65.avi,97,1320,988,332,33.603238866396765,morphological_dilation,3,2
0X4E20A4C205622D65.avi,109,855,579,276,47.66839378238342,morphological_dilation,3,2
0X4E2793B64C6E1697.avi,48,1900,1504,396,26.329787234042552,morphological_dilation,3,2
0X4E2793B64C6E1697.avi,62,1140,808,332,41.089108910891085,morphological_dilation,3,2
0X4E2D6ABB908ECD0E.avi,75,1631,1271,360,28.324154209284032,morphological_dilation,3,2
0X4E2D6ABB908ECD0E.avi,88,968,672,296,44.047619047619044,morphological_dilation,3,2
0X4E320712C667E02.avi,47,2506,2046,460,22.482893450635384,morphological_dilation,3,2
0X4E320712C667E02.avi,62,1602,1218,384,31.527093596059114,morphological_dilation,3,2
0X4E33F81AADBB343F.avi,65,1637,1277,360,28.191072826938136,morphological_dilation,3,2
0X4E33F81AADBB343F.avi,81,1365,1041,324,31.12391930835735,morphological_dilation,3,2
0X4E3854D3B444A40.avi,51,1939,1551,388,25.01611863313991,morphological_dilation,3,2
0X4E3854D3B444A40.avi,73,1228,904,324,35.84070796460177,morphological_dilation,3,2
0X4E38E030A745C3A7.avi,82,1680,1308,372,28.440366972477065,morphological_dilation,3,2
0X4E38E030A745C3A7.avi,98,980,696,284,40.804597701149426,morphological_dilation,3,2
0X4E399F38CE822B3D.avi,116,1845,1477,368,24.915368991198374,morphological_dilation,3,2
0X4E399F38CE822B3D.avi,131,1115,827,288,34.82466747279323,morphological_dilation,3,2
0X4E3C5105B7264BCB.avi,115,2244,1808,436,24.11504424778761,morphological_dilation,3,2
0X4E3C5105B7264BCB.avi,134,1473,1097,376,34.275296262534184,morphological_dilation,3,2
0X4E3D22FB4AFDEEE6.avi,37,2662,2175,487,22.39080459770115,morphological_dilation,3,2
0X4E3D22FB4AFDEEE6.avi,62,2079,1642,437,26.61388550548112,morphological_dilation,3,2
0X4E3E54697AC86829.avi,99,1670,1298,372,28.65947611710323,morphological_dilation,3,2
0X4E3E54697AC86829.avi,119,1041,749,292,38.98531375166889,morphological_dilation,3,2
0X4E3F9006EAE3AF6A.avi,97,1591,1215,376,30.946502057613166,morphological_dilation,3,2
0X4E3F9006EAE3AF6A.avi,114,960,649,311,47.919876733436055,morphological_dilation,3,2
0X4E40C59987FB86E4.avi,56,2071,1651,420,25.43912780133253,morphological_dilation,3,2
0X4E40C59987FB86E4.avi,73,1190,865,325,37.57225433526011,morphological_dilation,3,2
0X4E412E462075485D.avi,0,1311,974,337,34.59958932238193,morphological_dilation,3,2
0X4E412E462075485D.avi,15,911,618,293,47.41100323624595,morphological_dilation,3,2
0X4E464B347B6CF96D.avi,66,2712,2232,480,21.50537634408602,morphological_dilation,3,2
0X4E464B347B6CF96D.avi,103,1864,1460,404,27.671232876712327,morphological_dilation,3,2
0X4E4813A99BD6F4B4.avi,44,4241,3621,620,17.12234189450428,morphological_dilation,3,2
0X4E4813A99BD6F4B4.avi,58,2551,2035,516,25.356265356265357,morphological_dilation,3,2
0X4E4A2D91D3CCA44B.avi,147,1886,1479,407,27.518593644354294,morphological_dilation,3,2
0X4E4A2D91D3CCA44B.avi,161,1133,817,316,38.6780905752754,morphological_dilation,3,2
0X4E4C81F9E47142B2.avi,58,2152,1736,416,23.963133640552993,morphological_dilation,3,2
0X4E4C81F9E47142B2.avi,77,1204,879,325,36.973833902161545,morphological_dilation,3,2
0X4E4FDDC1BB14AC83.avi,38,1123,815,308,37.79141104294478,morphological_dilation,3,2
0X4E4FDDC1BB14AC83.avi,52,746,473,273,57.71670190274841,morphological_dilation,3,2
0X4E52A90E5831E39F.avi,33,3468,2948,520,17.639077340569877,morphological_dilation,3,2
0X4E52A90E5831E39F.avi,49,2312,1869,443,23.70251471375067,morphological_dilation,3,2
0X4E54F636B1924B21.avi,103,2151,1715,436,25.42274052478134,morphological_dilation,3,2
0X4E54F636B1924B21.avi,113,1435,1055,380,36.018957345971565,morphological_dilation,3,2
0X4E5765C29D7D4621.avi,39,1293,969,324,33.43653250773993,morphological_dilation,3,2
0X4E5765C29D7D4621.avi,60,1004,720,284,39.44444444444444,morphological_dilation,3,2
0X4E5A25A73BE58A0.avi,39,1550,1186,364,30.69139966273187,morphological_dilation,3,2
0X4E5A25A73BE58A0.avi,59,996,695,301,43.30935251798561,morphological_dilation,3,2
0X4E5A974D6675B7DA.avi,45,1601,1237,364,29.426030719482622,morphological_dilation,3,2
0X4E5A974D6675B7DA.avi,65,1006,706,300,42.492917847025495,morphological_dilation,3,2
0X4E5DF72148AC9F4F.avi,118,2210,1754,456,25.997719498289623,morphological_dilation,3,2
0X4E5DF72148AC9F4F.avi,134,1292,875,417,47.65714285714286,morphological_dilation,3,2
0X4E5E3D56B330AAF7.avi,33,2104,1680,424,25.238095238095237,morphological_dilation,3,2
0X4E5E3D56B330AAF7.avi,48,1311,963,348,36.13707165109034,morphological_dilation,3,2
0X4E621F66A326C49E.avi,120,1505,1161,344,29.629629629629626,morphological_dilation,3,2
0X4E621F66A326C49E.avi,131,1236,922,314,34.05639913232104,morphological_dilation,3,2
0X4E62C3793DAEB84C.avi,267,1291,959,332,34.61939520333681,morphological_dilation,3,2
0X4E62C3793DAEB84C.avi,284,854,566,288,50.8833922261484,morphological_dilation,3,2
0X4E665209F941789A.avi,68,2648,2184,464,21.245421245421245,morphological_dilation,3,2
0X4E665209F941789A.avi,82,1599,1223,376,30.744071954210956,morphological_dilation,3,2
0X4E67A3282A2BD57C.avi,65,1934,1518,416,27.40447957839262,morphological_dilation,3,2
0X4E67A3282A2BD57C.avi,84,1080,764,316,41.361256544502616,morphological_dilation,3,2
0X4E69D799006FE37A.avi,22,1714,1350,364,26.962962962962962,morphological_dilation,3,2
0X4E69D799006FE37A.avi,33,1076,792,284,35.858585858585855,morphological_dilation,3,2
0X4E6C958D54DCB463.avi,90,1864,1464,400,27.322404371584703,morphological_dilation,3,2
0X4E6C958D54DCB463.avi,103,1175,844,331,39.21800947867299,morphological_dilation,3,2
0X4E6CD95441F3C2D4.avi,42,1553,1189,364,30.613961312026916,morphological_dilation,3,2
0X4E6CD95441F3C2D4.avi,60,1107,780,327,41.92307692307693,morphological_dilation,3,2
0X4E6D554241E2AEDF.avi,185,1678,1290,388,30.077519379844965,morphological_dilation,3,2
0X4E6D554241E2AEDF.avi,198,1048,728,320,43.956043956043956,morphological_dilation,3,2
0X4E725B5FD89411A7.avi,62,1134,824,310,37.62135922330097,morphological_dilation,3,2
0X4E725B5FD89411A7.avi,86,685,422,263,62.32227488151659,morphological_dilation,3,2
0X4E75F3A54E92EE54.avi,28,1100,820,280,34.146341463414636,morphological_dilation,3,2
0X4E75F3A54E92EE54.avi,40,878,630,248,39.36507936507937,morphological_dilation,3,2
0X4E7832F9B39AD0E7.avi,86,1571,1223,348,28.454619787408014,morphological_dilation,3,2
0X4E7832F9B39AD0E7.avi,99,1174,870,304,34.94252873563218,morphological_dilation,3,2
0X4E7BAF8F68BD8886.avi,89,1222,882,340,38.54875283446712,morphological_dilation,3,2
0X4E7BAF8F68BD8886.avi,107,745,479,266,55.53235908141963,morphological_dilation,3,2
0X4E7C9CA0AD861665.avi,93,1504,1156,348,30.103806228373703,morphological_dilation,3,2
0X4E7C9CA0AD861665.avi,112,1070,758,312,41.16094986807388,morphological_dilation,3,2
0X4E7CB9094C0B9DE1.avi,25,955,667,288,43.1784107946027,morphological_dilation,3,2
0X4E7CB9094C0B9DE1.avi,36,646,388,258,66.49484536082474,morphological_dilation,3,2
0X4E81E783F4DB5B74.avi,56,951,649,302,46.5331278890601,morphological_dilation,3,2
0X4E81E783F4DB5B74.avi,75,1229,896,333,37.16517857142857,morphological_dilation,3,2
0X4E81ED16535A1BB7.avi,93,1302,958,344,35.908141962421716,morphological_dilation,3,2
0X4E81ED16535A1BB7.avi,108,1020,712,308,43.258426966292134,morphological_dilation,3,2
0X4E853239612456E5.avi,32,984,716,268,37.43016759776536,morphological_dilation,3,2
0X4E853239612456E5.avi,49,638,422,216,51.18483412322274,morphological_dilation,3,2
0X4E8ADDABFF433B57.avi,154,2399,1967,432,21.96237925775292,morphological_dilation,3,2
0X4E8ADDABFF433B57.avi,170,1987,1591,396,24.890006285355124,morphological_dilation,3,2
0X4E8DE76280B1445B.avi,142,2098,1690,408,24.142011834319526,morphological_dilation,3,2
0X4E8DE76280B1445B.avi,155,1321,997,324,32.4974924774323,morphological_dilation,3,2
0X4E90F05CC9B09307.avi,47,1835,1439,396,27.51911049339819,morphological_dilation,3,2
0X4E90F05CC9B09307.avi,66,1188,852,336,39.436619718309856,morphological_dilation,3,2
0X4E9306F55F5359D7.avi,39,1596,1218,378,31.03448275862069,morphological_dilation,3,2
0X4E9306F55F5359D7.avi,59,977,677,300,44.313146233382575,morphological_dilation,3,2
0X4E937E2B7BE93AF2.avi,74,1597,1225,372,30.36734693877551,morphological_dilation,3,2
0X4E937E2B7BE93AF2.avi,87,1171,847,324,38.252656434474616,morphological_dilation,3,2
0X4E9496513479C330.avi,32,3461,2945,516,17.521222410865875,morphological_dilation,3,2
0X4E9496513479C330.avi,56,2741,2282,459,20.11393514460999,morphological_dilation,3,2
0X4E97DA06A513F89A.avi,62,1387,1047,340,32.473734479465136,morphological_dilation,3,2
0X4E97DA06A513F89A.avi,73,943,643,300,46.65629860031104,morphological_dilation,3,2
0X4E984664E70238.avi,1,1403,1063,340,31.984948259642522,morphological_dilation,3,2
0X4E984664E70238.avi,17,977,681,296,43.4654919236417,morphological_dilation,3,2
0X4E98FC62B0018096.avi,3,2169,1745,424,24.297994269340975,morphological_dilation,3,2
0X4E98FC62B0018096.avi,17,1561,1211,350,28.901734104046245,morphological_dilation,3,2
0X4E99E59B60D1BE5B.avi,147,2282,1850,432,23.35135135135135,morphological_dilation,3,2
0X4E99E59B60D1BE5B.avi,170,1316,984,332,33.739837398373986,morphological_dilation,3,2
0X4E9A560DF17EE46B.avi,122,1347,999,348,34.83483483483483,morphological_dilation,3,2
0X4E9A560DF17EE46B.avi,138,934,645,289,44.8062015503876,morphological_dilation,3,2
0X4E9D55E9C61DB47A.avi,39,1646,1266,380,30.01579778830964,morphological_dilation,3,2
0X4E9D55E9C61DB47A.avi,53,1050,722,328,45.42936288088642,morphological_dilation,3,2
0X4E9F08061D109568.avi,1,1046,662,384,58.006042296072515,morphological_dilation,3,2
0X4E9F08061D109568.avi,59,1087,787,300,38.11944091486658,morphological_dilation,3,2
0X4EA00E9FC42DD0D8.avi,93,1359,1027,332,32.327166504381694,morphological_dilation,3,2
0X4EA00E9FC42DD0D8.avi,106,866,586,280,47.781569965870304,morphological_dilation,3,2
0X4EA078CC4E65B6A3.avi,42,4043,3021,1022,33.829857663025486,morphological_dilation,3,2
0X4EA078CC4E65B6A3.avi,61,3650,2708,942,34.78581979320532,morphological_dilation,3,2
0X4EA55CD0DC56E02E.avi,92,3274,2738,536,19.576333089846603,morphological_dilation,3,2
0X4EA55CD0DC56E02E.avi,108,1917,1497,420,28.0561122244489,morphological_dilation,3,2
0X4EA563488AF67C53.avi,81,910,634,276,43.53312302839117,morphological_dilation,3,2
0X4EA563488AF67C53.avi,90,631,399,232,58.1453634085213,morphological_dilation,3,2
0X4EA5AB16CEFE6434.avi,133,1321,985,336,34.11167512690355,morphological_dilation,3,2
0X4EA5AB16CEFE6434.avi,149,853,585,268,45.81196581196581,morphological_dilation,3,2
0X4EA6D34C1F46366F.avi,2,2543,2065,478,23.14769975786925,morphological_dilation,3,2
0X4EA6D34C1F46366F.avi,16,1888,1468,420,28.610354223433244,morphological_dilation,3,2
0X4EA930D226D84AD8.avi,71,2441,1977,464,23.469903894790086,morphological_dilation,3,2
0X4EA930D226D84AD8.avi,91,1487,1087,400,36.79852805887764,morphological_dilation,3,2
0X4EB1153ED4780B7E.avi,47,2097,1693,404,23.862965150620198,morphological_dilation,3,2
0X4EB1153ED4780B7E.avi,62,1330,998,332,33.26653306613226,morphological_dilation,3,2
0X4EB202C225CEFF2.avi,97,2392,1948,444,22.79260780287474,morphological_dilation,3,2
0X4EB202C225CEFF2.avi,116,1534,1165,369,31.673819742489272,morphological_dilation,3,2
0X4EB557C6A109190C.avi,46,1122,818,304,37.163814180929094,morphological_dilation,3,2
0X4EB557C6A109190C.avi,61,754,498,256,51.40562248995983,morphological_dilation,3,2
0X4EB55F5BF786BF5C.avi,40,3172,2672,500,18.7125748502994,morphological_dilation,3,2
0X4EB55F5BF786BF5C.avi,53,1824,1428,396,27.73109243697479,morphological_dilation,3,2
0X4EB91AA00350C857.avi,75,2185,1761,424,24.077228847245884,morphological_dilation,3,2
0X4EB91AA00350C857.avi,90,1177,845,332,39.289940828402365,morphological_dilation,3,2
0X4EBADC5362794865.avi,116,1375,1003,372,37.08873379860419,morphological_dilation,3,2
0X4EBADC5362794865.avi,130,791,515,276,53.592233009708735,morphological_dilation,3,2
0X4EC43FBE6C1D6028.avi,42,2423,1987,436,21.94262707599396,morphological_dilation,3,2
0X4EC43FBE6C1D6028.avi,61,1861,1465,396,27.030716723549485,morphological_dilation,3,2
0X4EC51376FE531C3A.avi,39,2115,1691,424,25.073920756948553,morphological_dilation,3,2
0X4EC51376FE531C3A.avi,53,1576,1206,370,30.679933665008292,morphological_dilation,3,2
0X4ECADC034CB56EF4.avi,97,2437,1985,452,22.770780856423173,morphological_dilation,3,2
0X4ECADC034CB56EF4.avi,116,1950,1542,408,26.459143968871597,morphological_dilation,3,2
0X4ECECBC46D4ACCB7.avi,2,2516,2076,440,21.19460500963391,morphological_dilation,3,2
0X4ECECBC46D4ACCB7.avi,17,1651,1291,360,27.885360185902403,morphological_dilation,3,2
0X4ECF7AF58277874E.avi,3,2665,2201,464,21.081326669695592,morphological_dilation,3,2
0X4ECF7AF58277874E.avi,19,1805,1409,396,28.105039034776436,morphological_dilation,3,2
0X4ED08C40FFA580E3.avi,167,1407,1059,348,32.86118980169972,morphological_dilation,3,2
0X4ED08C40FFA580E3.avi,177,827,547,280,51.18829981718464,morphological_dilation,3,2
0X4EDACB406C98305C.avi,1,2558,2091,467,22.33381157340985,morphological_dilation,3,2
0X4EDACB406C98305C.avi,18,1590,1218,372,30.541871921182267,morphological_dilation,3,2
0X4EDDCC9262193618.avi,41,4320,3696,624,16.883116883116884,morphological_dilation,3,2
0X4EDDCC9262193618.avi,60,2473,1977,496,25.088517956499746,morphological_dilation,3,2
0X4EDEDA9675BBA279.avi,103,2473,2017,456,22.607833415964304,morphological_dilation,3,2
0X4EDEDA9675BBA279.avi,114,2012,1604,408,25.43640897755611,morphological_dilation,3,2
0X4EE64D666DF75107.avi,105,2298,1838,460,25.0272034820457,morphological_dilation,3,2
0X4EE64D666DF75107.avi,122,1399,1023,376,36.75464320625611,morphological_dilation,3,2
0X4EEC1E7FEF4A8451.avi,45,1933,1537,396,25.764476252439817,morphological_dilation,3,2
0X4EEC1E7FEF4A8451.avi,60,1179,863,316,36.616454229432215,morphological_dilation,3,2
0X4EEC273ACACB8DC1.avi,117,1535,1167,368,31.533847472150818,morphological_dilation,3,2
0X4EEC273ACACB8DC1.avi,135,1139,835,304,36.40718562874252,morphological_dilation,3,2
0X4EED91FDB02D72F9.avi,50,1688,1309,379,28.953399541634834,morphological_dilation,3,2
0X4EED91FDB02D72F9.avi,64,983,675,308,45.62962962962963,morphological_dilation,3,2
0X4EEE65C7A3051C53.avi,3,1126,838,288,34.36754176610978,morphological_dilation,3,2
0X4EEE65C7A3051C53.avi,19,652,432,220,50.92592592592593,morphological_dilation,3,2
0X4EEE7DF904544AD2.avi,38,1201,885,316,35.706214689265536,morphological_dilation,3,2
0X4EEE7DF904544AD2.avi,55,826,550,276,50.18181818181818,morphological_dilation,3,2
0X4EEF887DA3A46D5B.avi,116,1778,1402,376,26.8188302425107,morphological_dilation,3,2
0X4EEF887DA3A46D5B.avi,135,1099,799,300,37.546933667083856,morphological_dilation,3,2
0X4EF738B9EC34D664.avi,0,2554,2114,440,20.813623462630083,morphological_dilation,3,2
0X4EF738B9EC34D664.avi,17,2110,1726,384,22.247972190034762,morphological_dilation,3,2
0X4EF859DB4F6D52D4.avi,89,1954,1554,400,25.74002574002574,morphological_dilation,3,2
0X4EF859DB4F6D52D4.avi,103,1332,992,340,34.274193548387096,morphological_dilation,3,2
0X4EF94579D05665F7.avi,121,1241,925,316,34.16216216216216,morphological_dilation,3,2
0X4EF94579D05665F7.avi,141,754,514,240,46.69260700389105,morphological_dilation,3,2
0X4EFB94EA8F9FC7C2.avi,0,1859,1479,380,25.693035835023665,morphological_dilation,3,2
0X4EFB94EA8F9FC7C2.avi,17,1698,1334,364,27.2863568215892,morphological_dilation,3,2
0X4EFBD2666D844938.avi,43,1485,1121,364,32.47100802854594,morphological_dilation,3,2
0X4EFBD2666D844938.avi,60,963,647,316,48.84080370942813,morphological_dilation,3,2
0X4EFF3AFD2E70D8B.avi,43,2461,2029,432,21.291276490882208,morphological_dilation,3,2
0X4EFF3AFD2E70D8B.avi,60,2252,1852,400,21.598272138228943,morphological_dilation,3,2
0X4F001FE7C65DEB60.avi,51,2005,1601,404,25.234228607120553,morphological_dilation,3,2
0X4F001FE7C65DEB60.avi,64,1245,925,320,34.5945945945946,morphological_dilation,3,2
0X4F00AAFE5870A218.avi,25,1877,1478,399,26.99594046008119,morphological_dilation,3,2
0X4F00AAFE5870A218.avi,35,1162,826,336,40.67796610169492,morphological_dilation,3,2
0X4F01C58EAA0EAF38.avi,58,2164,1704,460,26.995305164319248,morphological_dilation,3,2
0X4F01C58EAA0EAF38.avi,71,1520,1128,392,34.751773049645394,morphological_dilation,3,2
0X4F02DBDF1B8E730A.avi,28,867,611,256,41.89852700490999,morphological_dilation,3,2
0X4F02DBDF1B8E730A.avi,43,607,363,244,67.21763085399449,morphological_dilation,3,2
0X4F0312061571DC46.avi,116,1546,1194,352,29.48073701842546,morphological_dilation,3,2
0X4F0312061571DC46.avi,130,1057,769,288,37.45123537061119,morphological_dilation,3,2
0X4F052EF179738E8.avi,47,1920,1501,419,27.9147235176549,morphological_dilation,3,2
0X4F052EF179738E8.avi,64,1095,764,331,43.324607329842934,morphological_dilation,3,2
0X4F068B5E4772C3B1.avi,53,1873,1485,388,26.127946127946128,morphological_dilation,3,2
0X4F068B5E4772C3B1.avi,68,1503,1155,348,30.129870129870127,morphological_dilation,3,2
0X4F07C596C53C9A0E.avi,67,1427,1099,328,29.845313921747042,morphological_dilation,3,2
0X4F07C596C53C9A0E.avi,82,1244,944,300,31.779661016949152,morphological_dilation,3,2
0X4F07CA07E28A03F2.avi,42,1608,1229,379,30.838079739625712,morphological_dilation,3,2
0X4F07CA07E28A03F2.avi,60,902,614,288,46.90553745928339,morphological_dilation,3,2
0X4F0A56451DADD1E8.avi,112,2040,1636,404,24.69437652811736,morphological_dilation,3,2
0X4F0A56451DADD1E8.avi,131,1549,1213,336,27.699917559769165,morphological_dilation,3,2
0X4F13D40DFB6D079F.avi,88,1348,1012,336,33.201581027667984,morphological_dilation,3,2
0X4F13D40DFB6D079F.avi,104,818,550,268,48.72727272727273,morphological_dilation,3,2
0X4F151B857306CD84.avi,87,1371,1043,328,31.447746883988493,morphological_dilation,3,2
0X4F151B857306CD84.avi,104,786,510,276,54.11764705882353,morphological_dilation,3,2
0X4F15F814B6C4AC07.avi,135,1434,1102,332,30.127041742286753,morphological_dilation,3,2
0X4F15F814B6C4AC07.avi,151,1192,896,296,33.035714285714285,morphological_dilation,3,2
0X4F1634C33E5A0522.avi,90,1891,1511,380,25.148908007941763,morphological_dilation,3,2
0X4F1634C33E5A0522.avi,108,1148,844,304,36.018957345971565,morphological_dilation,3,2
0X4F1931029A1D9934.avi,55,2449,1997,452,22.633950926389584,morphological_dilation,3,2
0X4F1931029A1D9934.avi,71,1758,1362,396,29.074889867841406,morphological_dilation,3,2
0X4F1B9F3892A85EB7.avi,42,1435,1067,368,34.4892221180881,morphological_dilation,3,2
0X4F1B9F3892A85EB7.avi,55,881,573,308,53.752181500872595,morphological_dilation,3,2
0X4F1C516BC97B41EE.avi,79,1757,1381,376,27.226647356987687,morphological_dilation,3,2
0X4F1C516BC97B41EE.avi,95,1467,1119,348,31.099195710455763,morphological_dilation,3,2
0X4F1F34E939FC2557.avi,65,1291,955,336,35.18324607329843,morphological_dilation,3,2
0X4F1F34E939FC2557.avi,78,876,604,272,45.033112582781456,morphological_dilation,3,2
0X4F20288846F54AAD.avi,87,1714,1322,392,29.652042360060516,morphological_dilation,3,2
0X4F20288846F54AAD.avi,99,1001,701,300,42.796005706134096,morphological_dilation,3,2
0X4F2FCFDBC0A1DD38.avi,3,2171,1759,412,23.42239909039227,morphological_dilation,3,2
0X4F2FCFDBC0A1DD38.avi,20,1352,1028,324,31.517509727626457,morphological_dilation,3,2
0X4F2FF2F686A266C3.avi,46,1903,1519,384,25.279789335088875,morphological_dilation,3,2
0X4F2FF2F686A266C3.avi,61,1124,812,312,38.42364532019704,morphological_dilation,3,2
0X4F30FC9068E8FE43.avi,162,1435,1083,352,32.50230840258541,morphological_dilation,3,2
0X4F30FC9068E8FE43.avi,176,952,648,304,46.913580246913575,morphological_dilation,3,2
0X4F331FB817B1F3BE.avi,49,1374,1038,336,32.369942196531795,morphological_dilation,3,2
0X4F331FB817B1F3BE.avi,61,795,539,256,47.49536178107607,morphological_dilation,3,2
0X4F38559E6842E6B9.avi,109,2000,1600,400,25.0,morphological_dilation,3,2
0X4F38559E6842E6B9.avi,121,1219,903,316,34.99446290143965,morphological_dilation,3,2
0X4F3D2A57AE67F1BA.avi,45,1651,1243,408,32.82381335478681,morphological_dilation,3,2
0X4F3D2A57AE67F1BA.avi,61,969,625,344,55.04,morphological_dilation,3,2
0X4F3E4E3D41B3880F.avi,92,1583,1223,360,29.435813573180702,morphological_dilation,3,2
0X4F3E4E3D41B3880F.avi,106,1056,756,300,39.682539682539684,morphological_dilation,3,2
0X4F3EA3910326F0CC.avi,58,1778,1406,372,26.458036984352773,morphological_dilation,3,2
0X4F3EA3910326F0CC.avi,76,1098,794,304,38.287153652392945,morphological_dilation,3,2
0X4F3FE52D34FEC127.avi,39,1185,865,320,36.99421965317919,morphological_dilation,3,2
0X4F3FE52D34FEC127.avi,52,707,442,265,59.95475113122172,morphological_dilation,3,2
0X4F421A5FB2E90A22.avi,40,1617,1269,348,27.423167848699766,morphological_dilation,3,2
0X4F421A5FB2E90A22.avi,57,1395,1067,328,30.740393626991562,morphological_dilation,3,2
0X4F4419A0DFA94461.avi,85,1386,1050,336,32.0,morphological_dilation,3,2
0X4F4419A0DFA94461.avi,97,880,600,280,46.666666666666664,morphological_dilation,3,2
0X4F47E30FDD6BE447.avi,108,1763,1379,384,27.846265409717187,morphological_dilation,3,2
0X4F47E30FDD6BE447.avi,120,1383,1051,332,31.588962892483348,morphological_dilation,3,2
0X4F48415B343A0D90.avi,68,2288,1832,456,24.890829694323145,morphological_dilation,3,2
0X4F48415B343A0D90.avi,82,1289,921,368,39.95656894679696,morphological_dilation,3,2
0X4F4BB57DAEE2B13E.avi,45,1685,1305,380,29.118773946360154,morphological_dilation,3,2
0X4F4BB57DAEE2B13E.avi,59,1152,824,328,39.80582524271845,morphological_dilation,3,2
0X4F4D1ACDEAAD616D.avi,117,1366,1046,320,30.592734225621417,morphological_dilation,3,2
0X4F4D1ACDEAAD616D.avi,136,872,592,280,47.2972972972973,morphological_dilation,3,2
0X4F4F64C47B366DC9.avi,99,1400,1028,372,36.18677042801556,morphological_dilation,3,2
0X4F4F64C47B366DC9.avi,118,971,663,308,46.45550527903469,morphological_dilation,3,2
0X4F536E88702468E5.avi,57,1787,1378,409,29.680696661828737,morphological_dilation,3,2
0X4F536E88702468E5.avi,75,1048,728,320,43.956043956043956,morphological_dilation,3,2
0X4F5499DDFF536F69.avi,86,2761,2261,500,22.114108801415302,morphological_dilation,3,2
0X4F5499DDFF536F69.avi,120,2068,1640,428,26.097560975609756,morphological_dilation,3,2
0X4F55DBA9FA2C8A16.avi,2,1548,1200,348,28.999999999999996,morphological_dilation,3,2
0X4F55DBA9FA2C8A16.avi,18,1125,821,304,37.028014616321556,morphological_dilation,3,2
0X4F582A71F1FF7D0D.avi,64,1660,1308,352,26.911314984709477,morphological_dilation,3,2
0X4F582A71F1FF7D0D.avi,77,1038,750,288,38.4,morphological_dilation,3,2
0X4F599EF3B97B2074.avi,35,1368,1040,328,31.538461538461537,morphological_dilation,3,2
0X4F599EF3B97B2074.avi,51,874,590,284,48.13559322033898,morphological_dilation,3,2
0X4F5AC6C6E87FE738.avi,39,1976,1584,392,24.747474747474747,morphological_dilation,3,2
0X4F5AC6C6E87FE738.avi,53,1706,1338,368,27.50373692077728,morphological_dilation,3,2
0X4F67102FD11ACB40.avi,97,2358,1914,444,23.197492163009404,morphological_dilation,3,2
0X4F67102FD11ACB40.avi,114,1625,1225,400,32.6530612244898,morphological_dilation,3,2
0X4F6A027D4F2767D2.avi,116,1392,1036,356,34.36293436293436,morphological_dilation,3,2
0X4F6A027D4F2767D2.avi,129,920,632,288,45.56962025316456,morphological_dilation,3,2
0X4F6EAF6EA9D0D4AA.avi,91,1922,1514,408,26.948480845442536,morphological_dilation,3,2
0X4F6EAF6EA9D0D4AA.avi,105,1179,851,328,38.54289071680376,morphological_dilation,3,2
0X4F75447642EB2B26.avi,37,2159,1739,420,24.15181138585394,morphological_dilation,3,2
0X4F75447642EB2B26.avi,51,1287,947,340,35.90285110876452,morphological_dilation,3,2
0X4F7741E1C11B62D0.avi,80,1812,1412,400,28.328611898016998,morphological_dilation,3,2
0X4F7741E1C11B62D0.avi,94,1067,743,324,43.60699865410498,morphological_dilation,3,2
0X4F78BDF6D975B3F4.avi,59,2660,2170,490,22.58064516129032,morphological_dilation,3,2
0X4F78BDF6D975B3F4.avi,74,1661,1249,412,32.986389111289036,morphological_dilation,3,2
0X4F8669AE1E9EF98A.avi,55,2219,1779,440,24.73299606520517,morphological_dilation,3,2
0X4F8669AE1E9EF98A.avi,71,1281,923,358,38.78656554712892,morphological_dilation,3,2
0X4F881958C896CE48.avi,2,1502,1146,356,31.064572425828967,morphological_dilation,3,2
0X4F881958C896CE48.avi,18,915,627,288,45.933014354066984,morphological_dilation,3,2
0X4F8859C8AB4DA9CB.avi,1,1206,968,238,24.586776859504134,morphological_dilation,3,2
0X4F8859C8AB4DA9CB.avi,22,1091,806,285,35.359801488833746,morphological_dilation,3,2
0X4F89846030713617.avi,106,1822,1444,378,26.177285318559555,morphological_dilation,3,2
0X4F89846030713617.avi,122,1264,944,320,33.89830508474576,morphological_dilation,3,2
0X4F8A67FD2D22326D.avi,38,1540,1184,356,30.067567567567565,morphological_dilation,3,2
0X4F8A67FD2D22326D.avi,54,1006,714,292,40.896358543417364,morphological_dilation,3,2
0X4F91266598DC110C.avi,4,1604,1216,388,31.907894736842106,morphological_dilation,3,2
0X4F91266598DC110C.avi,22,1013,677,336,49.63072378138848,morphological_dilation,3,2
0X4F919DE23C2FA6E2.avi,95,1915,1519,396,26.0697827518104,morphological_dilation,3,2
0X4F919DE23C2FA6E2.avi,115,1124,808,316,39.10891089108911,morphological_dilation,3,2
0X4F940270E621C80F.avi,37,2044,1624,420,25.862068965517242,morphological_dilation,3,2
0X4F940270E621C80F.avi,50,1474,1120,354,31.607142857142854,morphological_dilation,3,2
0X4F963A8803EE27E1.avi,0,2212,1772,440,24.830699774266364,morphological_dilation,3,2
0X4F963A8803EE27E1.avi,19,1332,992,340,34.274193548387096,morphological_dilation,3,2
0X4F96D302CB820C76.avi,97,1742,1358,384,28.276877761413843,morphological_dilation,3,2
0X4F96D302CB820C76.avi,113,988,696,292,41.95402298850575,morphological_dilation,3,2
0X4F98D02DFC3B1946.avi,76,1474,1118,356,31.84257602862254,morphological_dilation,3,2
0X4F98D02DFC3B1946.avi,92,945,653,292,44.716692189892804,morphological_dilation,3,2
0X4F9A4229C54DA391.avi,46,1773,1385,388,28.014440433212997,morphological_dilation,3,2
0X4F9A4229C54DA391.avi,60,1050,718,332,46.239554317548745,morphological_dilation,3,2
0X4F9AAFE15DEFF1DD.avi,2,2320,1880,440,23.404255319148938,morphological_dilation,3,2
0X4F9AAFE15DEFF1DD.avi,20,1446,1082,364,33.64140480591497,morphological_dilation,3,2
0X4FA293CB5DA42464.avi,65,2036,1632,404,24.754901960784316,morphological_dilation,3,2
0X4FA293CB5DA42464.avi,81,1316,972,344,35.390946502057616,morphological_dilation,3,2
0X4FA94B7C48199688.avi,51,1552,1168,384,32.87671232876712,morphological_dilation,3,2
0X4FA94B7C48199688.avi,69,896,588,308,52.38095238095239,morphological_dilation,3,2
0X4FAB297B6620A2AB.avi,136,2630,2166,464,21.421975992613113,morphological_dilation,3,2
0X4FAB297B6620A2AB.avi,152,1644,1250,394,31.52,morphological_dilation,3,2
0X4FACABF5BA7D337.avi,104,1911,1511,400,26.472534745201852,morphological_dilation,3,2
0X4FACABF5BA7D337.avi,114,1265,937,328,35.005336179295625,morphological_dilation,3,2
0X4FAD323C9963C4C5.avi,46,1953,1561,392,25.112107623318387,morphological_dilation,3,2
0X4FAD323C9963C4C5.avi,61,1156,852,304,35.68075117370892,morphological_dilation,3,2
0X4FB1EC855B216E1A.avi,99,1457,1113,344,30.90745732255166,morphological_dilation,3,2
0X4FB1EC855B216E1A.avi,113,985,685,300,43.79562043795621,morphological_dilation,3,2
0X4FB7C9EF56491F44.avi,41,3239,2690,549,20.4089219330855,morphological_dilation,3,2
0X4FB7C9EF56491F44.avi,64,1893,1433,460,32.10048848569434,morphological_dilation,3,2
0X4FB86E58433D484.avi,42,2208,1784,424,23.766816143497756,morphological_dilation,3,2
0X4FB86E58433D484.avi,59,2008,1600,408,25.5,morphological_dilation,3,2
0X4FB8E429239BF340.avi,45,2047,1611,436,27.063935443823713,morphological_dilation,3,2
0X4FB8E429239BF340.avi,56,1202,858,344,40.0932400932401,morphological_dilation,3,2
0X4FBBACA1DE70DD6.avi,98,1407,1055,352,33.36492890995261,morphological_dilation,3,2
0X4FBBACA1DE70DD6.avi,117,945,641,304,47.425897035881434,morphological_dilation,3,2
0X4FC889C80C584428.avi,69,1117,821,296,36.05359317904993,morphological_dilation,3,2
0X4FC889C80C584428.avi,87,694,446,248,55.60538116591929,morphological_dilation,3,2
0X4FCDB057B0CDE7DF.avi,46,2033,1629,404,24.80049109883364,morphological_dilation,3,2
0X4FCDB057B0CDE7DF.avi,63,1364,1016,348,34.25196850393701,morphological_dilation,3,2
0X4FCE535BE53FAB25.avi,102,1864,1464,400,27.322404371584703,morphological_dilation,3,2
0X4FCE535BE53FAB25.avi,122,1079,779,300,38.51091142490372,morphological_dilation,3,2
0X4FDA647A573CBE00.avi,88,2001,1581,420,26.56546489563567,morphological_dilation,3,2
0X4FDA647A573CBE00.avi,102,1228,892,336,37.66816143497758,morphological_dilation,3,2
0X4FDFAA192A4C1A34.avi,42,1611,1259,352,27.95869737887212,morphological_dilation,3,2
0X4FDFAA192A4C1A34.avi,56,1171,865,306,35.3757225433526,morphological_dilation,3,2
0X4FE2CBC9422F019B.avi,123,2258,1842,416,22.58414766558089,morphological_dilation,3,2
0X4FE2CBC9422F019B.avi,146,1533,1165,368,31.587982832618028,morphological_dilation,3,2
0X4FEC9915044DD151.avi,1,1487,1139,348,30.553116769095702,morphological_dilation,3,2
0X4FEC9915044DD151.avi,14,1109,808,301,37.25247524752475,morphological_dilation,3,2
0X4FF3346B3C8EC3AB.avi,43,1770,1382,388,28.075253256150507,morphological_dilation,3,2
0X4FF3346B3C8EC3AB.avi,58,1131,795,336,42.26415094339623,morphological_dilation,3,2
0X4FFC94D07CF61F1D.avi,77,1712,1336,376,28.143712574850298,morphological_dilation,3,2
0X4FFC94D07CF61F1D.avi,99,1479,1126,353,31.349911190053287,morphological_dilation,3,2
0X500329C3351ED572.avi,65,2251,1800,451,25.055555555555554,morphological_dilation,3,2
0X500329C3351ED572.avi,101,1484,1044,440,42.1455938697318,morphological_dilation,3,2
0X500FC4E8716B0A8F.avi,63,1176,876,300,34.24657534246575,morphological_dilation,3,2
0X500FC4E8716B0A8F.avi,97,1526,1137,389,34.212840809146876,morphological_dilation,3,2
0X50123D34D2500DE7.avi,49,2964,2468,496,20.097244732576986,morphological_dilation,3,2
0X50123D34D2500DE7.avi,68,2257,1794,463,25.808249721293198,morphological_dilation,3,2
0X50138BF24E34070.avi,75,1097,785,312,39.74522292993631,morphological_dilation,3,2
0X50138BF24E34070.avi,87,709,449,260,57.906458797327396,morphological_dilation,3,2
0X501B99B68693CCE1.avi,65,2920,2432,488,20.065789473684212,morphological_dilation,3,2
0X501B99B68693CCE1.avi,82,1835,1447,388,26.81409813407049,morphological_dilation,3,2
0X50249BC3755317E9.avi,60,1932,1544,388,25.129533678756477,morphological_dilation,3,2
0X50249BC3755317E9.avi,78,1672,1313,359,27.341964965727346,morphological_dilation,3,2
0X50273065E4D6B4ED.avi,94,2954,2466,488,19.78913219789132,morphological_dilation,3,2
0X50273065E4D6B4ED.avi,103,1693,1281,412,32.16237314597971,morphological_dilation,3,2
0X502AEA12E5BBB9D2.avi,87,2184,1728,456,26.38888888888889,morphological_dilation,3,2
0X502AEA12E5BBB9D2.avi,110,1293,921,372,40.390879478827365,morphological_dilation,3,2
0X5031E6955F4365B4.avi,110,2639,2179,460,21.11060119320789,morphological_dilation,3,2
0X5031E6955F4365B4.avi,130,1692,1314,378,28.767123287671232,morphological_dilation,3,2
0X503525FC85147E0C.avi,67,1424,1076,348,32.342007434944236,morphological_dilation,3,2
0X503525FC85147E0C.avi,80,847,583,264,45.28301886792453,morphological_dilation,3,2
0X503BD718C4BF61C3.avi,47,1915,1513,402,26.569729015201588,morphological_dilation,3,2
0X503BD718C4BF61C3.avi,66,1138,810,328,40.49382716049383,morphological_dilation,3,2
0X50427F902D83EA24.avi,87,1778,1386,392,28.28282828282828,morphological_dilation,3,2
0X50427F902D83EA24.avi,104,1282,942,340,36.09341825902335,morphological_dilation,3,2
0X5042C6AB36212224.avi,69,3021,2485,536,21.569416498993963,morphological_dilation,3,2
0X5042C6AB36212224.avi,89,2267,1791,476,26.577331099944164,morphological_dilation,3,2
0X505828C7FAF08FAF.avi,37,1496,1144,352,30.76923076923077,morphological_dilation,3,2
0X505828C7FAF08FAF.avi,56,1032,732,300,40.98360655737705,morphological_dilation,3,2
0X5069F73ECE751F8B.avi,40,1888,1496,392,26.203208556149733,morphological_dilation,3,2
0X5069F73ECE751F8B.avi,60,1401,1033,368,35.6243949661181,morphological_dilation,3,2
0X506A4B034D096FD7.avi,103,1941,1561,380,24.343369634849456,morphological_dilation,3,2
0X506A4B034D096FD7.avi,118,1414,1074,340,31.65735567970205,morphological_dilation,3,2
0X506EEAD6511D811C.avi,51,1777,1358,419,30.85419734904271,morphological_dilation,3,2
0X506EEAD6511D811C.avi,62,1147,783,364,46.487867177522354,morphological_dilation,3,2
0X5070727F1ECC8DD4.avi,54,1576,1220,356,29.18032786885246,morphological_dilation,3,2
0X5070727F1ECC8DD4.avi,67,1070,758,312,41.16094986807388,morphological_dilation,3,2
0X50718C14D74E7486.avi,110,2428,1948,480,24.64065708418891,morphological_dilation,3,2
0X50718C14D74E7486.avi,125,1616,1196,420,35.11705685618729,morphological_dilation,3,2
0X5071B146A249B859.avi,38,1896,1508,388,25.72944297082228,morphological_dilation,3,2
0X5071B146A249B859.avi,54,1032,732,300,40.98360655737705,morphological_dilation,3,2
0X507257F3C2959527.avi,37,1951,1547,404,26.11506140917906,morphological_dilation,3,2
0X507257F3C2959527.avi,50,1321,972,349,35.90534979423868,morphological_dilation,3,2
0X5077E67FD3C011C.avi,43,1847,1463,384,26.247436773752565,morphological_dilation,3,2
0X5077E67FD3C011C.avi,61,1261,933,328,35.155412647374064,morphological_dilation,3,2
0X507C7C082EA6B68F.avi,87,2257,1853,404,21.80248246087426,morphological_dilation,3,2
0X507C7C082EA6B68F.avi,106,1523,1173,350,29.838022165387894,morphological_dilation,3,2
0X50807FBC49B44ED4.avi,43,6303,5689,614,10.792757953946213,morphological_dilation,3,2
0X50807FBC49B44ED4.avi,58,4047,3419,628,18.367943843229014,morphological_dilation,3,2
0X5083D1646DF2023E.avi,37,1679,1299,380,29.253271747498076,morphological_dilation,3,2
0X5083D1646DF2023E.avi,65,1038,734,304,41.41689373297003,morphological_dilation,3,2
0X50843AB0C28327D4.avi,101,1399,1063,336,31.60865475070555,morphological_dilation,3,2
0X50843AB0C28327D4.avi,112,915,623,292,46.869983948635635,morphological_dilation,3,2
0X508601D38C7D0090.avi,5,1813,1429,384,26.871938418474457,morphological_dilation,3,2
0X508601D38C7D0090.avi,16,1157,849,308,36.27797408716137,morphological_dilation,3,2
0X5089EB6EC06D2181.avi,85,2755,2299,456,19.834710743801654,morphological_dilation,3,2
0X5089EB6EC06D2181.avi,106,2191,1791,400,22.33389168062535,morphological_dilation,3,2
0X508FD6CD0EA0699D.avi,71,1920,1532,388,25.326370757180154,morphological_dilation,3,2
0X508FD6CD0EA0699D.avi,89,1417,1066,351,32.926829268292686,morphological_dilation,3,2
0X508FE72264BBC1D2.avi,81,1556,1196,360,30.100334448160538,morphological_dilation,3,2
0X508FE72264BBC1D2.avi,98,1069,757,312,41.21532364597093,morphological_dilation,3,2
0X5090FDBDC644DDBB.avi,74,1860,1437,423,29.436325678496868,morphological_dilation,3,2
0X5090FDBDC644DDBB.avi,93,1138,776,362,46.649484536082475,morphological_dilation,3,2
0X50915122F649829D.avi,84,2214,1775,439,24.732394366197184,morphological_dilation,3,2
0X50915122F649829D.avi,98,1401,1027,374,36.416747809152874,morphological_dilation,3,2
0X50974B4CA53CDE5A.avi,60,1550,1198,352,29.382303839732888,morphological_dilation,3,2
0X50974B4CA53CDE5A.avi,77,1105,809,296,36.58838071693449,morphological_dilation,3,2
0X5098726A21007991.avi,139,1370,1014,356,35.108481262327416,morphological_dilation,3,2
0X5098726A21007991.avi,166,1068,745,323,43.355704697986575,morphological_dilation,3,2
0X509943F2C5C692C1.avi,46,1896,1504,392,26.063829787234045,morphological_dilation,3,2
0X509943F2C5C692C1.avi,60,1071,763,308,40.36697247706422,morphological_dilation,3,2
0X509B4E8F6B3C73F7.avi,49,1417,1073,344,32.059645852749306,morphological_dilation,3,2
0X509B4E8F6B3C73F7.avi,65,1101,797,304,38.14303638644919,morphological_dilation,3,2
0X509C9EE624629703.avi,37,1592,1244,348,27.974276527331188,morphological_dilation,3,2
0X509C9EE624629703.avi,52,1027,731,296,40.49247606019152,morphological_dilation,3,2
0X50A01D7C0D1E0E45.avi,49,1583,1211,372,30.718414533443433,morphological_dilation,3,2
0X50A01D7C0D1E0E45.avi,70,955,594,361,60.77441077441077,morphological_dilation,3,2
0X50A161F5290B4A01.avi,75,1633,1265,368,29.09090909090909,morphological_dilation,3,2
0X50A161F5290B4A01.avi,86,1398,1050,348,33.14285714285714,morphological_dilation,3,2
0X50A22335DC1C7A37.avi,39,1590,1194,396,33.165829145728644,morphological_dilation,3,2
0X50A22335DC1C7A37.avi,52,837,506,331,65.41501976284584,morphological_dilation,3,2
0X50AA85E1108DD28D.avi,153,1887,1503,384,25.54890219560878,morphological_dilation,3,2
0X50AA85E1108DD28D.avi,168,1168,839,329,39.213349225268175,morphological_dilation,3,2
0X50AB04A900534867.avi,99,2101,1678,423,25.208581644815258,morphological_dilation,3,2
0X50AB04A900534867.avi,114,1362,998,364,36.47294589178357,morphological_dilation,3,2
0X50ADAC3EEB4348E3.avi,45,1799,1419,380,26.779422128259338,morphological_dilation,3,2
0X50ADAC3EEB4348E3.avi,63,1099,807,292,36.18339529120198,morphological_dilation,3,2
0X50AF86577B0E0C0.avi,3,1521,1177,344,29.226847918436704,morphological_dilation,3,2
0X50AF86577B0E0C0.avi,17,1346,1014,332,32.74161735700197,morphological_dilation,3,2
0X50B19C247881BBAD.avi,63,1083,779,304,39.02439024390244,morphological_dilation,3,2
0X50B19C247881BBAD.avi,85,640,412,228,55.33980582524271,morphological_dilation,3,2
0X50B2490FF86A89ED.avi,65,2067,1656,411,24.818840579710145,morphological_dilation,3,2
0X50B2490FF86A89ED.avi,83,1482,1130,352,31.150442477876105,morphological_dilation,3,2
0X50B4E37239529E65.avi,67,1723,1355,368,27.158671586715865,morphological_dilation,3,2
0X50B4E37239529E65.avi,81,1202,878,324,36.90205011389522,morphological_dilation,3,2
0X50C66E404592BE7.avi,52,1495,1139,356,31.255487269534683,morphological_dilation,3,2
0X50C66E404592BE7.avi,67,936,632,304,48.10126582278481,morphological_dilation,3,2
0X50D4A9CD65B07152.avi,148,2042,1606,436,27.14819427148194,morphological_dilation,3,2
0X50D4A9CD65B07152.avi,161,1646,1238,408,32.956381260096926,morphological_dilation,3,2
0X50D89DBCD571E45A.avi,77,2395,1959,436,22.256253190403267,morphological_dilation,3,2
0X50D89DBCD571E45A.avi,93,1458,1070,388,36.26168224299066,morphological_dilation,3,2
0X50D9093629F3BA7B.avi,54,2002,1618,384,23.73300370828183,morphological_dilation,3,2
0X50D9093629F3BA7B.avi,71,1450,1110,340,30.630630630630627,morphological_dilation,3,2
0X50DA3CD732256F5C.avi,38,1038,742,296,39.892183288409704,morphological_dilation,3,2
0X50DA3CD732256F5C.avi,53,832,568,264,46.478873239436616,morphological_dilation,3,2
0X50DCD68550B88271.avi,46,1852,1452,400,27.548209366391184,morphological_dilation,3,2
0X50DCD68550B88271.avi,63,1247,891,356,39.95510662177329,morphological_dilation,3,2
0X50E1A609EDB71DDE.avi,88,2133,1725,408,23.652173913043477,morphological_dilation,3,2
0X50E1A609EDB71DDE.avi,102,1496,1160,336,28.965517241379313,morphological_dilation,3,2
0X50EFCFC1C29B956D.avi,38,1298,946,352,37.2093023255814,morphological_dilation,3,2
0X50EFCFC1C29B956D.avi,52,871,558,313,56.09318996415771,morphological_dilation,3,2
0X50EFE29884414EC2.avi,139,1952,1536,416,27.083333333333332,morphological_dilation,3,2
0X50EFE29884414EC2.avi,157,1376,1003,373,37.188434695912264,morphological_dilation,3,2
0X50F1A619EA4634A1.avi,39,1720,1344,376,27.976190476190478,morphological_dilation,3,2
0X50F1A619EA4634A1.avi,57,1212,884,328,37.10407239819005,morphological_dilation,3,2
0X50F2DBBCDE495383.avi,80,1699,1335,364,27.265917602996254,morphological_dilation,3,2
0X50F2DBBCDE495383.avi,95,1080,772,308,39.89637305699482,morphological_dilation,3,2
0X50F561E08B87FD73.avi,43,1523,1183,340,28.740490278951818,morphological_dilation,3,2
0X50F561E08B87FD73.avi,53,951,659,292,44.30955993930198,morphological_dilation,3,2
0X50F967F1598F990.avi,88,1878,1482,396,26.720647773279353,morphological_dilation,3,2
0X50F967F1598F990.avi,106,1520,1168,352,30.136986301369863,morphological_dilation,3,2
0X50F9F19FB81D504C.avi,46,1588,1192,396,33.22147651006711,morphological_dilation,3,2
0X50F9F19FB81D504C.avi,59,992,652,340,52.14723926380368,morphological_dilation,3,2
0X5100C0F7F0AF1B58.avi,0,1983,1575,408,25.9047619047619,morphological_dilation,3,2
0X5100C0F7F0AF1B58.avi,17,1134,810,324,40.0,morphological_dilation,3,2
0X510159059AAA7201.avi,85,2116,1718,398,23.166472642607683,morphological_dilation,3,2
0X510159059AAA7201.avi,99,1706,1346,360,26.74591381872214,morphological_dilation,3,2
0X5107F84375998635.avi,51,1856,1448,408,28.176795580110497,morphological_dilation,3,2
0X5107F84375998635.avi,69,1160,812,348,42.857142857142854,morphological_dilation,3,2
0X51097AF8AA3331ED.avi,1,1148,818,330,40.34229828850856,morphological_dilation,3,2
0X51097AF8AA3331ED.avi,17,848,562,286,50.88967971530249,morphological_dilation,3,2
0X510CBB5CB06F937B.avi,213,1272,960,312,32.5,morphological_dilation,3,2
0X510CBB5CB06F937B.avi,221,871,595,276,46.38655462184874,morphological_dilation,3,2
0X510DF8DD83561A78.avi,40,1717,1361,356,26.15723732549596,morphological_dilation,3,2
0X510DF8DD83561A78.avi,54,1089,801,288,35.95505617977528,morphological_dilation,3,2
0X510F6BFB4FBA32E.avi,51,2026,1619,407,25.138974675725756,morphological_dilation,3,2
0X510F6BFB4FBA32E.avi,70,1523,1156,367,31.747404844290656,morphological_dilation,3,2
0X510FF9F679F312C2.avi,41,2565,2073,492,23.733719247467437,morphological_dilation,3,2
0X510FF9F679F312C2.avi,57,1638,1222,416,34.04255319148936,morphological_dilation,3,2
0X51150E423F255843.avi,97,1812,1428,384,26.89075630252101,morphological_dilation,3,2
0X51150E423F255843.avi,117,1253,917,336,36.6412213740458,morphological_dilation,3,2
0X5115DAC6AB92DF56.avi,54,2075,1652,423,25.605326876513317,morphological_dilation,3,2
0X5115DAC6AB92DF56.avi,75,1282,926,356,38.44492440604751,morphological_dilation,3,2
0X511728C63B70B4B1.avi,104,2324,1888,436,23.093220338983052,morphological_dilation,3,2
0X511728C63B70B4B1.avi,121,1728,1340,388,28.955223880597014,morphological_dilation,3,2
0X5118B4340358A520.avi,2,1809,1422,387,27.21518987341772,morphological_dilation,3,2
0X5118B4340358A520.avi,23,1211,872,339,38.87614678899082,morphological_dilation,3,2
0X511C9798FB92301C.avi,32,2420,1985,435,21.91435768261965,morphological_dilation,3,2
0X511C9798FB92301C.avi,60,1665,1297,368,28.373168851195064,morphological_dilation,3,2
0X511D25AE9C39685C.avi,36,884,608,276,45.39473684210527,morphological_dilation,3,2
0X511D25AE9C39685C.avi,49,595,361,234,64.81994459833795,morphological_dilation,3,2
0X5121D9B6B28A9A0D.avi,244,1517,1165,352,30.21459227467811,morphological_dilation,3,2
0X5121D9B6B28A9A0D.avi,269,1008,711,297,41.77215189873418,morphological_dilation,3,2
0X512232C545DBCE9F.avi,97,1216,894,322,36.017897091722595,morphological_dilation,3,2
0X512232C545DBCE9F.avi,108,949,657,292,44.44444444444444,morphological_dilation,3,2
0X5122FEA094776B90.avi,40,1960,1560,400,25.64102564102564,morphological_dilation,3,2
0X5122FEA094776B90.avi,60,1641,1277,364,28.50430696945967,morphological_dilation,3,2
0X5125B39CB59E5FBE.avi,35,1935,1507,428,28.400796284007964,morphological_dilation,3,2
0X5125B39CB59E5FBE.avi,52,1326,974,352,36.139630390143736,morphological_dilation,3,2
0X5126AE3A3650D66B.avi,72,2073,1649,424,25.712553062462096,morphological_dilation,3,2
0X5126AE3A3650D66B.avi,85,1566,1202,364,30.282861896838604,morphological_dilation,3,2
0X51276E90BFD4E4C0.avi,97,1254,934,320,34.26124197002141,morphological_dilation,3,2
0X51276E90BFD4E4C0.avi,119,753,490,263,53.673469387755105,morphological_dilation,3,2
0X512845940E60D485.avi,131,3188,2668,520,19.490254872563717,morphological_dilation,3,2
0X512845940E60D485.avi,151,1871,1483,388,26.163182737693862,morphological_dilation,3,2
0X512A035A01A6C549.avi,83,1456,1094,362,33.089579524680076,morphological_dilation,3,2
0X512A035A01A6C549.avi,96,876,590,286,48.47457627118644,morphological_dilation,3,2
0X512A516AACF78DAB.avi,43,2109,1673,436,26.060968320382543,morphological_dilation,3,2
0X512A516AACF78DAB.avi,62,1330,978,352,35.991820040899796,morphological_dilation,3,2
0X512A75F626846DD1.avi,55,1107,791,316,39.94943109987358,morphological_dilation,3,2
0X512A75F626846DD1.avi,73,691,413,278,67.31234866828088,morphological_dilation,3,2
0X51327FBFD448A550.avi,42,1544,1196,348,29.09698996655518,morphological_dilation,3,2
0X51327FBFD448A550.avi,61,908,624,284,45.51282051282051,morphological_dilation,3,2
0X513338EB70290591.avi,86,1635,1264,371,29.35126582278481,morphological_dilation,3,2
0X513338EB70290591.avi,102,1398,1046,352,33.652007648183556,morphological_dilation,3,2
0X513547F80FE92CA6.avi,75,1714,1354,360,26.587887740029544,morphological_dilation,3,2
0X513547F80FE92CA6.avi,94,1146,842,304,36.104513064133016,morphological_dilation,3,2
0X5135B2283BB69AF3.avi,2,2427,1963,464,23.637289862455425,morphological_dilation,3,2
0X5135B2283BB69AF3.avi,19,1624,1248,376,30.128205128205128,morphological_dilation,3,2
0X51387CAC8388DCAC.avi,102,2311,1859,452,24.314147391070467,morphological_dilation,3,2
0X51387CAC8388DCAC.avi,116,1449,1081,368,34.04255319148936,morphological_dilation,3,2
0X513B9DFACA291153.avi,107,2133,1722,411,23.86759581881533,morphological_dilation,3,2
0X513B9DFACA291153.avi,125,1489,1137,352,30.958663148636763,morphological_dilation,3,2
0X513CB49F4AFD54BB.avi,112,1747,1351,396,29.311621021465584,morphological_dilation,3,2
0X513CB49F4AFD54BB.avi,127,1056,732,324,44.26229508196721,morphological_dilation,3,2
0X51472543858384F2.avi,46,1733,1343,390,29.03946388682055,morphological_dilation,3,2
0X51472543858384F2.avi,62,1207,860,347,40.348837209302324,morphological_dilation,3,2
0X514AE6D7248D0A2A.avi,63,2153,1725,428,24.81159420289855,morphological_dilation,3,2
0X514AE6D7248D0A2A.avi,80,1358,998,360,36.07214428857716,morphological_dilation,3,2
0X514E30A308ED7C61.avi,155,2525,2081,444,21.3358962037482,morphological_dilation,3,2
0X514E30A308ED7C61.avi,176,1696,1304,392,30.061349693251532,morphological_dilation,3,2
0X51533857C7611936.avi,62,2477,2021,456,22.56308758040574,morphological_dilation,3,2
0X51533857C7611936.avi,83,1412,1044,368,35.24904214559387,morphological_dilation,3,2
0X5153747D26CD85F4.avi,129,1554,1202,352,29.28452579034942,morphological_dilation,3,2
0X5153747D26CD85F4.avi,147,1061,765,296,38.692810457516345,morphological_dilation,3,2
0X51556AE74D21038E.avi,123,1407,1071,336,31.372549019607842,morphological_dilation,3,2
0X51556AE74D21038E.avi,142,912,640,272,42.5,morphological_dilation,3,2
0X51574834DE0DBDA.avi,104,2588,2116,472,22.306238185255197,morphological_dilation,3,2
0X51574834DE0DBDA.avi,123,1712,1312,400,30.48780487804878,morphological_dilation,3,2
0X515B00307A98E6F9.avi,124,2090,1679,411,24.47885646217987,morphological_dilation,3,2
0X515B00307A98E6F9.avi,138,1512,1168,344,29.45205479452055,morphological_dilation,3,2
0X515B3FC559BDA78C.avi,63,2394,1934,460,23.784901758014477,morphological_dilation,3,2
0X515B3FC559BDA78C.avi,78,1258,919,339,36.88792165397171,morphological_dilation,3,2
0X515B9D79337A52A8.avi,28,1445,1113,332,29.829290206648697,morphological_dilation,3,2
0X515B9D79337A52A8.avi,43,904,640,264,41.25,morphological_dilation,3,2
0X515BE303CDEBF73D.avi,67,2442,1970,472,23.95939086294416,morphological_dilation,3,2
0X515BE303CDEBF73D.avi,94,1523,1107,416,37.57904245709124,morphological_dilation,3,2
0X515FB01ECBD93661.avi,97,1545,1189,356,29.941126997476868,morphological_dilation,3,2
0X515FB01ECBD93661.avi,112,1000,708,292,41.24293785310734,morphological_dilation,3,2
0X5169B30FBF1908B0.avi,114,1643,1279,364,28.459734167318217,morphological_dilation,3,2
0X5169B30FBF1908B0.avi,128,1046,750,296,39.46666666666667,morphological_dilation,3,2
0X516A825179C202F9.avi,46,1910,1502,408,27.163781624500665,morphological_dilation,3,2
0X516A825179C202F9.avi,67,1310,958,352,36.74321503131524,morphological_dilation,3,2
0X517063CA3BDBF3DA.avi,52,2174,1754,420,23.945267958950968,morphological_dilation,3,2
0X517063CA3BDBF3DA.avi,75,1720,1340,380,28.35820895522388,morphological_dilation,3,2
0X5171ECAA55C8BBA.avi,0,3997,3413,584,17.111046000585993,morphological_dilation,3,2
0X5171ECAA55C8BBA.avi,19,2315,1859,456,24.529316837009144,morphological_dilation,3,2
0X5175AED2558B83E6.avi,66,2002,1610,392,24.347826086956523,morphological_dilation,3,2
0X5175AED2558B83E6.avi,92,1182,862,320,37.12296983758701,morphological_dilation,3,2
0X517B9EA7B3FBEE17.avi,72,946,660,286,43.333333333333336,morphological_dilation,3,2
0X517B9EA7B3FBEE17.avi,81,675,419,256,61.09785202863962,morphological_dilation,3,2
0X517DACB0D4E4274.avi,89,1459,1096,363,33.12043795620438,morphological_dilation,3,2
0X517DACB0D4E4274.avi,102,974,669,305,45.59043348281017,morphological_dilation,3,2
0X517DB959DDA30D1F.avi,122,1890,1486,404,27.18707940780619,morphological_dilation,3,2
0X517DB959DDA30D1F.avi,138,1174,838,336,40.09546539379475,morphological_dilation,3,2
0X518BC58DF231D061.avi,64,3291,2791,500,17.914725904693658,morphological_dilation,3,2
0X518BC58DF231D061.avi,80,3104,2616,488,18.654434250764528,morphological_dilation,3,2
0X5191570E6D6CCBC6.avi,48,1543,1199,344,28.690575479566306,morphological_dilation,3,2
0X5191570E6D6CCBC6.avi,70,1096,800,296,37.0,morphological_dilation,3,2
0X5193979B5CD463D0.avi,101,3678,3114,564,18.11175337186898,morphological_dilation,3,2
0X5193979B5CD463D0.avi,120,2405,1941,464,23.90520350334879,morphological_dilation,3,2
0X519483F9EFA0B20E.avi,31,3645,3093,552,17.846750727449077,morphological_dilation,3,2
0X519483F9EFA0B20E.avi,53,2414,1919,495,25.794684731631058,morphological_dilation,3,2
0X51A155A49796F621.avi,97,2259,1843,416,22.57189365165491,morphological_dilation,3,2
0X51A155A49796F621.avi,113,1337,1025,312,30.4390243902439,morphological_dilation,3,2
0X51A72288BC365D50.avi,75,1595,1235,360,29.1497975708502,morphological_dilation,3,2
0X51A72288BC365D50.avi,99,960,672,288,42.857142857142854,morphological_dilation,3,2
0X51A7D5E3CC58EB01.avi,73,1947,1543,404,26.182760855476346,morphological_dilation,3,2
0X51A7D5E3CC58EB01.avi,86,1226,882,344,39.002267573696145,morphological_dilation,3,2
0X51AB3FD231602B33.avi,73,2184,1748,436,24.94279176201373,morphological_dilation,3,2
0X51AB3FD231602B33.avi,103,1349,993,356,35.85095669687814,morphological_dilation,3,2
0X51AF557A09FB40DA.avi,130,2692,2240,452,20.17857142857143,morphological_dilation,3,2
0X51AF557A09FB40DA.avi,144,1522,1166,356,30.53173241852487,morphological_dilation,3,2
0X51B29B65CD38C69E.avi,1,1305,965,340,35.233160621761655,morphological_dilation,3,2
0X51B29B65CD38C69E.avi,15,821,553,268,48.4629294755877,morphological_dilation,3,2
0X51B5B37B6F4A8CA8.avi,122,1453,1125,328,29.15555555555556,morphological_dilation,3,2
0X51B5B37B6F4A8CA8.avi,145,933,673,260,38.632986627043095,morphological_dilation,3,2
0X51B8DEE8747AFD9F.avi,113,3825,3257,568,17.439361375498923,morphological_dilation,3,2
0X51B8DEE8747AFD9F.avi,130,2380,1924,456,23.7006237006237,morphological_dilation,3,2
0X51BA813A5E8A6986.avi,115,1976,1557,419,26.91072575465639,morphological_dilation,3,2
0X51BA813A5E8A6986.avi,134,1624,1252,372,29.712460063897762,morphological_dilation,3,2
0X51BB2250DB2403D5.avi,99,1753,1381,372,26.937002172338886,morphological_dilation,3,2
0X51BB2250DB2403D5.avi,117,1359,1031,328,31.81377303588749,morphological_dilation,3,2
0X51C04B6508D13507.avi,49,2306,1846,460,24.918743228602384,morphological_dilation,3,2
0X51C04B6508D13507.avi,75,1663,1271,392,30.84185680566483,morphological_dilation,3,2
0X51C33D62976C86E7.avi,31,1419,1083,336,31.024930747922436,morphological_dilation,3,2
0X51C33D62976C86E7.avi,44,928,644,284,44.099378881987576,morphological_dilation,3,2
0X51C7B722CB637F8.avi,98,2407,1944,463,23.81687242798354,morphological_dilation,3,2
0X51C7B722CB637F8.avi,116,1399,1035,364,35.169082125603865,morphological_dilation,3,2
0X51C9BBFB660CF100.avi,67,2919,2435,484,19.876796714579058,morphological_dilation,3,2
0X51C9BBFB660CF100.avi,85,1801,1393,408,29.289303661162958,morphological_dilation,3,2
0X51D2CBF603A4689D.avi,47,3401,2873,528,18.37800208840933,morphological_dilation,3,2
0X51D2CBF603A4689D.avi,64,2153,1709,444,25.980105324751317,morphological_dilation,3,2
0X51D385BFAEB40339.avi,73,1817,1441,376,26.092990978487162,morphological_dilation,3,2
0X51D385BFAEB40339.avi,89,1039,735,304,41.36054421768707,morphological_dilation,3,2
0X51D66652BDB24941.avi,32,2516,2076,440,21.19460500963391,morphological_dilation,3,2
0X51D66652BDB24941.avi,56,2167,1751,416,23.75785265562536,morphological_dilation,3,2
0X51D8A66B24FD69CA.avi,57,1926,1520,406,26.710526315789473,morphological_dilation,3,2
0X51D8A66B24FD69CA.avi,70,1322,962,360,37.42203742203743,morphological_dilation,3,2
0X51DBEF15E61B4374.avi,28,1648,1286,362,28.149300155520997,morphological_dilation,3,2
0X51DBEF15E61B4374.avi,43,1348,1024,324,31.640625,morphological_dilation,3,2
0X51DC2AFCF509252E.avi,38,1889,1477,412,27.89438050101557,morphological_dilation,3,2
0X51DC2AFCF509252E.avi,53,1348,1000,348,34.8,morphological_dilation,3,2
0X51DD9336133AA9A3.avi,56,1319,971,348,35.83934088568486,morphological_dilation,3,2
0X51DD9336133AA9A3.avi,74,865,569,296,52.02108963093146,morphological_dilation,3,2
0X51DEA404C6DAE247.avi,50,1965,1541,424,27.514600908500974,morphological_dilation,3,2
0X51DEA404C6DAE247.avi,59,1397,1025,372,36.292682926829265,morphological_dilation,3,2
0X51DF5916C8A5E638.avi,48,2094,1677,417,24.86583184257603,morphological_dilation,3,2
0X51DF5916C8A5E638.avi,61,1727,1327,400,30.143180105501134,morphological_dilation,3,2
0X51E57CEE1EFF9453.avi,47,2837,2357,480,20.364870598218072,morphological_dilation,3,2
0X51E57CEE1EFF9453.avi,66,1909,1493,416,27.863362357669125,morphological_dilation,3,2
0X51E6A6EC8684036C.avi,114,1985,1570,415,26.43312101910828,morphological_dilation,3,2
0X51E6A6EC8684036C.avi,131,1145,812,333,41.00985221674877,morphological_dilation,3,2
0X51EBAEFBADEB15E9.avi,86,3488,2980,508,17.04697986577181,morphological_dilation,3,2
0X51EBAEFBADEB15E9.avi,103,3237,2757,480,17.410228509249183,morphological_dilation,3,2
0X51EDA76C5B32BFB6.avi,3,1626,1274,352,27.629513343799054,morphological_dilation,3,2
0X51EDA76C5B32BFB6.avi,21,1318,992,326,32.86290322580645,morphological_dilation,3,2
0X51EEF0AF4CF6A039.avi,49,1730,1334,396,29.685157421289354,morphological_dilation,3,2
0X51EEF0AF4CF6A039.avi,70,1283,947,336,35.480464625131994,morphological_dilation,3,2
0X51F0878231E80676.avi,67,1490,1126,364,32.326820603907635,morphological_dilation,3,2
0X51F0878231E80676.avi,77,949,649,300,46.22496147919877,morphological_dilation,3,2
0X51F276725BEE4BF9.avi,0,2594,2134,460,21.55576382380506,morphological_dilation,3,2
0X51F276725BEE4BF9.avi,19,1826,1430,396,27.692307692307693,morphological_dilation,3,2
0X51F3A05DB9647C01.avi,108,3678,3142,536,17.05919796308084,morphological_dilation,3,2
0X51F3A05DB9647C01.avi,142,2767,2292,475,20.724258289703315,morphological_dilation,3,2
0X51FD3D57BA8323F2.avi,50,1868,1472,396,26.902173913043477,morphological_dilation,3,2
0X51FD3D57BA8323F2.avi,67,1239,919,320,34.82045701849837,morphological_dilation,3,2
0X51FE69873DAD3A42.avi,30,1543,1171,372,31.767719897523484,morphological_dilation,3,2
0X51FE69873DAD3A42.avi,40,838,566,272,48.0565371024735,morphological_dilation,3,2
0X51FF8C85CC1C6EC7.avi,36,1733,1329,404,30.39879608728367,morphological_dilation,3,2
0X51FF8C85CC1C6EC7.avi,52,1095,765,330,43.13725490196079,morphological_dilation,3,2
0X52014FFC1A469302.avi,52,1337,1005,332,33.03482587064677,morphological_dilation,3,2
0X52014FFC1A469302.avi,66,945,657,288,43.83561643835616,morphological_dilation,3,2
0X520169BA78B3FD6A.avi,65,1320,984,336,34.146341463414636,morphological_dilation,3,2
0X520169BA78B3FD6A.avi,81,922,626,296,47.284345047923324,morphological_dilation,3,2
0X520285C7C42A3A71.avi,44,1761,1377,384,27.886710239651418,morphological_dilation,3,2
0X520285C7C42A3A71.avi,57,1142,826,316,38.256658595641646,morphological_dilation,3,2
0X5203FF5095E5A01.avi,0,1728,1345,383,28.475836431226764,morphological_dilation,3,2
0X5203FF5095E5A01.avi,19,1087,787,300,38.11944091486658,morphological_dilation,3,2
0X5204CC14B02919D5.avi,97,3831,3217,614,19.086105066832452,morphological_dilation,3,2
0X5204CC14B02919D5.avi,126,2446,1918,528,27.528675703858184,morphological_dilation,3,2
0X52060B6BF382C4B4.avi,54,2406,1982,424,21.39253279515641,morphological_dilation,3,2
0X52060B6BF382C4B4.avi,71,1477,1121,356,31.757359500446032,morphological_dilation,3,2
0X5206D35DE3795342.avi,90,2268,1848,420,22.727272727272727,morphological_dilation,3,2
0X5206D35DE3795342.avi,107,1938,1550,388,25.032258064516128,morphological_dilation,3,2
0X5206F9D88064AFE8.avi,90,3036,2524,512,20.28526148969889,morphological_dilation,3,2
0X5206F9D88064AFE8.avi,106,1898,1486,412,27.725437415881558,morphological_dilation,3,2
0X5208E6FA65C27BC5.avi,101,1345,1013,332,32.77393879565646,morphological_dilation,3,2
0X5208E6FA65C27BC5.avi,119,896,616,280,45.45454545454545,morphological_dilation,3,2
0X5210A2AE344C6131.avi,39,1493,1100,393,35.72727272727273,morphological_dilation,3,2
0X5210A2AE344C6131.avi,54,982,657,325,49.467275494672755,morphological_dilation,3,2
0X5216E8EAC6638EC5.avi,94,2344,1920,424,22.083333333333332,morphological_dilation,3,2
0X5216E8EAC6638EC5.avi,116,1955,1545,410,26.537216828478964,morphological_dilation,3,2
0X521D37449979E761.avi,67,1312,988,324,32.79352226720648,morphological_dilation,3,2
0X521D37449979E761.avi,86,833,573,260,45.37521815008726,morphological_dilation,3,2
0X521EA8A95B25BF85.avi,41,1619,1235,384,31.093117408906885,morphological_dilation,3,2
0X521EA8A95B25BF85.avi,52,1101,762,339,44.48818897637795,morphological_dilation,3,2
0X5222169EED25C8D8.avi,0,2134,1666,468,28.091236494597837,morphological_dilation,3,2
0X5222169EED25C8D8.avi,17,1394,991,403,40.66599394550959,morphological_dilation,3,2
0X5225E58471150AD3.avi,49,1634,1250,384,30.72,morphological_dilation,3,2
0X5225E58471150AD3.avi,67,1152,816,336,41.17647058823529,morphological_dilation,3,2
0X5226FB3272760299.avi,43,1255,943,312,33.085896076352064,morphological_dilation,3,2
0X5226FB3272760299.avi,60,845,577,268,46.447140381282495,morphological_dilation,3,2
0X52297761808D2976.avi,105,1605,1239,366,29.539951573849876,morphological_dilation,3,2
0X52297761808D2976.avi,122,1145,833,312,37.45498199279712,morphological_dilation,3,2
0X522E7EC5D8AA4628.avi,56,2901,2413,488,20.223787815996687,morphological_dilation,3,2
0X522E7EC5D8AA4628.avi,79,1592,1220,372,30.491803278688522,morphological_dilation,3,2
0X522EE1FAE9E44660.avi,1,1882,1487,395,26.563550773369197,morphological_dilation,3,2
0X522EE1FAE9E44660.avi,18,1272,948,324,34.177215189873415,morphological_dilation,3,2
0X523258F4875D1051.avi,35,1624,1256,368,29.29936305732484,morphological_dilation,3,2
0X523258F4875D1051.avi,52,952,656,296,45.1219512195122,morphological_dilation,3,2
0X5232F0CB5A9F5EFE.avi,53,3024,2540,484,19.055118110236222,morphological_dilation,3,2
0X5232F0CB5A9F5EFE.avi,72,2785,2321,464,19.991383024558377,morphological_dilation,3,2
0X5233D810FA8D90D0.avi,110,1624,1248,376,30.128205128205128,morphological_dilation,3,2
0X5233D810FA8D90D0.avi,127,1013,701,312,44.50784593437946,morphological_dilation,3,2
0X5235A82128C7DA89.avi,42,2020,1628,392,24.078624078624077,morphological_dilation,3,2
0X5235A82128C7DA89.avi,59,1331,1015,316,31.133004926108377,morphological_dilation,3,2
0X5238017D9647223F.avi,28,1589,1213,376,30.99752679307502,morphological_dilation,3,2
0X5238017D9647223F.avi,40,935,639,296,46.322378716744915,morphological_dilation,3,2
0X523FA0DDFF2B86ED.avi,88,1914,1526,388,25.4259501965924,morphological_dilation,3,2
0X523FA0DDFF2B86ED.avi,105,1470,1134,336,29.629629629629626,morphological_dilation,3,2
0X523FF4ADB265D1D7.avi,48,1671,1295,376,29.034749034749037,morphological_dilation,3,2
0X523FF4ADB265D1D7.avi,65,1333,1005,328,32.63681592039801,morphological_dilation,3,2
0X5242792A4F7179CB.avi,93,1797,1401,396,28.26552462526767,morphological_dilation,3,2
0X5242792A4F7179CB.avi,111,1182,866,316,36.489607390300236,morphological_dilation,3,2
0X52440183F6E99858.avi,1,1718,1342,376,28.017883755588674,morphological_dilation,3,2
0X52440183F6E99858.avi,17,983,677,306,45.199409158050216,morphological_dilation,3,2
0X5245782BC86D72CF.avi,90,1858,1466,392,26.73942701227831,morphological_dilation,3,2
0X5245782BC86D72CF.avi,105,1147,835,312,37.365269461077844,morphological_dilation,3,2
0X524BD73B9BA0994B.avi,43,2007,1591,416,26.147077309868006,morphological_dilation,3,2
0X524BD73B9BA0994B.avi,55,1270,916,354,38.646288209606986,morphological_dilation,3,2
0X524E096EBA4915EA.avi,89,2407,1971,436,22.120750887874173,morphological_dilation,3,2
0X524E096EBA4915EA.avi,110,1571,1203,368,30.59019118869493,morphological_dilation,3,2
0X5250AF044F67C35B.avi,83,2591,2131,460,21.586109807602064,morphological_dilation,3,2
0X5250AF044F67C35B.avi,99,1976,1572,404,25.699745547073793,morphological_dilation,3,2
0X5250BFB3A5B5DE5D.avi,42,1453,1105,348,31.493212669683256,morphological_dilation,3,2
0X5250BFB3A5B5DE5D.avi,54,1290,954,336,35.22012578616352,morphological_dilation,3,2
0X5251B40D3A1CD1D6.avi,50,1542,1170,372,31.794871794871792,morphological_dilation,3,2
0X5251B40D3A1CD1D6.avi,68,977,669,308,46.038863976083704,morphological_dilation,3,2
0X525504B5A2CB1678.avi,42,1858,1470,388,26.39455782312925,morphological_dilation,3,2
0X525504B5A2CB1678.avi,58,1123,810,313,38.641975308641975,morphological_dilation,3,2
0X525A6043720EEE80.avi,101,2080,1676,404,24.105011933174225,morphological_dilation,3,2
0X525A6043720EEE80.avi,119,1229,908,321,35.352422907488986,morphological_dilation,3,2
0X525B53BB23B6BFFF.avi,43,1290,934,356,38.11563169164882,morphological_dilation,3,2
0X525B53BB23B6BFFF.avi,58,794,513,281,54.77582846003899,morphological_dilation,3,2
0X525F4337010EACD0.avi,87,1872,1488,384,25.806451612903224,morphological_dilation,3,2
0X525F4337010EACD0.avi,102,1220,888,332,37.38738738738739,morphological_dilation,3,2
0X525F58503C9356EE.avi,53,1368,1040,328,31.538461538461537,morphological_dilation,3,2
0X525F58503C9356EE.avi,72,1191,887,304,34.2728297632469,morphological_dilation,3,2
0X526147E29A61A557.avi,57,1685,1317,368,27.942293090356873,morphological_dilation,3,2
0X526147E29A61A557.avi,71,1132,816,316,38.72549019607843,morphological_dilation,3,2
0X52619FC2739EB1F1.avi,0,862,586,276,47.098976109215016,morphological_dilation,3,2
0X52619FC2739EB1F1.avi,19,601,373,228,61.12600536193029,morphological_dilation,3,2
0X5263B7448345F313.avi,81,1580,1220,360,29.508196721311474,morphological_dilation,3,2
0X5263B7448345F313.avi,94,963,691,272,39.36324167872648,morphological_dilation,3,2
0X52640461AE729391.avi,52,1934,1526,408,26.736566186107467,morphological_dilation,3,2
0X52640461AE729391.avi,69,1363,1019,344,33.7585868498528,morphological_dilation,3,2
0X5266458976482657.avi,33,1009,717,292,40.72524407252441,morphological_dilation,3,2
0X5266458976482657.avi,49,605,377,228,60.47745358090185,morphological_dilation,3,2
0X52681CFFD5B749CC.avi,98,2263,1815,448,24.683195592286502,morphological_dilation,3,2
0X52681CFFD5B749CC.avi,116,1425,1074,351,32.68156424581006,morphological_dilation,3,2
0X526BA02D476E9274.avi,73,1332,1004,328,32.669322709163346,morphological_dilation,3,2
0X526BA02D476E9274.avi,93,1829,1362,467,34.287812041116005,morphological_dilation,3,2
0X5271A44429C406DE.avi,3,2296,1796,500,27.839643652561247,morphological_dilation,3,2
0X5271A44429C406DE.avi,15,1271,871,400,45.924225028702644,morphological_dilation,3,2
0X52741F3A8E09E79C.avi,55,2051,1644,407,24.75669099756691,morphological_dilation,3,2
0X52741F3A8E09E79C.avi,72,1785,1391,394,28.324946081955428,morphological_dilation,3,2
0X52749A08918D145.avi,206,1685,1281,404,31.53786104605777,morphological_dilation,3,2
0X52749A08918D145.avi,227,992,643,349,54.27682737169518,morphological_dilation,3,2
0X527F41D680422536.avi,100,1278,946,332,35.095137420718814,morphological_dilation,3,2
0X527F41D680422536.avi,113,749,497,252,50.70422535211267,morphological_dilation,3,2
0X52832AF3B2EE7826.avi,55,1889,1449,440,30.36576949620428,morphological_dilation,3,2
0X52832AF3B2EE7826.avi,79,1465,1085,380,35.02304147465438,morphological_dilation,3,2
0X5284C8C05B0255E9.avi,49,1817,1429,388,27.1518544436669,morphological_dilation,3,2
0X5284C8C05B0255E9.avi,61,1181,857,324,37.80630105017503,morphological_dilation,3,2
0X528747A45FEF978E.avi,54,1956,1560,396,25.384615384615383,morphological_dilation,3,2
0X528747A45FEF978E.avi,74,1301,969,332,34.26212590299277,morphological_dilation,3,2
0X52894A1293DC3698.avi,116,2127,1711,416,24.313267095265925,morphological_dilation,3,2
0X52894A1293DC3698.avi,135,1307,955,352,36.858638743455494,morphological_dilation,3,2
0X5294006E7295A9D3.avi,121,1234,918,316,34.42265795206972,morphological_dilation,3,2
0X5294006E7295A9D3.avi,136,809,541,268,49.53789279112754,morphological_dilation,3,2
0X5295198F216052C5.avi,155,2494,2050,444,21.658536585365855,morphological_dilation,3,2
0X5295198F216052C5.avi,177,1734,1370,364,26.56934306569343,morphological_dilation,3,2
0X52A19EE2EB43DCEA.avi,75,1229,921,308,33.441910966340934,morphological_dilation,3,2
0X52A19EE2EB43DCEA.avi,86,770,491,279,56.82281059063137,morphological_dilation,3,2
0X52A92D8D4C0BB36B.avi,96,1911,1341,570,42.505592841163306,morphological_dilation,3,2
0X52A92D8D4C0BB36B.avi,105,1885,1485,400,26.936026936026934,morphological_dilation,3,2
0X52AB5E2861E64C14.avi,111,1383,1039,344,33.108758421559195,morphological_dilation,3,2
0X52AB5E2861E64C14.avi,130,789,473,316,66.8076109936575,morphological_dilation,3,2
0X52ADAC369E93CF52.avi,50,2399,1951,448,22.962583290620195,morphological_dilation,3,2
0X52ADAC369E93CF52.avi,65,1486,1122,364,32.44206773618538,morphological_dilation,3,2
0X52B0FFBD0E252F79.avi,45,1886,1490,396,26.57718120805369,morphological_dilation,3,2
0X52B0FFBD0E252F79.avi,62,1233,898,335,37.30512249443207,morphological_dilation,3,2
0X52B18B65394F13D1.avi,111,1362,1034,328,31.721470019342355,morphological_dilation,3,2
0X52B18B65394F13D1.avi,123,1044,752,292,38.82978723404255,morphological_dilation,3,2
0X52B3311CBAFB526B.avi,56,1401,1045,356,34.06698564593301,morphological_dilation,3,2
0X52B3311CBAFB526B.avi,65,921,621,300,48.309178743961354,morphological_dilation,3,2
0X52B45CBAAC8373DA.avi,71,2403,1955,448,22.915601023017903,morphological_dilation,3,2
0X52B45CBAAC8373DA.avi,86,1375,1023,352,34.40860215053764,morphological_dilation,3,2
0X52BBC4F30524BEB6.avi,91,1462,1126,336,29.84014209591474,morphological_dilation,3,2
0X52BBC4F30524BEB6.avi,121,893,633,260,41.07424960505529,morphological_dilation,3,2
0X52C8E34676F66ADB.avi,63,2091,1667,424,25.43491301739652,morphological_dilation,3,2
0X52C8E34676F66ADB.avi,90,1548,1180,368,31.186440677966104,morphological_dilation,3,2
0X52CBA0C16FD4CD3D.avi,47,1631,1243,388,31.214802896218824,morphological_dilation,3,2
0X52CBA0C16FD4CD3D.avi,60,1020,673,347,51.56017830609212,morphological_dilation,3,2
0X52CC0BAB001C7C06.avi,66,2063,1635,428,26.177370030581038,morphological_dilation,3,2
0X52CC0BAB001C7C06.avi,78,1692,1308,384,29.357798165137616,morphological_dilation,3,2
0X52CDBA521DF75946.avi,1,1311,983,328,33.36724313326551,morphological_dilation,3,2
0X52CDBA521DF75946.avi,19,935,655,280,42.74809160305343,morphological_dilation,3,2
0X52D0359294EEDEA7.avi,58,1615,1267,348,27.466456195737965,morphological_dilation,3,2
0X52D0359294EEDEA7.avi,73,1091,787,304,38.6277001270648,morphological_dilation,3,2
0X52D27E1752D12960.avi,104,1419,1067,352,32.98969072164948,morphological_dilation,3,2
0X52D27E1752D12960.avi,124,985,685,300,43.79562043795621,morphological_dilation,3,2
0X52D4906BB576A5F5.avi,99,1809,1393,416,29.863603732950466,morphological_dilation,3,2
0X52D4906BB576A5F5.avi,109,1234,881,353,40.06810442678774,morphological_dilation,3,2
0X52D557F8B05D9D23.avi,35,1286,942,344,36.51804670912951,morphological_dilation,3,2
0X52D557F8B05D9D23.avi,48,799,523,276,52.77246653919694,morphological_dilation,3,2
0X52D5600CFB02C68A.avi,3,1678,1310,368,28.091603053435115,morphological_dilation,3,2
0X52D5600CFB02C68A.avi,16,898,604,294,48.675496688741724,morphological_dilation,3,2
0X52D59CA57FAC5D8A.avi,141,2452,2016,436,21.626984126984127,morphological_dilation,3,2
0X52D59CA57FAC5D8A.avi,156,2115,1703,412,24.192601291837935,morphological_dilation,3,2
0X52DD020FA81C5911.avi,2,1247,935,312,33.36898395721925,morphological_dilation,3,2
0X52DD020FA81C5911.avi,16,797,537,260,48.4171322160149,morphological_dilation,3,2
0X52E6FB1ABC9979AA.avi,84,2265,1841,424,23.03096143400326,morphological_dilation,3,2
0X52E6FB1ABC9979AA.avi,101,1279,947,332,35.05807814149947,morphological_dilation,3,2
0X52E72FE599012A73.avi,99,2090,1678,412,24.553039332538738,morphological_dilation,3,2
0X52E72FE599012A73.avi,107,1273,933,340,36.441586280814576,morphological_dilation,3,2
0X52E865A8C311F559.avi,53,1413,1073,340,31.68685927306617,morphological_dilation,3,2
0X52E865A8C311F559.avi,80,981,693,288,41.55844155844156,morphological_dilation,3,2
0X52EE1C53A1BC9F16.avi,85,2319,1875,444,23.68,morphological_dilation,3,2
0X52EE1C53A1BC9F16.avi,102,1441,1065,376,35.305164319248824,morphological_dilation,3,2
0X52F3BB17DC1CC0EA.avi,40,1334,998,336,33.66733466933868,morphological_dilation,3,2
0X52F3BB17DC1CC0EA.avi,56,806,526,280,53.2319391634981,morphological_dilation,3,2
0X52F59CC4F973172F.avi,31,2150,1750,400,22.857142857142858,morphological_dilation,3,2
0X52F59CC4F973172F.avi,50,1856,1484,372,25.067385444743934,morphological_dilation,3,2
0X52F78B094464709B.avi,35,1606,1222,384,31.42389525368249,morphological_dilation,3,2
0X52F78B094464709B.avi,52,952,644,308,47.82608695652174,morphological_dilation,3,2
0X52F97576E094322B.avi,36,1493,1161,332,28.59603789836348,morphological_dilation,3,2
0X52F97576E094322B.avi,47,987,715,272,38.04195804195804,morphological_dilation,3,2
0X52FDE4342ACD5331.avi,0,2996,2504,492,19.64856230031949,morphological_dilation,3,2
0X52FDE4342ACD5331.avi,18,1936,1532,404,26.370757180156655,morphological_dilation,3,2
0X52FEE70BDB811E9B.avi,36,1330,1010,320,31.683168316831683,morphological_dilation,3,2
0X52FEE70BDB811E9B.avi,56,755,515,240,46.601941747572816,morphological_dilation,3,2
0X5304E93805A039EC.avi,50,1523,1179,344,29.17726887192536,morphological_dilation,3,2
0X5304E93805A039EC.avi,65,954,658,296,44.984802431610944,morphological_dilation,3,2
0X5305BF4F8A3780B0.avi,47,1962,1508,454,30.106100795755967,morphological_dilation,3,2
0X5305BF4F8A3780B0.avi,63,1210,838,372,44.39140811455847,morphological_dilation,3,2
0X53086AFB52330C89.avi,101,1765,1385,380,27.436823104693143,morphological_dilation,3,2
0X53086AFB52330C89.avi,118,1316,980,336,34.285714285714285,morphological_dilation,3,2
0X530DFA010BC9EE5A.avi,38,1240,928,312,33.62068965517241,morphological_dilation,3,2
0X530DFA010BC9EE5A.avi,49,805,540,265,49.074074074074076,morphological_dilation,3,2
0X53105275386CE431.avi,78,1675,1295,380,29.343629343629345,morphological_dilation,3,2
0X53105275386CE431.avi,100,983,667,316,47.37631184407796,morphological_dilation,3,2
0X53138007E8FCB197.avi,41,1855,1471,384,26.10469068660775,morphological_dilation,3,2
0X53138007E8FCB197.avi,59,1258,922,336,36.44251626898048,morphological_dilation,3,2
0X531443B0071CDBE7.avi,82,1806,1426,380,26.64796633941094,morphological_dilation,3,2
0X531443B0071CDBE7.avi,109,1151,843,308,36.5361803084223,morphological_dilation,3,2
0X5314F4555E935D32.avi,135,1399,1075,324,30.13953488372093,morphological_dilation,3,2
0X5314F4555E935D32.avi,152,919,643,276,42.92379471228615,morphological_dilation,3,2
0X532255A0D06AF53D.avi,133,2454,1998,456,22.822822822822822,morphological_dilation,3,2
0X532255A0D06AF53D.avi,148,1417,1069,348,32.55378858746492,morphological_dilation,3,2
0X532260359751DBB.avi,49,2369,1949,420,21.549512570549,morphological_dilation,3,2
0X532260359751DBB.avi,61,2075,1687,388,22.999407231772377,morphological_dilation,3,2
0X5323F2A87FB33D5.avi,132,1286,963,323,33.54101765316719,morphological_dilation,3,2
0X5323F2A87FB33D5.avi,147,871,587,284,48.38160136286201,morphological_dilation,3,2
0X5324777137DAAF06.avi,61,3182,2674,508,18.997756170531037,morphological_dilation,3,2
0X5324777137DAAF06.avi,76,2813,2325,488,20.989247311827956,morphological_dilation,3,2
0X532728AF419C2BD4.avi,95,2084,1680,404,24.047619047619047,morphological_dilation,3,2
0X532728AF419C2BD4.avi,111,1337,1009,328,32.507433102081265,morphological_dilation,3,2
0X53293E0FFF92E26A.avi,87,2378,1942,436,22.451081359423274,morphological_dilation,3,2
0X53293E0FFF92E26A.avi,105,1571,1211,360,29.72749793559042,morphological_dilation,3,2
0X5331DF8AF33FA880.avi,48,1473,1097,376,34.275296262534184,morphological_dilation,3,2
0X5331DF8AF33FA880.avi,72,919,614,305,49.6742671009772,morphological_dilation,3,2
0X5333CEAC223AB6D0.avi,52,1018,734,284,38.69209809264305,morphological_dilation,3,2
0X5333CEAC223AB6D0.avi,65,692,452,240,53.09734513274337,morphological_dilation,3,2
0X533498EF6F72192.avi,59,797,541,256,47.31977818853974,morphological_dilation,3,2
0X533498EF6F72192.avi,74,526,321,205,63.862928348909655,morphological_dilation,3,2
0X53352F8300F75CEC.avi,109,1761,1362,399,29.295154185022028,morphological_dilation,3,2
0X53352F8300F75CEC.avi,126,1025,707,318,44.97878359264498,morphological_dilation,3,2
0X53403DC4C4526AC3.avi,79,1206,866,340,39.260969976905315,morphological_dilation,3,2
0X53403DC4C4526AC3.avi,98,649,393,256,65.13994910941476,morphological_dilation,3,2
0X53412B6864809F46.avi,49,1494,1134,360,31.746031746031743,morphological_dilation,3,2
0X53412B6864809F46.avi,67,897,618,279,45.14563106796117,morphological_dilation,3,2
0X53432F9602925B2E.avi,100,1880,1476,404,27.371273712737125,morphological_dilation,3,2
0X53432F9602925B2E.avi,116,1175,822,353,42.94403892944039,morphological_dilation,3,2
0X53434964FF756E9A.avi,71,1416,1044,372,35.63218390804598,morphological_dilation,3,2
0X53434964FF756E9A.avi,84,827,547,280,51.18829981718464,morphological_dilation,3,2
0X53491FA3CDC950C1.avi,64,1725,1333,392,29.40735183795949,morphological_dilation,3,2
0X53491FA3CDC950C1.avi,82,1116,779,337,43.26059050064185,morphological_dilation,3,2
0X5349865A317C7B59.avi,34,2609,2149,460,21.405304792926945,morphological_dilation,3,2
0X5349865A317C7B59.avi,53,2078,1662,416,25.03008423586041,morphological_dilation,3,2
0X53499C56E6465674.avi,117,1587,1231,356,28.9195775792039,morphological_dilation,3,2
0X53499C56E6465674.avi,136,934,646,288,44.58204334365325,morphological_dilation,3,2
0X534A45D607A13527.avi,45,5346,4712,634,13.455008488964346,morphological_dilation,3,2
0X534A45D607A13527.avi,57,4931,4323,608,14.064307194078188,morphological_dilation,3,2
0X534B7A1F00C0869C.avi,121,1694,1322,372,28.139183055975792,morphological_dilation,3,2
0X534B7A1F00C0869C.avi,139,1099,775,324,41.80645161290323,morphological_dilation,3,2
0X534C9F54153DA440.avi,30,2546,2098,448,21.353670162059103,morphological_dilation,3,2
0X534C9F54153DA440.avi,55,1580,1208,372,30.79470198675497,morphological_dilation,3,2
0X534F8C502A462B60.avi,105,1874,1490,384,25.771812080536915,morphological_dilation,3,2
0X534F8C502A462B60.avi,119,1223,899,324,36.04004449388209,morphological_dilation,3,2
0X5352D23D6CB2673C.avi,55,1314,994,320,32.19315895372233,morphological_dilation,3,2
0X5352D23D6CB2673C.avi,70,917,633,284,44.86571879936809,morphological_dilation,3,2
0X53552FB88892AC31.avi,34,1055,715,340,47.55244755244755,morphological_dilation,3,2
0X53552FB88892AC31.avi,47,694,398,296,74.37185929648241,morphological_dilation,3,2
0X5359A0AEC9FD8C36.avi,84,1702,1322,380,28.74432677760968,morphological_dilation,3,2
0X5359A0AEC9FD8C36.avi,96,1304,976,328,33.60655737704918,morphological_dilation,3,2
0X535B7884988ACFBC.avi,58,1648,1288,360,27.95031055900621,morphological_dilation,3,2
0X535B7884988ACFBC.avi,79,1160,852,308,36.15023474178404,morphological_dilation,3,2
0X535C51E9C2EE35F1.avi,51,1261,953,308,32.3189926547744,morphological_dilation,3,2
0X535C51E9C2EE35F1.avi,66,806,546,260,47.61904761904761,morphological_dilation,3,2
0X535C97BB939E71C4.avi,0,1882,1491,391,26.22401073105298,morphological_dilation,3,2
0X535C97BB939E71C4.avi,20,1548,1188,360,30.303030303030305,morphological_dilation,3,2
0X53640FEE8C415E2A.avi,92,1785,1385,400,28.880866425992778,morphological_dilation,3,2
0X53640FEE8C415E2A.avi,108,1060,732,328,44.80874316939891,morphological_dilation,3,2
0X53654922C42D0581.avi,81,1555,1211,344,28.406275805119733,morphological_dilation,3,2
0X53654922C42D0581.avi,109,1001,729,272,37.31138545953361,morphological_dilation,3,2
0X53665CE9C3E14600.avi,36,1777,1413,364,25.760792639773534,morphological_dilation,3,2
0X53665CE9C3E14600.avi,50,1467,1139,328,28.797190517998246,morphological_dilation,3,2
0X53666FBFC3CC3583.avi,100,2295,1831,464,25.341343528126707,morphological_dilation,3,2
0X53666FBFC3CC3583.avi,119,1591,1195,396,33.13807531380753,morphological_dilation,3,2
0X536907DD9FB81B8E.avi,43,2306,1866,440,23.579849946409432,morphological_dilation,3,2
0X536907DD9FB81B8E.avi,59,1965,1565,400,25.559105431309902,morphological_dilation,3,2
0X5369F6C63E8B5DF5.avi,49,1607,1255,352,28.047808764940243,morphological_dilation,3,2
0X5369F6C63E8B5DF5.avi,65,1010,710,300,42.25352112676056,morphological_dilation,3,2
0X536F4846A4B7D0F9.avi,52,2405,1941,464,23.90520350334879,morphological_dilation,3,2
0X536F4846A4B7D0F9.avi,70,1283,927,356,38.403451995685,morphological_dilation,3,2
0X536FF5B8DA04D5A9.avi,130,1926,1522,404,26.544021024967147,morphological_dilation,3,2
0X536FF5B8DA04D5A9.avi,141,1290,935,355,37.967914438502675,morphological_dilation,3,2
0X5374EEB8E8E1650C.avi,50,1421,1057,364,34.437086092715234,morphological_dilation,3,2
0X5374EEB8E8E1650C.avi,66,851,563,288,51.15452930728242,morphological_dilation,3,2
0X53766395EDD20AF4.avi,3,1348,1012,336,33.201581027667984,morphological_dilation,3,2
0X53766395EDD20AF4.avi,21,877,605,272,44.95867768595041,morphological_dilation,3,2
0X537E0C66F1BC068B.avi,35,1561,1204,357,29.651162790697676,morphological_dilation,3,2
0X537E0C66F1BC068B.avi,49,1062,758,304,40.105540897097626,morphological_dilation,3,2
0X5384FB77E5EA44DB.avi,55,1419,1083,336,31.024930747922436,morphological_dilation,3,2
0X5384FB77E5EA44DB.avi,73,828,564,264,46.808510638297875,morphological_dilation,3,2
0X5386330F2823CD9A.avi,111,2296,1821,475,26.084568918176824,morphological_dilation,3,2
0X5386330F2823CD9A.avi,126,1283,935,348,37.219251336898395,morphological_dilation,3,2
0X5389ED952B455A33.avi,43,1299,948,351,37.0253164556962,morphological_dilation,3,2
0X5389ED952B455A33.avi,58,751,471,280,59.447983014862,morphological_dilation,3,2
0X538CA13B226682A9.avi,119,1809,1405,404,28.75444839857651,morphological_dilation,3,2
0X538CA13B226682A9.avi,136,1470,1107,363,32.79132791327913,morphological_dilation,3,2
0X538EE4B6099DF1CC.avi,41,1986,1598,388,24.28035043804756,morphological_dilation,3,2
0X538EE4B6099DF1CC.avi,59,1291,967,324,33.50568769389866,morphological_dilation,3,2
0X53935BDDDDEAC8BE.avi,88,3747,3191,556,17.42400501410216,morphological_dilation,3,2
0X53935BDDDDEAC8BE.avi,106,2218,1766,452,25.59456398640997,morphological_dilation,3,2
0X539386FD2B2033D5.avi,53,1938,1562,376,24.07170294494238,morphological_dilation,3,2
0X539386FD2B2033D5.avi,66,1280,972,308,31.68724279835391,morphological_dilation,3,2
0X539A371D00A8183E.avi,0,2541,2077,464,22.33991333654309,morphological_dilation,3,2
0X539A371D00A8183E.avi,19,1700,1296,404,31.17283950617284,morphological_dilation,3,2
0X539C8A97334B092C.avi,68,2357,1925,432,22.441558441558442,morphological_dilation,3,2
0X539C8A97334B092C.avi,79,1945,1549,396,25.564880568108457,morphological_dilation,3,2
0X539CB3C4DC98A2A2.avi,59,2085,1673,412,24.626419605499102,morphological_dilation,3,2
0X539CB3C4DC98A2A2.avi,77,1243,903,340,37.652270210409746,morphological_dilation,3,2
0X539FF77627188BF8.avi,44,2056,1632,424,25.98039215686275,morphological_dilation,3,2
0X539FF77627188BF8.avi,55,1571,1211,360,29.72749793559042,morphological_dilation,3,2
0X53A0FEF8F35BDBDC.avi,38,1699,1303,396,30.391404451266308,morphological_dilation,3,2
0X53A0FEF8F35BDBDC.avi,56,1030,714,316,44.25770308123249,morphological_dilation,3,2
0X53B6D6024241698C.avi,48,2138,1706,432,25.32239155920281,morphological_dilation,3,2
0X53B6D6024241698C.avi,66,1451,1103,348,31.550317316409792,morphological_dilation,3,2
0X53BD50EB0C43D30D.avi,51,1463,998,465,46.59318637274549,morphological_dilation,3,2
0X53BD50EB0C43D30D.avi,85,890,602,288,47.840531561461795,morphological_dilation,3,2
0X53BE187CA129F29.avi,91,1685,1321,364,27.554882664647995,morphological_dilation,3,2
0X53BE187CA129F29.avi,106,1105,821,284,34.59196102314251,morphological_dilation,3,2
0X53C185263415AA4F.avi,25,1397,1049,348,33.17445185891325,morphological_dilation,3,2
0X53C185263415AA4F.avi,37,1835,1361,474,34.82733284349743,morphological_dilation,3,2
0X53C2C17D229F3C15.avi,57,2261,1841,420,22.813688212927758,morphological_dilation,3,2
0X53C2C17D229F3C15.avi,71,1255,937,318,33.938100320170754,morphological_dilation,3,2
0X53C64FBBD36CD7ED.avi,45,2238,1810,428,23.646408839779006,morphological_dilation,3,2
0X53C64FBBD36CD7ED.avi,59,1331,983,348,35.40183112919634,morphological_dilation,3,2
0X53C694BBD38E22BF.avi,0,1570,1214,356,29.32454695222405,morphological_dilation,3,2
0X53C694BBD38E22BF.avi,12,932,652,280,42.944785276073624,morphological_dilation,3,2
0X53C69D7485C75891.avi,69,1975,1571,404,25.716104392106935,morphological_dilation,3,2
0X53C69D7485C75891.avi,86,1335,987,348,35.25835866261398,morphological_dilation,3,2
0X53C84BFA9447BEE8.avi,118,1966,1562,404,25.86427656850192,morphological_dilation,3,2
0X53C84BFA9447BEE8.avi,129,1149,841,308,36.623067776456594,morphological_dilation,3,2
0X53C87632CB74A529.avi,40,1532,1168,364,31.164383561643838,morphological_dilation,3,2
0X53C87632CB74A529.avi,57,958,662,296,44.71299093655589,morphological_dilation,3,2
0X53CDAEEF7BDFBFB2.avi,79,1322,986,336,34.07707910750507,morphological_dilation,3,2
0X53CDAEEF7BDFBFB2.avi,99,874,598,276,46.15384615384615,morphological_dilation,3,2
0X53CDFF78C91C7385.avi,43,1256,950,306,32.21052631578947,morphological_dilation,3,2
0X53CDFF78C91C7385.avi,60,793,529,264,49.9054820415879,morphological_dilation,3,2
0X53CE02247441397F.avi,33,1362,1010,352,34.85148514851485,morphological_dilation,3,2
0X53CE02247441397F.avi,46,871,595,276,46.38655462184874,morphological_dilation,3,2
0X53D2957F996CF868.avi,71,1759,1387,372,26.820475847152125,morphological_dilation,3,2
0X53D2957F996CF868.avi,83,996,700,296,42.285714285714285,morphological_dilation,3,2
0X53D35BCC24F3C358.avi,67,1570,1210,360,29.75206611570248,morphological_dilation,3,2
0X53D35BCC24F3C358.avi,84,1001,701,300,42.796005706134096,morphological_dilation,3,2
0X53E07181682C4F8A.avi,100,2748,2264,484,21.37809187279152,morphological_dilation,3,2
0X53E07181682C4F8A.avi,119,1953,1553,400,25.756600128783003,morphological_dilation,3,2
0X53E1375C97572B46.avi,50,1949,1573,376,23.903369357914812,morphological_dilation,3,2
0X53E1375C97572B46.avi,66,1397,1069,328,30.68288119738073,morphological_dilation,3,2
0X53E56B91AA00FA9D.avi,52,1203,875,328,37.48571428571428,morphological_dilation,3,2
0X53E56B91AA00FA9D.avi,68,739,483,256,53.002070393374744,morphological_dilation,3,2
0X53E9F9A7FB8F3310.avi,47,1656,1246,410,32.90529695024077,morphological_dilation,3,2
0X53E9F9A7FB8F3310.avi,61,993,606,387,63.86138613861386,morphological_dilation,3,2
0X53EEA5419A7890EC.avi,80,1667,1303,364,27.93553338449731,morphological_dilation,3,2
0X53EEA5419A7890EC.avi,94,1142,842,300,35.62945368171022,morphological_dilation,3,2
0X53F8BDD78E95B9FC.avi,0,1740,1360,380,27.941176470588236,morphological_dilation,3,2
0X53F8BDD78E95B9FC.avi,16,1141,833,308,36.97478991596639,morphological_dilation,3,2
0X54033ED5CBA33FFC.avi,83,2751,2255,496,21.995565410199557,morphological_dilation,3,2
0X54033ED5CBA33FFC.avi,102,1381,982,399,40.63136456211813,morphological_dilation,3,2
0X5404DDC9EBCC99AC.avi,45,1767,1391,376,27.030913012221426,morphological_dilation,3,2
0X5404DDC9EBCC99AC.avi,64,1345,1009,336,33.30029732408325,morphological_dilation,3,2
0X5406E97A85CAEB10.avi,48,1411,1079,332,30.76923076923077,morphological_dilation,3,2
0X5406E97A85CAEB10.avi,70,790,546,244,44.68864468864469,morphological_dilation,3,2
0X5407651AF7E19AD1.avi,4,2591,2139,452,21.131369798971484,morphological_dilation,3,2
0X5407651AF7E19AD1.avi,24,1928,1552,376,24.22680412371134,morphological_dilation,3,2
0X5407BBC70D8C2668.avi,111,1602,1230,372,30.24390243902439,morphological_dilation,3,2
0X5407BBC70D8C2668.avi,135,1030,722,308,42.65927977839335,morphological_dilation,3,2
0X5408E0317663E31D.avi,108,2050,1638,412,25.152625152625152,morphological_dilation,3,2
0X5408E0317663E31D.avi,123,1574,1204,370,30.730897009966778,morphological_dilation,3,2
0X540A087A5D8BA000.avi,43,1837,1441,396,27.480916030534353,morphological_dilation,3,2
0X540A087A5D8BA000.avi,57,1205,869,336,38.66513233601841,morphological_dilation,3,2
0X540A0C3A3D6FE15E.avi,114,1714,1351,363,26.86898593634345,morphological_dilation,3,2
0X540A0C3A3D6FE15E.avi,129,1087,775,312,40.25806451612903,morphological_dilation,3,2
0X540C108EF0C4BC0A.avi,40,1730,1366,364,26.647144948755493,morphological_dilation,3,2
0X540C108EF0C4BC0A.avi,61,1150,846,304,35.9338061465721,morphological_dilation,3,2
0X540CEAFF8921F79A.avi,60,1968,1552,416,26.804123711340207,morphological_dilation,3,2
0X540CEAFF8921F79A.avi,77,1134,814,320,39.31203931203931,morphological_dilation,3,2
0X540DB65A86CE2AE9.avi,41,2261,1833,428,23.349699945444627,morphological_dilation,3,2
0X540DB65A86CE2AE9.avi,56,1481,1125,356,31.644444444444442,morphological_dilation,3,2
0X540FDA7545A0BE0D.avi,91,1646,1274,372,29.199372056514918,morphological_dilation,3,2
0X540FDA7545A0BE0D.avi,102,1016,712,304,42.69662921348314,morphological_dilation,3,2
0X5411B84B15B3E3D3.avi,57,2083,1655,428,25.861027190332326,morphological_dilation,3,2
0X5411B84B15B3E3D3.avi,73,1284,928,356,38.362068965517246,morphological_dilation,3,2
0X541432A2F24BA7A4.avi,3,2038,1622,416,25.64734895191122,morphological_dilation,3,2
0X541432A2F24BA7A4.avi,17,1224,892,332,37.219730941704036,morphological_dilation,3,2
0X5418A371914B3AAD.avi,38,1916,1457,459,31.503088538091973,morphological_dilation,3,2
0X5418A371914B3AAD.avi,51,1396,1004,392,39.04382470119522,morphological_dilation,3,2
0X541C0693140E6AD0.avi,18,1195,887,308,34.72378804960542,morphological_dilation,3,2
0X541C0693140E6AD0.avi,33,918,630,288,45.714285714285715,morphological_dilation,3,2
0X541CBDC87C8A9938.avi,66,1829,1437,392,27.279053583855255,morphological_dilation,3,2
0X541CBDC87C8A9938.avi,86,1514,1150,364,31.65217391304348,morphological_dilation,3,2
0X5420B85CEA2D0031.avi,84,1935,1547,388,25.080801551389786,morphological_dilation,3,2
0X5420B85CEA2D0031.avi,100,1156,848,308,36.32075471698113,morphological_dilation,3,2
0X542269B9EE51A992.avi,101,1739,1359,380,27.961736571008096,morphological_dilation,3,2
0X542269B9EE51A992.avi,118,1054,750,304,40.53333333333333,morphological_dilation,3,2
0X542C044A1CD63BB5.avi,1,1675,1291,384,29.744384198295894,morphological_dilation,3,2
0X542C044A1CD63BB5.avi,17,1054,746,308,41.28686327077748,morphological_dilation,3,2
0X542D2E472E2F1679.avi,51,1250,918,332,36.165577342047925,morphological_dilation,3,2
0X542D2E472E2F1679.avi,71,718,474,244,51.47679324894515,morphological_dilation,3,2
0X5432781F699FAD85.avi,187,1878,1490,388,26.040268456375838,morphological_dilation,3,2
0X5432781F699FAD85.avi,207,1157,849,308,36.27797408716137,morphological_dilation,3,2
0X543AF83606F3A663.avi,44,1606,1242,364,29.307568438003223,morphological_dilation,3,2
0X543AF83606F3A663.avi,57,906,614,292,47.55700325732899,morphological_dilation,3,2
0X543FF08F5AEED836.avi,73,1578,1214,364,29.983525535420096,morphological_dilation,3,2
0X543FF08F5AEED836.avi,81,984,674,310,45.99406528189911,morphological_dilation,3,2
0X5440A5C9A8CACA49.avi,28,1880,1492,388,26.005361930294907,morphological_dilation,3,2
0X5440A5C9A8CACA49.avi,47,1292,972,320,32.92181069958848,morphological_dilation,3,2
0X54426A036FD34753.avi,101,5123,4471,652,14.58286736747931,morphological_dilation,3,2
0X54426A036FD34753.avi,129,4076,3480,596,17.126436781609193,morphological_dilation,3,2
0X54442FC8E9CB9471.avi,67,2019,1611,408,25.32588454376164,morphological_dilation,3,2
0X54442FC8E9CB9471.avi,84,1229,896,333,37.16517857142857,morphological_dilation,3,2
0X5445E6F3C13CBD31.avi,64,1380,1028,352,34.24124513618677,morphological_dilation,3,2
0X5445E6F3C13CBD31.avi,85,808,532,276,51.8796992481203,morphological_dilation,3,2
0X544FD7AD28A89E2.avi,109,1636,1224,412,33.66013071895425,morphological_dilation,3,2
0X544FD7AD28A89E2.avi,129,1244,869,375,43.15304948216341,morphological_dilation,3,2
0X545052C74517595D.avi,37,2707,2227,480,21.553659631791646,morphological_dilation,3,2
0X545052C74517595D.avi,55,1483,1111,372,33.48334833483349,morphological_dilation,3,2
0X5451814C7D5751EE.avi,40,1650,1298,352,27.11864406779661,morphological_dilation,3,2
0X5451814C7D5751EE.avi,55,1018,722,296,40.99722991689751,morphological_dilation,3,2
0X545A13EBCAB66563.avi,41,1859,1427,432,30.27330063069376,morphological_dilation,3,2
0X545A13EBCAB66563.avi,56,1099,730,369,50.54794520547945,morphological_dilation,3,2
0X545A872618190FB2.avi,44,1573,1201,372,30.97418817651957,morphological_dilation,3,2
0X545A872618190FB2.avi,60,890,606,284,46.864686468646866,morphological_dilation,3,2
0X545AE8E42396264B.avi,49,3443,2899,544,18.76509141083132,morphological_dilation,3,2
0X545AE8E42396264B.avi,67,2100,1656,444,26.811594202898554,morphological_dilation,3,2
0X5463B4BB0B291919.avi,50,1475,1129,346,30.646589902568643,morphological_dilation,3,2
0X5463B4BB0B291919.avi,72,982,694,288,41.4985590778098,morphological_dilation,3,2
0X5468C7D7A31C7B4E.avi,114,2025,1597,428,26.80025046963056,morphological_dilation,3,2
0X5468C7D7A31C7B4E.avi,132,1242,906,336,37.086092715231786,morphological_dilation,3,2
0X54698C3D37232417.avi,33,1286,950,336,35.368421052631575,morphological_dilation,3,2
0X54698C3D37232417.avi,48,902,618,284,45.9546925566343,morphological_dilation,3,2
0X547038301E3979F9.avi,33,1421,1067,354,33.177132146204315,morphological_dilation,3,2
0X547038301E3979F9.avi,46,852,568,284,50.0,morphological_dilation,3,2
0X547103856DCD6CB5.avi,64,3151,2629,522,19.855458349182197,morphological_dilation,3,2
0X547103856DCD6CB5.avi,82,1958,1530,428,27.973856209150327,morphological_dilation,3,2
0X547240BF9319AEB2.avi,82,2132,1716,416,24.242424242424242,morphological_dilation,3,2
0X547240BF9319AEB2.avi,89,1229,865,364,42.08092485549133,morphological_dilation,3,2
0X54753D541D22E2A6.avi,53,1808,1408,400,28.40909090909091,morphological_dilation,3,2
0X54753D541D22E2A6.avi,69,1052,736,316,42.934782608695656,morphological_dilation,3,2
0X547722DDE523BEA8.avi,63,1403,1038,365,35.16377649325626,morphological_dilation,3,2
0X547722DDE523BEA8.avi,79,885,585,300,51.28205128205128,morphological_dilation,3,2
0X5477359C84D56656.avi,68,1984,1568,416,26.53061224489796,morphological_dilation,3,2
0X5477359C84D56656.avi,83,1597,1225,372,30.36734693877551,morphological_dilation,3,2
0X5478D5A9213C8100.avi,95,2913,2405,508,21.122661122661125,morphological_dilation,3,2
0X5478D5A9213C8100.avi,118,2090,1612,478,29.652605459057074,morphological_dilation,3,2
0X547B565B7E7D71E0.avi,164,1821,1414,407,28.783592644978782,morphological_dilation,3,2
0X547B565B7E7D71E0.avi,179,1158,807,351,43.49442379182156,morphological_dilation,3,2
0X547BE4F7E93BBD8E.avi,50,1765,1385,380,27.436823104693143,morphological_dilation,3,2
0X547BE4F7E93BBD8E.avi,69,1088,772,316,40.932642487046635,morphological_dilation,3,2
0X5482AE6485A16527.avi,20,2293,1869,424,22.68592830390583,morphological_dilation,3,2
0X5482AE6485A16527.avi,32,1607,1215,392,32.26337448559671,morphological_dilation,3,2
0X5488B4989668C529.avi,64,1631,1259,372,29.547259729944404,morphological_dilation,3,2
0X5488B4989668C529.avi,84,964,664,300,45.18072289156627,morphological_dilation,3,2
0X54929E074AA52477.avi,33,1301,981,320,32.61977573904179,morphological_dilation,3,2
0X54929E074AA52477.avi,48,936,660,276,41.81818181818181,morphological_dilation,3,2
0X5496FF752FDE2035.avi,55,1158,848,310,36.556603773584904,morphological_dilation,3,2
0X5496FF752FDE2035.avi,75,1856,1462,394,26.949384404924757,morphological_dilation,3,2
0X549DC9EF35C8C4E1.avi,31,2179,1751,428,24.44317532838378,morphological_dilation,3,2
0X549DC9EF35C8C4E1.avi,50,1618,1231,387,31.437855402112103,morphological_dilation,3,2
0X549E4D1EF55F1A8E.avi,46,2151,1695,456,26.902654867256636,morphological_dilation,3,2
0X549E4D1EF55F1A8E.avi,69,1139,796,343,43.09045226130653,morphological_dilation,3,2
0X54A01EB69B2856E5.avi,77,2328,1884,444,23.56687898089172,morphological_dilation,3,2
0X54A01EB69B2856E5.avi,90,1535,1176,359,30.52721088435374,morphological_dilation,3,2
0X54A17A345854DE4F.avi,64,1884,1484,400,26.954177897574123,morphological_dilation,3,2
0X54A17A345854DE4F.avi,80,1508,1136,372,32.74647887323944,morphological_dilation,3,2
0X54A1D14B31268CC6.avi,101,2377,1917,460,23.99582681272822,morphological_dilation,3,2
0X54A1D14B31268CC6.avi,117,1856,1436,420,29.247910863509752,morphological_dilation,3,2
0X54A2D65EAE28F52.avi,31,1599,1211,388,32.03963666391412,morphological_dilation,3,2
0X54A2D65EAE28F52.avi,48,997,673,324,48.14264487369985,morphological_dilation,3,2
0X54B01A56E95D4A2E.avi,35,2065,1661,404,24.32269717037929,morphological_dilation,3,2
0X54B01A56E95D4A2E.avi,79,1320,976,344,35.24590163934426,morphological_dilation,3,2
0X54B116C8FC863906.avi,119,1347,1011,336,33.23442136498516,morphological_dilation,3,2
0X54B116C8FC863906.avi,136,825,553,272,49.186256781193485,morphological_dilation,3,2
0X54B16EA56C850E86.avi,62,1170,854,316,37.00234192037471,morphological_dilation,3,2
0X54B16EA56C850E86.avi,82,641,403,238,59.05707196029777,morphological_dilation,3,2
0X54B172E349A11249.avi,44,1406,1051,355,33.77735490009515,morphological_dilation,3,2
0X54B172E349A11249.avi,55,971,675,296,43.851851851851855,morphological_dilation,3,2
0X54B48701142030FC.avi,2,2038,1614,424,26.270136307311027,morphological_dilation,3,2
0X54B48701142030FC.avi,19,1296,944,352,37.28813559322034,morphological_dilation,3,2
0X54B60ED35AF2106C.avi,115,1880,1488,392,26.344086021505376,morphological_dilation,3,2
0X54B60ED35AF2106C.avi,129,1123,819,304,37.11843711843712,morphological_dilation,3,2
0X54B663CB7EDDFDCE.avi,44,3357,2829,528,18.66383881230117,morphological_dilation,3,2
0X54B663CB7EDDFDCE.avi,61,2155,1695,460,27.13864306784661,morphological_dilation,3,2
0X54B71D4AF64D761C.avi,136,1602,1242,360,28.985507246376812,morphological_dilation,3,2
0X54B71D4AF64D761C.avi,156,1174,834,340,40.7673860911271,morphological_dilation,3,2
0X54B8B2249BC8D627.avi,53,1695,1327,368,27.731725697061037,morphological_dilation,3,2
0X54B8B2249BC8D627.avi,72,1062,762,300,39.37007874015748,morphological_dilation,3,2
0X54B9C80F509BBF38.avi,40,2522,2062,460,22.30843840931135,morphological_dilation,3,2
0X54B9C80F509BBF38.avi,60,1574,1194,380,31.825795644891127,morphological_dilation,3,2
0X54BB6DC418E39712.avi,92,3028,2516,512,20.349761526232115,morphological_dilation,3,2
0X54BB6DC418E39712.avi,111,2048,1624,424,26.108374384236456,morphological_dilation,3,2
0X54BDACF8BA99714A.avi,95,1727,1335,392,29.363295880149813,morphological_dilation,3,2
0X54BDACF8BA99714A.avi,112,1064,744,320,43.01075268817204,morphological_dilation,3,2
0X54C421A80132E0C1.avi,35,1266,930,336,36.12903225806451,morphological_dilation,3,2
0X54C421A80132E0C1.avi,49,774,502,272,54.18326693227091,morphological_dilation,3,2
0X54CA4BDAF8C19A6C.avi,40,1865,1473,392,26.61235573659199,morphological_dilation,3,2
0X54CA4BDAF8C19A6C.avi,60,1484,1124,360,32.028469750889684,morphological_dilation,3,2
0X54CB2267CB8CEBBB.avi,66,1514,1154,360,31.195840554592717,morphological_dilation,3,2
0X54CB2267CB8CEBBB.avi,78,1057,755,302,40.0,morphological_dilation,3,2
0X54CD126B0C4D7D78.avi,46,2105,1669,436,26.123427201917316,morphological_dilation,3,2
0X54CD126B0C4D7D78.avi,63,1108,796,312,39.19597989949749,morphological_dilation,3,2
0X54CDBDAA77A5FD1F.avi,72,1494,1126,368,32.682060390763766,morphological_dilation,3,2
0X54CDBDAA77A5FD1F.avi,104,2546,2078,468,22.52165543792108,morphological_dilation,3,2
0X54CF7E6850392CF3.avi,62,1672,1316,356,27.0516717325228,morphological_dilation,3,2
0X54CF7E6850392CF3.avi,75,1561,1213,348,28.689200329760922,morphological_dilation,3,2
0X54D24B12375DA7A9.avi,94,2357,1901,456,23.987375065754865,morphological_dilation,3,2
0X54D24B12375DA7A9.avi,119,1534,1078,456,42.30055658627087,morphological_dilation,3,2
0X54D663188563F412.avi,47,1635,1275,360,28.235294117647058,morphological_dilation,3,2
0X54D663188563F412.avi,66,1066,760,306,40.26315789473684,morphological_dilation,3,2
0X54D8BECFC523ACC0.avi,2,2666,2194,472,21.513217866909752,morphological_dilation,3,2
0X54D8BECFC523ACC0.avi,19,1713,1317,396,30.068337129840543,morphological_dilation,3,2
0X54DB8759A3F32BB7.avi,51,2409,1953,456,23.34869431643625,morphological_dilation,3,2
0X54DB8759A3F32BB7.avi,70,1736,1331,405,30.428249436513898,morphological_dilation,3,2
0X54DF4907CC51E612.avi,47,1718,1338,380,28.400597907324364,morphological_dilation,3,2
0X54DF4907CC51E612.avi,61,1011,703,308,43.81223328591749,morphological_dilation,3,2
0X54E4998C51F9E270.avi,35,1196,894,302,33.78076062639821,morphological_dilation,3,2
0X54E4998C51F9E270.avi,48,727,479,248,51.774530271398746,morphological_dilation,3,2
0X54E58ED86243D0B1.avi,46,3396,2864,532,18.575418994413408,morphological_dilation,3,2
0X54E58ED86243D0B1.avi,69,2473,2021,452,22.365165759524988,morphological_dilation,3,2
0X54EA74B9F2F612A3.avi,116,2061,1649,412,24.98483929654336,morphological_dilation,3,2
0X54EA74B9F2F612A3.avi,146,1307,975,332,34.05128205128205,morphological_dilation,3,2
0X54F30BAC1CA08CA5.avi,48,1303,987,316,32.016210739615,morphological_dilation,3,2
0X54F30BAC1CA08CA5.avi,63,910,642,268,41.74454828660436,morphological_dilation,3,2
0X54F3797A02026F4.avi,15,1281,957,324,33.85579937304075,morphological_dilation,3,2
0X54F3797A02026F4.avi,21,773,497,276,55.53319919517102,morphological_dilation,3,2
0X54FBE65372BC873.avi,63,1557,1209,348,28.78411910669975,morphological_dilation,3,2
0X54FBE65372BC873.avi,84,1042,742,300,40.43126684636118,morphological_dilation,3,2
0X55002DEF59DB3DD2.avi,53,1862,1446,416,28.769017980636235,morphological_dilation,3,2
0X55002DEF59DB3DD2.avi,65,1296,948,348,36.708860759493675,morphological_dilation,3,2
0X55058C5F4D7952FC.avi,52,2128,1708,420,24.59016393442623,morphological_dilation,3,2
0X55058C5F4D7952FC.avi,69,1348,1016,332,32.677165354330704,morphological_dilation,3,2
0X55068EDD14C46A52.avi,0,1310,970,340,35.051546391752574,morphological_dilation,3,2
0X55068EDD14C46A52.avi,19,794,510,284,55.68627450980392,morphological_dilation,3,2
0X5508A93688262E41.avi,111,2450,2006,444,22.13359920239282,morphological_dilation,3,2
0X5508A93688262E41.avi,129,1453,1085,368,33.917050691244235,morphological_dilation,3,2
0X550D53D5EC185F5B.avi,45,3281,2749,532,19.352491815205532,morphological_dilation,3,2
0X550D53D5EC185F5B.avi,63,1665,1273,392,30.793401413982718,morphological_dilation,3,2
0X55108601E603EE28.avi,86,2046,1650,396,24.0,morphological_dilation,3,2
0X55108601E603EE28.avi,101,1869,1493,376,25.184192900200937,morphological_dilation,3,2
0X5511D9A61EB4B90.avi,71,3224,2684,540,20.119225037257824,morphological_dilation,3,2
0X5511D9A61EB4B90.avi,90,2075,1608,467,29.04228855721393,morphological_dilation,3,2
0X551726008E92B23D.avi,85,1558,1202,356,29.61730449251248,morphological_dilation,3,2
0X551726008E92B23D.avi,99,924,648,276,42.592592592592595,morphological_dilation,3,2
0X5519060A689F206.avi,33,2109,1709,400,23.405500292568753,morphological_dilation,3,2
0X5519060A689F206.avi,45,1851,1477,374,25.321597833446173,morphological_dilation,3,2
0X551C98C8FE6B51A9.avi,3,2715,2223,492,22.13225371120108,morphological_dilation,3,2
0X551C98C8FE6B51A9.avi,16,1745,1325,420,31.69811320754717,morphological_dilation,3,2
0X551E297304F24B60.avi,48,1780,1406,374,26.600284495021338,morphological_dilation,3,2
0X551E297304F24B60.avi,112,1052,760,292,38.421052631578945,morphological_dilation,3,2
0X55232922CC7FEEED.avi,43,4595,3979,616,15.481276702689117,morphological_dilation,3,2
0X55232922CC7FEEED.avi,63,4003,3440,563,16.366279069767444,morphological_dilation,3,2
0X5525679C7CAF9ACA.avi,54,1581,1197,384,32.08020050125313,morphological_dilation,3,2
0X5525679C7CAF9ACA.avi,72,1007,683,324,47.43777452415813,morphological_dilation,3,2
0X552D2BEC02396DD4.avi,104,1941,1533,408,26.614481409001954,morphological_dilation,3,2
0X552D2BEC02396DD4.avi,120,1272,924,348,37.66233766233766,morphological_dilation,3,2
0X552F06BFE42062D8.avi,41,1726,1358,368,27.098674521354933,morphological_dilation,3,2
0X552F06BFE42062D8.avi,59,1036,736,300,40.76086956521739,morphological_dilation,3,2
0X552F28636AF60E12.avi,41,1768,1380,388,28.115942028985508,morphological_dilation,3,2
0X552F28636AF60E12.avi,58,1066,758,308,40.633245382585756,morphological_dilation,3,2
0X552F36A6E92D7FE8.avi,35,2010,1574,436,27.70012706480305,morphological_dilation,3,2
0X552F36A6E92D7FE8.avi,51,1053,709,344,48.51904090267983,morphological_dilation,3,2
0X55306990D785541A.avi,115,1628,1244,384,30.86816720257235,morphological_dilation,3,2
0X55306990D785541A.avi,134,977,654,323,49.38837920489297,morphological_dilation,3,2
0X5530A07BC4EB238F.avi,61,1952,1560,392,25.128205128205128,morphological_dilation,3,2
0X5530A07BC4EB238F.avi,81,1495,1147,348,30.340017436791634,morphological_dilation,3,2
0X55324702AE57AF6D.avi,40,865,593,272,45.86846543001686,morphological_dilation,3,2
0X55324702AE57AF6D.avi,58,594,358,236,65.92178770949721,morphological_dilation,3,2
0X5532CED62BAB6882.avi,1,1581,1233,348,28.223844282238442,morphological_dilation,3,2
0X5532CED62BAB6882.avi,17,939,663,276,41.6289592760181,morphological_dilation,3,2
0X5537710165616E3F.avi,42,1740,1356,384,28.31858407079646,morphological_dilation,3,2
0X5537710165616E3F.avi,59,1241,909,332,36.52365236523652,morphological_dilation,3,2
0X554436B8E190C6C8.avi,90,2836,2332,504,21.612349914236706,morphological_dilation,3,2
0X554436B8E190C6C8.avi,102,2248,1800,448,24.88888888888889,morphological_dilation,3,2
0X5544FBF1BA5A9A61.avi,94,1382,1046,336,32.122370936902485,morphological_dilation,3,2
0X5544FBF1BA5A9A61.avi,108,874,598,276,46.15384615384615,morphological_dilation,3,2
0X554AC1E23B17F678.avi,92,2612,2148,464,21.601489757914337,morphological_dilation,3,2
0X554AC1E23B17F678.avi,104,1703,1327,376,28.334589299171064,morphological_dilation,3,2
0X554BA85E872B3ADC.avi,66,1470,1095,375,34.24657534246575,morphological_dilation,3,2
0X554BA85E872B3ADC.avi,78,955,626,329,52.55591054313099,morphological_dilation,3,2
0X554E1E7CA898F04B.avi,0,1862,1474,388,26.322930800542743,morphological_dilation,3,2
0X554E1E7CA898F04B.avi,19,999,711,288,40.50632911392405,morphological_dilation,3,2
0X554F12E355AF8FF4.avi,2,1329,1009,320,31.714568880079284,morphological_dilation,3,2
0X554F12E355AF8FF4.avi,12,767,511,256,50.09784735812133,morphological_dilation,3,2
0X5551A05C97F8D56D.avi,60,1904,1524,380,24.93438320209974,morphological_dilation,3,2
0X5551A05C97F8D56D.avi,80,1171,879,292,33.21956769055745,morphological_dilation,3,2
0X5555BF5C1EDB9A9B.avi,51,2233,1814,419,23.098125689084895,morphological_dilation,3,2
0X5555BF5C1EDB9A9B.avi,73,1278,954,324,33.9622641509434,morphological_dilation,3,2
0X555625C9E3EC6CEC.avi,68,1343,1007,336,33.36643495531281,morphological_dilation,3,2
0X555625C9E3EC6CEC.avi,86,854,574,280,48.78048780487805,morphological_dilation,3,2
0X555876814CADAFA9.avi,90,1435,1077,358,33.24048282265552,morphological_dilation,3,2
0X555876814CADAFA9.avi,105,922,634,288,45.42586750788644,morphological_dilation,3,2
0X55622F196983BF6A.avi,73,1738,1346,392,29.123328380386333,morphological_dilation,3,2
0X55622F196983BF6A.avi,84,1074,758,316,41.68865435356201,morphological_dilation,3,2
0X5563B85DBBF1351C.avi,0,2429,2013,416,20.66567312468952,morphological_dilation,3,2
0X5563B85DBBF1351C.avi,24,1974,1594,380,23.83939774153074,morphological_dilation,3,2
0X556778F52DA9C489.avi,133,1859,1472,387,26.290760869565215,morphological_dilation,3,2
0X556778F52DA9C489.avi,152,1033,741,292,39.40620782726046,morphological_dilation,3,2
0X556D518F0DA96477.avi,69,1661,1265,396,31.30434782608696,morphological_dilation,3,2
0X556D518F0DA96477.avi,77,1106,766,340,44.38642297650131,morphological_dilation,3,2
0X556EDE44066B12B8.avi,2,1282,966,316,32.71221532091098,morphological_dilation,3,2
0X556EDE44066B12B8.avi,21,819,559,260,46.51162790697674,morphological_dilation,3,2
0X556FD0F89DA85639.avi,52,1916,1517,399,26.301911667765328,morphological_dilation,3,2
0X556FD0F89DA85639.avi,71,1661,1271,390,30.68450039339103,morphological_dilation,3,2
0X5572CB2B3CEA5D9D.avi,121,1803,1423,380,26.704146170063247,morphological_dilation,3,2
0X5572CB2B3CEA5D9D.avi,134,1081,777,304,39.12483912483912,morphological_dilation,3,2
0X5572F384EF9DD9FC.avi,53,2026,1634,392,23.990208078335375,morphological_dilation,3,2
0X5572F384EF9DD9FC.avi,71,1090,798,292,36.59147869674185,morphological_dilation,3,2
0X55776F3806F893EA.avi,29,1301,969,332,34.26212590299277,morphological_dilation,3,2
0X55776F3806F893EA.avi,40,764,492,272,55.28455284552846,morphological_dilation,3,2
0X557E1E735D23884B.avi,113,1604,1240,364,29.354838709677416,morphological_dilation,3,2
0X557E1E735D23884B.avi,129,994,698,296,42.40687679083094,morphological_dilation,3,2
0X5581B2D3B0328218.avi,155,2842,2342,500,21.34927412467976,morphological_dilation,3,2
0X5581B2D3B0328218.avi,175,1832,1421,411,28.92329345531316,morphological_dilation,3,2
0X55822C238F9E5AD3.avi,114,1992,1576,416,26.39593908629442,morphological_dilation,3,2
0X55822C238F9E5AD3.avi,134,1163,839,324,38.61740166865316,morphological_dilation,3,2
0X55866DE7615EB0C5.avi,69,1331,968,363,37.5,morphological_dilation,3,2
0X55866DE7615EB0C5.avi,91,852,557,295,52.96229802513464,morphological_dilation,3,2
0X558A2A6676BE7D36.avi,45,2675,2203,472,21.425329096686337,morphological_dilation,3,2
0X558A2A6676BE7D36.avi,66,1569,1201,368,30.641132389675267,morphological_dilation,3,2
0X558BBB9DC59ABE58.avi,60,1611,1235,376,30.44534412955466,morphological_dilation,3,2
0X558BBB9DC59ABE58.avi,74,1206,868,338,38.94009216589861,morphological_dilation,3,2
0X558C8F3D27CEDA73.avi,60,1892,1496,396,26.47058823529412,morphological_dilation,3,2
0X558C8F3D27CEDA73.avi,72,1268,940,328,34.8936170212766,morphological_dilation,3,2
0X558FCFDEDFCAFCD5.avi,4,1489,1143,346,30.271216097987754,morphological_dilation,3,2
0X558FCFDEDFCAFCD5.avi,19,963,665,298,44.81203007518797,morphological_dilation,3,2
0X5590B39A15DFDEFB.avi,57,1563,1207,356,29.494614747307374,morphological_dilation,3,2
0X5590B39A15DFDEFB.avi,70,1061,753,308,40.90305444887118,morphological_dilation,3,2
0X559321CCEEEF01DF.avi,43,1733,1335,398,29.812734082397004,morphological_dilation,3,2
0X559321CCEEEF01DF.avi,57,1042,703,339,48.22190611664296,morphological_dilation,3,2
0X55946D9966062EAB.avi,21,1072,768,304,39.58333333333333,morphological_dilation,3,2
0X55946D9966062EAB.avi,32,861,581,280,48.19277108433735,morphological_dilation,3,2
0X5595939CF40AD617.avi,0,2007,1619,388,23.965410747374925,morphological_dilation,3,2
0X5595939CF40AD617.avi,20,1186,880,306,34.77272727272727,morphological_dilation,3,2
0X5596B9090BBECECC.avi,53,1069,781,288,36.875800256081945,morphological_dilation,3,2
0X5596B9090BBECECC.avi,72,693,453,240,52.980132450331126,morphological_dilation,3,2
0X559CBA3607FC7673.avi,49,2482,1986,496,24.97482376636455,morphological_dilation,3,2
0X559CBA3607FC7673.avi,64,1419,981,438,44.64831804281346,morphological_dilation,3,2
0X559FE34A6D107985.avi,61,1816,1416,400,28.24858757062147,morphological_dilation,3,2
0X559FE34A6D107985.avi,79,1080,756,324,42.857142857142854,morphological_dilation,3,2
0X55A40FE407A960E2.avi,50,1478,1106,372,33.634719710669074,morphological_dilation,3,2
0X55A40FE407A960E2.avi,60,934,627,307,48.963317384370015,morphological_dilation,3,2
0X55A8DADE461043A7.avi,105,2181,1725,456,26.43478260869565,morphological_dilation,3,2
0X55A8DADE461043A7.avi,123,1334,964,370,38.38174273858922,morphological_dilation,3,2
0X55AD49CFEDC55DA0.avi,74,1212,876,336,38.35616438356164,morphological_dilation,3,2
0X55AD49CFEDC55DA0.avi,90,910,610,300,49.18032786885246,morphological_dilation,3,2
0X55AE4F5E25A9609F.avi,39,1758,1350,408,30.22222222222222,morphological_dilation,3,2
0X55AE4F5E25A9609F.avi,56,984,676,308,45.562130177514796,morphological_dilation,3,2
0X55AEA1223ADFB9E8.avi,37,1405,1063,342,32.173095014111006,morphological_dilation,3,2
0X55AEA1223ADFB9E8.avi,54,984,676,308,45.562130177514796,morphological_dilation,3,2
0X55B0C7326EDA51B0.avi,37,1184,876,308,35.15981735159817,morphological_dilation,3,2
0X55B0C7326EDA51B0.avi,49,842,562,280,49.8220640569395,morphological_dilation,3,2
0X55B0F73B6D560359.avi,35,1254,918,336,36.60130718954248,morphological_dilation,3,2
0X55B0F73B6D560359.avi,50,749,483,266,55.072463768115945,morphological_dilation,3,2
0X55B28D6DC97FB5C4.avi,44,1901,1486,415,27.927321668909826,morphological_dilation,3,2
0X55B28D6DC97FB5C4.avi,65,1432,1037,395,38.09064609450338,morphological_dilation,3,2
0X55B2FB1BDE1B809F.avi,53,2360,1921,439,22.852680895366998,morphological_dilation,3,2
0X55B2FB1BDE1B809F.avi,75,1463,1112,351,31.564748201438846,morphological_dilation,3,2
0X55B49E2362323D1F.avi,30,1495,1147,348,30.340017436791634,morphological_dilation,3,2
0X55B49E2362323D1F.avi,42,981,689,292,42.380261248185775,morphological_dilation,3,2
0X55B743099A8EC7BC.avi,62,1340,1020,320,31.372549019607842,morphological_dilation,3,2
0X55B743099A8EC7BC.avi,77,711,455,256,56.26373626373626,morphological_dilation,3,2
0X55BAE17B3063905A.avi,53,1222,910,312,34.285714285714285,morphological_dilation,3,2
0X55BAE17B3063905A.avi,70,884,596,288,48.322147651006716,morphological_dilation,3,2
0X55BD75ADD9A85ADB.avi,48,1730,1354,376,27.76957163958641,morphological_dilation,3,2
0X55BD75ADD9A85ADB.avi,70,1231,903,328,36.32336655592469,morphological_dilation,3,2
0X55BE2D4BC726F7B7.avi,81,1962,1574,388,24.650571791613725,morphological_dilation,3,2
0X55BE2D4BC726F7B7.avi,95,1110,806,304,37.71712158808933,morphological_dilation,3,2
0X55C0000B295E5100.avi,59,1589,1225,364,29.714285714285715,morphological_dilation,3,2
0X55C0000B295E5100.avi,74,1184,843,341,40.45077105575326,morphological_dilation,3,2
0X55C600641A1669E.avi,49,1363,1027,336,32.716650438169424,morphological_dilation,3,2
0X55C600641A1669E.avi,65,793,525,268,51.04761904761905,morphological_dilation,3,2
0X55CA123768AEFB14.avi,82,1372,1038,334,32.177263969171484,morphological_dilation,3,2
0X55CA123768AEFB14.avi,98,1017,717,300,41.84100418410041,morphological_dilation,3,2
0X55CFEE15BB86A841.avi,208,3301,2781,520,18.698309960445883,morphological_dilation,3,2
0X55CFEE15BB86A841.avi,238,2218,1766,452,25.59456398640997,morphological_dilation,3,2
0X55D3F7134FE08939.avi,58,1382,1042,340,32.629558541266796,morphological_dilation,3,2
0X55D3F7134FE08939.avi,68,800,532,268,50.37593984962406,morphological_dilation,3,2
0X55D7CB901F53B25F.avi,64,1903,1515,388,25.610561056105613,morphological_dilation,3,2
0X55D7CB901F53B25F.avi,80,1268,936,332,35.47008547008547,morphological_dilation,3,2
0X55D7F567D55FE1F6.avi,64,1379,1039,340,32.723772858517805,morphological_dilation,3,2
0X55D7F567D55FE1F6.avi,87,874,590,284,48.13559322033898,morphological_dilation,3,2
0X55D97A446839D999.avi,65,2820,2316,504,21.761658031088082,morphological_dilation,3,2
0X55D97A446839D999.avi,79,1816,1377,439,31.88090050835149,morphological_dilation,3,2
0X55DD5AB1762EDCDA.avi,57,1173,849,324,38.16254416961131,morphological_dilation,3,2
0X55DD5AB1762EDCDA.avi,81,724,472,252,53.38983050847458,morphological_dilation,3,2
0X55EF093BB97CF2D1.avi,7,2592,2128,464,21.804511278195488,morphological_dilation,3,2
0X55EF093BB97CF2D1.avi,23,2380,1925,455,23.636363636363637,morphological_dilation,3,2
0X55F05AC4B87FF7ED.avi,134,1463,1119,344,30.741733690795353,morphological_dilation,3,2
0X55F05AC4B87FF7ED.avi,155,954,674,280,41.54302670623146,morphological_dilation,3,2
0X55F34E78F82115A.avi,58,3467,2939,528,17.96529431779517,morphological_dilation,3,2
0X55F34E78F82115A.avi,85,1893,1497,396,26.452905811623246,morphological_dilation,3,2
0X55F5808EF06694A4.avi,52,1929,1525,404,26.491803278688526,morphological_dilation,3,2
0X55F5808EF06694A4.avi,72,1185,857,328,38.2730455075846,morphological_dilation,3,2
0X55F8010A394F3756.avi,58,2534,2074,460,22.179363548698166,morphological_dilation,3,2
0X55F8010A394F3756.avi,74,1540,1176,364,30.952380952380953,morphological_dilation,3,2
0X55FF5914AD9A8C52.avi,49,1835,1455,380,26.11683848797251,morphological_dilation,3,2
0X55FF5914AD9A8C52.avi,71,1405,1073,332,30.941286113699906,morphological_dilation,3,2
0X560279556FB69A44.avi,89,2274,1836,438,23.856209150326798,morphological_dilation,3,2
0X560279556FB69A44.avi,108,1243,907,336,37.045203969129,morphological_dilation,3,2
0X5604847553919219.avi,41,3045,2534,511,20.165745856353592,morphological_dilation,3,2
0X5604847553919219.avi,55,2522,2043,479,23.445912873225648,morphological_dilation,3,2
0X5606683C2B5E4E3C.avi,105,1885,1497,388,25.918503674014698,morphological_dilation,3,2
0X5606683C2B5E4E3C.avi,121,1209,889,320,35.9955005624297,morphological_dilation,3,2
0X56099E849EE89786.avi,49,2334,1874,460,24.546424759871933,morphological_dilation,3,2
0X56099E849EE89786.avi,74,1402,1050,352,33.523809523809526,morphological_dilation,3,2
0X560AC3ED5C9AA949.avi,55,2598,2154,444,20.61281337047354,morphological_dilation,3,2
0X560AC3ED5C9AA949.avi,72,2029,1621,408,25.169648365206665,morphological_dilation,3,2
0X560DCF7EA12DC533.avi,118,1425,1085,340,31.336405529953915,morphological_dilation,3,2
0X560DCF7EA12DC533.avi,131,896,604,292,48.34437086092716,morphological_dilation,3,2
0X560F4FD09C718326.avi,97,1929,1517,412,27.158866183256425,morphological_dilation,3,2
0X560F4FD09C718326.avi,114,1160,832,328,39.42307692307692,morphological_dilation,3,2
0X561479A7A64AF873.avi,100,1404,1080,324,30.0,morphological_dilation,3,2
0X561479A7A64AF873.avi,115,831,571,260,45.53415061295972,morphological_dilation,3,2
0X5617906D2ADFA252.avi,2,1577,1201,376,31.307243963363863,morphological_dilation,3,2
0X5617906D2ADFA252.avi,19,1153,813,340,41.82041820418204,morphological_dilation,3,2
0X56196FF1812E8C2.avi,115,2634,2128,506,23.778195488721803,morphological_dilation,3,2
0X56196FF1812E8C2.avi,138,1353,977,376,38.485158648925285,morphological_dilation,3,2
0X561B0F7DC084235B.avi,104,1789,1405,384,27.330960854092528,morphological_dilation,3,2
0X561B0F7DC084235B.avi,115,1278,934,344,36.83083511777302,morphological_dilation,3,2
0X561B176101B8763D.avi,113,2351,1899,452,23.802001053185887,morphological_dilation,3,2
0X561B176101B8763D.avi,126,1459,1080,379,35.092592592592595,morphological_dilation,3,2
0X561EA6D2BA7109CC.avi,2,1879,1499,380,25.350233488992664,morphological_dilation,3,2
0X561EA6D2BA7109CC.avi,29,1163,843,320,37.959667852906286,morphological_dilation,3,2
0X562104499AF7434C.avi,45,1379,1051,328,31.208372978116078,morphological_dilation,3,2
0X562104499AF7434C.avi,63,1001,709,292,41.18476727785614,morphological_dilation,3,2
0X5623423CD11DB981.avi,38,1439,1111,328,29.522952295229523,morphological_dilation,3,2
0X5623423CD11DB981.avi,61,1049,741,308,41.56545209176788,morphological_dilation,3,2
0X5628BF37F914D9D3.avi,36,3142,2626,516,19.64965727341965,morphological_dilation,3,2
0X5628BF37F914D9D3.avi,60,1994,1587,407,25.645872715816004,morphological_dilation,3,2
0X562D7CFA5BAE1A69.avi,131,1698,1326,372,28.054298642533936,morphological_dilation,3,2
0X562D7CFA5BAE1A69.avi,146,1150,820,330,40.243902439024396,morphological_dilation,3,2
0X562DD4BDA72895C5.avi,2,1824,1416,408,28.8135593220339,morphological_dilation,3,2
0X562DD4BDA72895C5.avi,19,1160,836,324,38.75598086124402,morphological_dilation,3,2
0X562F92891AEF1368.avi,38,3686,3118,568,18.216805644644,morphological_dilation,3,2
0X562F92891AEF1368.avi,52,2203,1751,452,25.81382067390063,morphological_dilation,3,2
0X5634E7D1A1EF62FE.avi,78,1765,1385,380,27.436823104693143,morphological_dilation,3,2
0X5634E7D1A1EF62FE.avi,92,1163,843,320,37.959667852906286,morphological_dilation,3,2
0X5637911EE0FA79F3.avi,51,1479,1087,392,36.06255749770009,morphological_dilation,3,2
0X5637911EE0FA79F3.avi,67,986,622,364,58.520900321543415,morphological_dilation,3,2
0X563A4DE533398A77.avi,0,3229,2710,519,19.15129151291513,morphological_dilation,3,2
0X563A4DE533398A77.avi,23,1898,1478,420,28.416779431664413,morphological_dilation,3,2
0X563EE078BB4DBE66.avi,39,848,584,264,45.20547945205479,morphological_dilation,3,2
0X563EE078BB4DBE66.avi,50,1304,976,328,33.60655737704918,morphological_dilation,3,2
0X56477376D54B5518.avi,67,1860,1460,400,27.397260273972602,morphological_dilation,3,2
0X56477376D54B5518.avi,82,1158,838,320,38.18615751789976,morphological_dilation,3,2
0X564851F58C08D3CF.avi,230,1704,1344,360,26.785714285714285,morphological_dilation,3,2
0X564851F58C08D3CF.avi,247,1084,785,299,38.089171974522294,morphological_dilation,3,2
0X5648DF28AE0A879F.avi,178,1094,792,302,38.131313131313135,morphological_dilation,3,2
0X5648DF28AE0A879F.avi,194,696,448,248,55.35714285714286,morphological_dilation,3,2
0X56497E5A81DB483A.avi,53,2319,1871,448,23.944414751469804,morphological_dilation,3,2
0X56497E5A81DB483A.avi,68,1542,1166,376,32.24699828473413,morphological_dilation,3,2
0X564B7112D21AC297.avi,49,2701,2237,464,20.742065265981225,morphological_dilation,3,2
0X564B7112D21AC297.avi,68,2235,1779,456,25.632377740303543,morphological_dilation,3,2
0X564D07499141655.avi,49,1956,1554,402,25.868725868725868,morphological_dilation,3,2
0X564D07499141655.avi,67,1333,981,352,35.881753312945975,morphological_dilation,3,2
0X564F15765F05A7ED.avi,32,1970,1570,400,25.477707006369428,morphological_dilation,3,2
0X564F15765F05A7ED.avi,45,1680,1300,380,29.230769230769234,morphological_dilation,3,2
0X565CB99FA2247353.avi,91,1801,1429,372,26.03219034289713,morphological_dilation,3,2
0X565CB99FA2247353.avi,110,1134,840,294,35.0,morphological_dilation,3,2
0X566073CD81D42C71.avi,91,1711,1351,360,26.646928201332347,morphological_dilation,3,2
0X566073CD81D42C71.avi,105,1270,958,312,32.5678496868476,morphological_dilation,3,2
0X566816B89E817417.avi,76,2573,2097,476,22.69909394372914,morphological_dilation,3,2
0X566816B89E817417.avi,94,1583,1180,403,34.152542372881356,morphological_dilation,3,2
0X566B56DBD9C76630.avi,51,2245,1813,432,23.827909542195254,morphological_dilation,3,2
0X566B56DBD9C76630.avi,75,1547,1175,372,31.659574468085104,morphological_dilation,3,2
0X566BCD122F004DBB.avi,98,1245,909,336,36.96369636963696,morphological_dilation,3,2
0X566BCD122F004DBB.avi,117,761,484,277,57.231404958677686,morphological_dilation,3,2
0X56708560343E424C.avi,2,1793,1401,392,27.98001427551749,morphological_dilation,3,2
0X56708560343E424C.avi,18,1101,785,316,40.254777070063696,morphological_dilation,3,2
0X56744939961E376C.avi,5,1304,953,351,36.83105981112277,morphological_dilation,3,2
0X56744939961E376C.avi,22,860,564,296,52.4822695035461,morphological_dilation,3,2
0X56772AFC64BB2E21.avi,33,2859,2391,468,19.573400250941027,morphological_dilation,3,2
0X56772AFC64BB2E21.avi,47,2721,2269,452,19.920669898633758,morphological_dilation,3,2
0X5678F14272EC915.avi,72,1845,1461,384,26.283367556468175,morphological_dilation,3,2
0X5678F14272EC915.avi,86,1585,1235,350,28.34008097165992,morphological_dilation,3,2
0X56797D174D34659A.avi,113,2382,1942,440,22.657054582904223,morphological_dilation,3,2
0X56797D174D34659A.avi,140,1955,1559,396,25.400898011545863,morphological_dilation,3,2
0X567AE5FEFC5CE4C6.avi,113,2727,2231,496,22.23218287763335,morphological_dilation,3,2
0X567AE5FEFC5CE4C6.avi,128,1741,1337,404,30.21690351533283,morphological_dilation,3,2
0X567C02D701B3C187.avi,94,3214,2670,544,20.374531835205993,morphological_dilation,3,2
0X567C02D701B3C187.avi,108,1775,1331,444,33.35837716003005,morphological_dilation,3,2
0X568003EF393E748E.avi,125,1393,1033,360,34.84995159728945,morphological_dilation,3,2
0X568003EF393E748E.avi,146,794,522,272,52.10727969348659,morphological_dilation,3,2
0X5680EEA4E51CBF5E.avi,4,1441,1069,372,34.79887745556595,morphological_dilation,3,2
0X5680EEA4E51CBF5E.avi,19,1043,666,377,56.606606606606604,morphological_dilation,3,2
0X568183EB03D60A5E.avi,70,2192,1748,444,25.400457665903893,morphological_dilation,3,2
0X568183EB03D60A5E.avi,86,1480,1104,376,34.05797101449276,morphological_dilation,3,2
0X5681A0EC29CEDAFB.avi,104,2604,2132,472,22.138836772983115,morphological_dilation,3,2
0X5681A0EC29CEDAFB.avi,118,1635,1251,384,30.69544364508393,morphological_dilation,3,2
0X5682461951253D12.avi,88,1685,1288,397,30.82298136645963,morphological_dilation,3,2
0X5682461951253D12.avi,107,1032,712,320,44.9438202247191,morphological_dilation,3,2
0X56832722695AD390.avi,103,1984,1584,400,25.252525252525253,morphological_dilation,3,2
0X56832722695AD390.avi,118,1163,827,336,40.628778718258765,morphological_dilation,3,2
0X56874CBB4CCD7382.avi,119,2476,2000,476,23.799999999999997,morphological_dilation,3,2
0X56874CBB4CCD7382.avi,137,1613,1214,399,32.8665568369028,morphological_dilation,3,2
0X568C885819B16C0A.avi,211,2325,1901,424,22.30405049973698,morphological_dilation,3,2
0X568C885819B16C0A.avi,231,1949,1557,392,25.176621708413617,morphological_dilation,3,2
0X568CB22448662BDC.avi,2,1677,1297,380,29.298380878951424,morphological_dilation,3,2
0X568CB22448662BDC.avi,19,1120,797,323,40.52697616060226,morphological_dilation,3,2
0X569083868ADC8519.avi,95,1974,1566,408,26.053639846743295,morphological_dilation,3,2
0X569083868ADC8519.avi,110,1119,807,312,38.66171003717472,morphological_dilation,3,2
0X5694870433CABB5.avi,1,2089,1665,424,25.465465465465464,morphological_dilation,3,2
0X5694870433CABB5.avi,16,1229,885,344,38.87005649717514,morphological_dilation,3,2
0X5699359D37175033.avi,40,1595,1225,370,30.20408163265306,morphological_dilation,3,2
0X5699359D37175033.avi,54,1119,790,329,41.64556962025316,morphological_dilation,3,2
0X569C32CA446F75CB.avi,54,2194,1774,420,23.675310033821873,morphological_dilation,3,2
0X569C32CA446F75CB.avi,76,1352,1004,348,34.66135458167331,morphological_dilation,3,2
0X569DEFF95A8A059F.avi,43,1605,1245,360,28.915662650602407,morphological_dilation,3,2
0X569DEFF95A8A059F.avi,60,936,636,300,47.16981132075472,morphological_dilation,3,2
0X56A3F4651716DAFF.avi,38,1647,1299,348,26.78983833718245,morphological_dilation,3,2
0X56A3F4651716DAFF.avi,52,1197,889,308,34.645669291338585,morphological_dilation,3,2
0X56AA2BDAB8C1F14F.avi,45,1151,824,327,39.68446601941748,morphological_dilation,3,2
0X56AA2BDAB8C1F14F.avi,56,769,493,276,55.98377281947262,morphological_dilation,3,2
0X56AEDD98E8E5A043.avi,126,1285,951,334,35.120925341745526,morphological_dilation,3,2
0X56AEDD98E8E5A043.avi,141,816,536,280,52.23880597014925,morphological_dilation,3,2
0X56AF18E9AFAC458.avi,67,1361,1025,336,32.78048780487805,morphological_dilation,3,2
0X56AF18E9AFAC458.avi,80,1028,724,304,41.988950276243095,morphological_dilation,3,2
0X56B33CBB233A00B9.avi,48,1754,1378,376,27.28592162554427,morphological_dilation,3,2
0X56B33CBB233A00B9.avi,66,1066,758,308,40.633245382585756,morphological_dilation,3,2
0X56B7224CF1210326.avi,77,1192,876,316,36.07305936073059,morphological_dilation,3,2
0X56B7224CF1210326.avi,88,749,509,240,47.151277013752456,morphological_dilation,3,2
0X56B7729C43515690.avi,61,1416,1052,364,34.60076045627377,morphological_dilation,3,2
0X56B7729C43515690.avi,76,935,611,324,53.0278232405892,morphological_dilation,3,2
0X56B7B0747C33B23A.avi,97,1295,963,332,34.47559709241953,morphological_dilation,3,2
0X56B7B0747C33B23A.avi,118,863,583,280,48.02744425385935,morphological_dilation,3,2
0X56B9E97A265B9F6C.avi,51,1948,1560,388,24.871794871794872,morphological_dilation,3,2
0X56B9E97A265B9F6C.avi,69,1255,915,340,37.15846994535519,morphological_dilation,3,2
0X56BAEFC36506EC74.avi,84,1612,1160,452,38.96551724137931,morphological_dilation,3,2
0X56BAEFC36506EC74.avi,99,1067,763,304,39.84272608125819,morphological_dilation,3,2
0X56BDAF0A20E92CF1.avi,2,2097,1657,440,26.55401327700664,morphological_dilation,3,2
0X56BDAF0A20E92CF1.avi,21,1249,885,364,41.12994350282486,morphological_dilation,3,2
0X56C0487D888C3C2E.avi,39,1978,1570,408,25.987261146496817,morphological_dilation,3,2
0X56C0487D888C3C2E.avi,55,1385,1015,370,36.45320197044335,morphological_dilation,3,2
0X56C28776175F8548.avi,156,2473,2041,432,21.166095051445367,morphological_dilation,3,2
0X56C28776175F8548.avi,173,1389,1047,342,32.664756446991404,morphological_dilation,3,2
0X56C97E9D6660C8B7.avi,88,1452,1100,352,32.0,morphological_dilation,3,2
0X56C97E9D6660C8B7.avi,106,755,487,268,55.03080082135524,morphological_dilation,3,2
0X56D0F1AB970BFE4D.avi,35,1966,1562,404,25.86427656850192,morphological_dilation,3,2
0X56D0F1AB970BFE4D.avi,48,1232,900,332,36.888888888888886,morphological_dilation,3,2
0X56D7623C833287F2.avi,95,1525,1169,356,30.453378956372966,morphological_dilation,3,2
0X56D7623C833287F2.avi,119,1155,847,308,36.36363636363637,morphological_dilation,3,2
0X56D95E6BBB21D5B4.avi,3,1075,778,297,38.174807197943444,morphological_dilation,3,2
0X56D95E6BBB21D5B4.avi,21,657,417,240,57.55395683453237,morphological_dilation,3,2
0X56E3DF133F5CF751.avi,3,1260,936,324,34.61538461538461,morphological_dilation,3,2
0X56E3DF133F5CF751.avi,20,851,583,268,45.96912521440824,morphological_dilation,3,2
0X56E7A49CF36EA5F9.avi,114,1943,1531,412,26.910516002612674,morphological_dilation,3,2
0X56E7A49CF36EA5F9.avi,127,1328,980,348,35.51020408163265,morphological_dilation,3,2
0X56ECC2667F530B1.avi,115,1378,1034,344,33.26885880077369,morphological_dilation,3,2
0X56ECC2667F530B1.avi,135,939,643,296,46.034214618973564,morphological_dilation,3,2
0X56F50AAB96844031.avi,30,1731,1367,364,26.627651792245793,morphological_dilation,3,2
0X56F50AAB96844031.avi,42,1344,1028,316,30.739299610894943,morphological_dilation,3,2
0X56F9344331EA3B8.avi,68,1546,1190,356,29.915966386554622,morphological_dilation,3,2
0X56F9344331EA3B8.avi,81,997,697,300,43.0416068866571,morphological_dilation,3,2
0X56FC2793F196F52C.avi,74,1195,871,324,37.198622273249136,morphological_dilation,3,2
0X56FC2793F196F52C.avi,89,801,521,280,53.74280230326296,morphological_dilation,3,2
0X56FC615935BD61AD.avi,45,1832,1436,396,27.57660167130919,morphological_dilation,3,2
0X56FC615935BD61AD.avi,58,1165,837,328,39.18757467144564,morphological_dilation,3,2
0X56FD0409BFA202DF.avi,45,3625,3081,544,17.65660499837715,morphological_dilation,3,2
0X56FD0409BFA202DF.avi,64,2485,1970,515,26.14213197969543,morphological_dilation,3,2
0X570169A62E38E453.avi,36,1084,772,312,40.41450777202073,morphological_dilation,3,2
0X570169A62E38E453.avi,48,974,678,296,43.657817109144545,morphological_dilation,3,2
0X57049D79D2223947.avi,70,3094,2594,500,19.275250578257516,morphological_dilation,3,2
0X57049D79D2223947.avi,88,2490,2062,428,20.75654704170708,morphological_dilation,3,2
0X57068FCB2941B2B0.avi,48,1702,1306,396,30.321592649310876,morphological_dilation,3,2
0X57068FCB2941B2B0.avi,59,1039,656,383,58.38414634146341,morphological_dilation,3,2
0X5709B89606570BB5.avi,75,1453,1113,340,30.54806828391734,morphological_dilation,3,2
0X5709B89606570BB5.avi,92,868,588,280,47.61904761904761,morphological_dilation,3,2
0X570CF669C75084DE.avi,49,1337,1001,336,33.56643356643357,morphological_dilation,3,2
0X570CF669C75084DE.avi,63,779,519,260,50.09633911368015,morphological_dilation,3,2
0X57115FCDFC17AD13.avi,69,1863,1475,388,26.305084745762713,morphological_dilation,3,2
0X57115FCDFC17AD13.avi,88,1172,844,328,38.862559241706165,morphological_dilation,3,2
0X5711E76EE9E6D05C.avi,92,2148,1712,436,25.46728971962617,morphological_dilation,3,2
0X5711E76EE9E6D05C.avi,108,1528,1111,417,37.53375337533754,morphological_dilation,3,2
0X571A188810080076.avi,66,2448,2008,440,21.91235059760956,morphological_dilation,3,2
0X571A188810080076.avi,80,2005,1593,412,25.863151286880097,morphological_dilation,3,2
0X571FD5A3DF89F23E.avi,41,2862,2350,512,21.78723404255319,morphological_dilation,3,2
0X571FD5A3DF89F23E.avi,58,1755,1339,416,31.06796116504854,morphological_dilation,3,2
0X572499FB5E263E98.avi,145,3336,2833,503,17.755030003529825,morphological_dilation,3,2
0X572499FB5E263E98.avi,164,2714,2256,458,20.30141843971631,morphological_dilation,3,2
0X57294851359B9F2C.avi,94,1664,1288,376,29.19254658385093,morphological_dilation,3,2
0X57294851359B9F2C.avi,118,1206,886,320,36.11738148984199,morphological_dilation,3,2
0X572AEF5D9FB71D5E.avi,91,2069,1669,400,23.96644697423607,morphological_dilation,3,2
0X572AEF5D9FB71D5E.avi,105,1181,853,328,38.45252051582649,morphological_dilation,3,2
0X5732F683C370572F.avi,42,1794,1418,376,26.516220028208743,morphological_dilation,3,2
0X5732F683C370572F.avi,58,1076,766,310,40.469973890339425,morphological_dilation,3,2
0X5737214D87C3C6A2.avi,42,1463,1111,352,31.683168316831683,morphological_dilation,3,2
0X5737214D87C3C6A2.avi,58,855,563,292,51.865008880994665,morphological_dilation,3,2
0X5737FD30335E04B2.avi,65,892,620,272,43.87096774193549,morphological_dilation,3,2
0X5737FD30335E04B2.avi,76,588,356,232,65.1685393258427,morphological_dilation,3,2
0X5739E698E8CF82B8.avi,15,1693,1305,388,29.731800766283524,morphological_dilation,3,2
0X5739E698E8CF82B8.avi,32,2394,1927,467,24.234561494551116,morphological_dilation,3,2
0X573ACEFCBEEEBDB1.avi,90,1916,1500,416,27.73333333333333,morphological_dilation,3,2
0X573ACEFCBEEEBDB1.avi,105,1171,839,332,39.57091775923719,morphological_dilation,3,2
0X5740370BFDBCB8C0.avi,83,1773,1369,404,29.510591672753833,morphological_dilation,3,2
0X5740370BFDBCB8C0.avi,95,1084,752,332,44.148936170212764,morphological_dilation,3,2
0X57418E2E81370788.avi,89,1313,993,320,32.225579053373615,morphological_dilation,3,2
0X57418E2E81370788.avi,108,909,643,266,41.368584758942454,morphological_dilation,3,2
0X5746FD1045390A93.avi,69,2146,1734,412,23.760092272203,morphological_dilation,3,2
0X5746FD1045390A93.avi,82,1370,1026,344,33.528265107212476,morphological_dilation,3,2
0X5747C22B0A383B17.avi,71,1846,1454,392,26.960110041265473,morphological_dilation,3,2
0X5747C22B0A383B17.avi,90,1178,858,320,37.2960372960373,morphological_dilation,3,2
0X574915FE8F47DA9D.avi,30,1517,1169,348,29.769033361847736,morphological_dilation,3,2
0X574915FE8F47DA9D.avi,44,1338,1022,316,30.919765166340508,morphological_dilation,3,2
0X57496C7B6FB532F3.avi,94,1713,1333,380,28.507126781695426,morphological_dilation,3,2
0X57496C7B6FB532F3.avi,110,1086,778,308,39.588688946015424,morphological_dilation,3,2
0X575385417D2251F3.avi,92,1442,1094,348,31.809872029250457,morphological_dilation,3,2
0X575385417D2251F3.avi,109,904,623,281,45.10433386837881,morphological_dilation,3,2
0X575A1E4C8C441849.avi,71,1497,1138,359,31.54657293497364,morphological_dilation,3,2
0X575A1E4C8C441849.avi,87,1184,852,332,38.967136150234744,morphological_dilation,3,2
0X57614735C29E7850.avi,48,1770,1398,372,26.609442060085836,morphological_dilation,3,2
0X57614735C29E7850.avi,57,1022,718,304,42.33983286908078,morphological_dilation,3,2
0X57638EDBA6862410.avi,131,2329,1889,440,23.292747485442035,morphological_dilation,3,2
0X57638EDBA6862410.avi,148,1556,1168,388,33.21917808219178,morphological_dilation,3,2
0X5763B13F5E834682.avi,90,2829,2361,468,19.82210927573062,morphological_dilation,3,2
0X5763B13F5E834682.avi,103,1838,1442,396,27.461858529819693,morphological_dilation,3,2
0X576CE75DB92A2833.avi,47,3892,3340,552,16.526946107784433,morphological_dilation,3,2
0X576CE75DB92A2833.avi,75,3275,2761,514,18.616443317638538,morphological_dilation,3,2
0X5770BC86E23F64A1.avi,129,2929,2426,503,20.733718054410552,morphological_dilation,3,2
0X5770BC86E23F64A1.avi,151,1732,1336,396,29.64071856287425,morphological_dilation,3,2
0X577895B05C084B1C.avi,60,1764,1273,491,38.57030636292223,morphological_dilation,3,2
0X577895B05C084B1C.avi,72,907,523,384,73.4225621414914,morphological_dilation,3,2
0X5782DC934099FAF7.avi,45,1088,792,296,37.37373737373738,morphological_dilation,3,2
0X5782DC934099FAF7.avi,67,717,467,250,53.53319057815846,morphological_dilation,3,2
0X5789708D8B711CE9.avi,60,5036,4384,652,14.872262773722628,morphological_dilation,3,2
0X5789708D8B711CE9.avi,136,2759,2263,496,21.91780821917808,morphological_dilation,3,2
0X5789D0955145506E.avi,4,1185,869,316,36.36363636363637,morphological_dilation,3,2
0X5789D0955145506E.avi,13,795,523,272,52.00764818355641,morphological_dilation,3,2
0X578A64C447B18198.avi,29,1871,1503,368,24.484364604125084,morphological_dilation,3,2
0X578A64C447B18198.avi,46,1550,1222,328,26.841243862520457,morphological_dilation,3,2
0X578CD55FD7FA1FBC.avi,69,1405,1065,340,31.92488262910798,morphological_dilation,3,2
0X578CD55FD7FA1FBC.avi,86,918,638,280,43.8871473354232,morphological_dilation,3,2
0X579545295C91E0C9.avi,84,1334,986,348,35.294117647058826,morphological_dilation,3,2
0X579545295C91E0C9.avi,105,767,489,278,56.850715746421265,morphological_dilation,3,2
0X57967E99CD78E8DD.avi,42,2326,1894,432,22.80887011615628,morphological_dilation,3,2
0X57967E99CD78E8DD.avi,67,1716,1297,419,32.305319969159605,morphological_dilation,3,2
0X57998A179A216872.avi,124,1925,1521,404,26.561472715318867,morphological_dilation,3,2
0X57998A179A216872.avi,139,1257,921,336,36.48208469055375,morphological_dilation,3,2
0X579AA4481F4C4811.avi,48,2750,2258,492,21.78919397697077,morphological_dilation,3,2
0X579AA4481F4C4811.avi,68,1713,1309,404,30.863254392666157,morphological_dilation,3,2
0X57A074E488CFB7AC.avi,124,2095,1667,428,25.674865026994603,morphological_dilation,3,2
0X57A074E488CFB7AC.avi,146,1497,1122,375,33.42245989304813,morphological_dilation,3,2
0X57AD6F3761E27928.avi,55,1178,850,328,38.588235294117645,morphological_dilation,3,2
0X57AD6F3761E27928.avi,72,699,451,248,54.988913525498894,morphological_dilation,3,2
0X57ADA497F0EBEDF1.avi,51,1809,1433,376,26.238660153524073,morphological_dilation,3,2
0X57ADA497F0EBEDF1.avi,67,1488,1148,340,29.61672473867596,morphological_dilation,3,2
0X57AF243EC526F96B.avi,128,2411,1967,444,22.57244534824606,morphological_dilation,3,2
0X57AF243EC526F96B.avi,142,1696,1312,384,29.268292682926827,morphological_dilation,3,2
0X57AF4D24B154C573.avi,1,4525,3463,1062,30.667051689286744,morphological_dilation,3,2
0X57AF4D24B154C573.avi,15,4931,3441,1490,43.30136588201105,morphological_dilation,3,2
0X57B106FE43F61E7F.avi,126,1415,1075,340,31.627906976744185,morphological_dilation,3,2
0X57B106FE43F61E7F.avi,142,911,611,300,49.09983633387889,morphological_dilation,3,2
0X57B2E99ECD4B98E1.avi,71,1458,1090,368,33.76146788990826,morphological_dilation,3,2
0X57B2E99ECD4B98E1.avi,86,950,634,316,49.8422712933754,morphological_dilation,3,2
0X57B3CE32DFE7E331.avi,173,1382,1046,336,32.122370936902485,morphological_dilation,3,2
0X57B3CE32DFE7E331.avi,195,999,711,288,40.50632911392405,morphological_dilation,3,2
0X57B578504088002B.avi,57,1965,1569,396,25.239005736137663,morphological_dilation,3,2
0X57B578504088002B.avi,72,1150,830,320,38.55421686746988,morphological_dilation,3,2
0X57BBFCDCFCC7C65B.avi,42,1338,998,340,34.06813627254509,morphological_dilation,3,2
0X57BBFCDCFCC7C65B.avi,60,772,474,298,62.869198312236286,morphological_dilation,3,2
0X57C2A3A02FE8B21.avi,44,1446,1086,360,33.14917127071823,morphological_dilation,3,2
0X57C2A3A02FE8B21.avi,60,838,558,280,50.179211469534046,morphological_dilation,3,2
0X57C34323F2863D98.avi,48,1582,1214,368,30.31301482701812,morphological_dilation,3,2
0X57C34323F2863D98.avi,64,930,646,284,43.962848297213625,morphological_dilation,3,2
0X57C52904B0175D71.avi,111,2577,2113,464,21.959299574065312,morphological_dilation,3,2
0X57C52904B0175D71.avi,139,1623,1251,372,29.73621103117506,morphological_dilation,3,2
0X57C86935475E8DA1.avi,38,1940,1549,391,25.24209167204648,morphological_dilation,3,2
0X57C86935475E8DA1.avi,50,1190,898,292,32.516703786191535,morphological_dilation,3,2
0X57CAE0E977EF3D47.avi,110,997,725,272,37.51724137931035,morphological_dilation,3,2
0X57CAE0E977EF3D47.avi,122,578,350,228,65.14285714285715,morphological_dilation,3,2
0X57D305C314C9E75B.avi,36,1362,1022,340,33.268101761252446,morphological_dilation,3,2
0X57D305C314C9E75B.avi,50,915,622,293,47.10610932475884,morphological_dilation,3,2
0X57D44A1928229F95.avi,54,1691,1307,384,29.380260137719972,morphological_dilation,3,2
0X57D44A1928229F95.avi,75,1083,759,324,42.68774703557312,morphological_dilation,3,2
0X57D45309B5983032.avi,46,1937,1533,404,26.353555120678408,morphological_dilation,3,2
0X57D45309B5983032.avi,61,1233,905,328,36.24309392265193,morphological_dilation,3,2
0X57D463CDA795B9E4.avi,109,1456,1128,328,29.078014184397162,morphological_dilation,3,2
0X57D463CDA795B9E4.avi,120,1131,836,295,35.28708133971292,morphological_dilation,3,2
0X57DC82A70105D85E.avi,53,2112,1680,432,25.71428571428571,morphological_dilation,3,2
0X57DC82A70105D85E.avi,71,1530,1136,394,34.683098591549296,morphological_dilation,3,2
0X57E2E5B50B2F0E9F.avi,59,1926,1502,424,28.22902796271638,morphological_dilation,3,2
0X57E2E5B50B2F0E9F.avi,75,1224,829,395,47.64776839565742,morphological_dilation,3,2
0X57E5F01C8FBC44B2.avi,50,1620,1280,340,26.5625,morphological_dilation,3,2
0X57E5F01C8FBC44B2.avi,55,1317,997,320,32.0962888665998,morphological_dilation,3,2
0X57E623AB38FB2122.avi,25,1030,730,300,41.0958904109589,morphological_dilation,3,2
0X57E623AB38FB2122.avi,38,779,515,264,51.262135922330096,morphological_dilation,3,2
0X57E6ED6156AD179.avi,52,1656,1268,388,30.5993690851735,morphological_dilation,3,2
0X57E6ED6156AD179.avi,71,1022,710,312,43.94366197183099,morphological_dilation,3,2
0X57EE8E6B8C4E7F5.avi,35,1601,1245,356,28.594377510040157,morphological_dilation,3,2
0X57EE8E6B8C4E7F5.avi,49,1029,721,308,42.71844660194174,morphological_dilation,3,2
0X57F0C4F8C24F34EA.avi,0,1679,1299,380,29.253271747498076,morphological_dilation,3,2
0X57F0C4F8C24F34EA.avi,15,1076,768,308,40.10416666666667,morphological_dilation,3,2
0X57FB35BD11EF937D.avi,114,1717,1353,364,26.90317812269032,morphological_dilation,3,2
0X57FB35BD11EF937D.avi,136,1277,953,324,33.997901364113325,morphological_dilation,3,2
0X57FE3361D451C871.avi,129,1294,954,340,35.63941299790356,morphological_dilation,3,2
0X57FE3361D451C871.avi,140,2247,1797,450,25.041736227045075,morphological_dilation,3,2
0X5806E874A6A5F13D.avi,664,1640,1264,376,29.746835443037973,morphological_dilation,3,2
0X5806E874A6A5F13D.avi,686,995,683,312,45.68081991215227,morphological_dilation,3,2
0X5807A3E41076EE92.avi,52,1882,1494,388,25.970548862115127,morphological_dilation,3,2
0X5807A3E41076EE92.avi,64,1165,849,316,37.22025912838633,morphological_dilation,3,2
0X580C785A54010D31.avi,100,1593,1233,360,29.1970802919708,morphological_dilation,3,2
0X580C785A54010D31.avi,113,998,698,300,42.97994269340974,morphological_dilation,3,2
0X580CEE48A5CB3F78.avi,100,1374,1030,344,33.398058252427184,morphological_dilation,3,2
0X580CEE48A5CB3F78.avi,114,852,572,280,48.95104895104895,morphological_dilation,3,2
0X580E9EB1627EA2EC.avi,78,1345,1001,344,34.36563436563437,morphological_dilation,3,2
0X580E9EB1627EA2EC.avi,91,867,556,311,55.93525179856115,morphological_dilation,3,2
0X5814C1D501200DBC.avi,44,1252,952,300,31.512605042016805,morphological_dilation,3,2
0X5814C1D501200DBC.avi,63,923,655,268,40.916030534351144,morphological_dilation,3,2
0X5816941DEDFD5EF8.avi,51,2815,2355,460,19.53290870488323,morphological_dilation,3,2
0X5816941DEDFD5EF8.avi,68,1977,1581,396,25.047438330170777,morphological_dilation,3,2
0X581C466FF21EA655.avi,121,1359,994,365,36.72032193158954,morphological_dilation,3,2
0X581C466FF21EA655.avi,138,933,619,314,50.72697899838449,morphological_dilation,3,2
0X58234EC2ACE425BC.avi,26,785,553,232,41.952983725135624,morphological_dilation,3,2
0X58234EC2ACE425BC.avi,36,641,425,216,50.8235294117647,morphological_dilation,3,2
0X582705BA9DF60331.avi,0,1908,1512,396,26.190476190476193,morphological_dilation,3,2
0X582705BA9DF60331.avi,13,1105,785,320,40.76433121019109,morphological_dilation,3,2
0X582990A8C81BACB0.avi,0,2029,1625,404,24.861538461538462,morphological_dilation,3,2
0X582990A8C81BACB0.avi,16,1156,838,318,37.94749403341289,morphological_dilation,3,2
0X58328E6D19296808.avi,108,2039,1623,416,25.63154651879236,morphological_dilation,3,2
0X58328E6D19296808.avi,118,1733,1351,382,28.275351591413767,morphological_dilation,3,2
0X58338E94EAA6EFCE.avi,67,1548,1202,346,28.785357737104828,morphological_dilation,3,2
0X58338E94EAA6EFCE.avi,77,1013,725,288,39.724137931034484,morphological_dilation,3,2
0X5834018E4FD4FBEA.avi,56,2495,2039,456,22.36390387444826,morphological_dilation,3,2
0X5834018E4FD4FBEA.avi,80,1702,1318,384,29.1350531107739,morphological_dilation,3,2
0X58344E9C7BAF1EFC.avi,47,1552,1180,372,31.52542372881356,morphological_dilation,3,2
0X58344E9C7BAF1EFC.avi,60,896,604,292,48.34437086092716,morphological_dilation,3,2
0X58381B534004F33A.avi,40,1888,1492,396,26.541554959785525,morphological_dilation,3,2
0X58381B534004F33A.avi,57,1213,889,324,36.445444319460066,morphological_dilation,3,2
0X583C05A8EFEF7992.avi,36,1786,1402,384,27.38944365192582,morphological_dilation,3,2
0X583C05A8EFEF7992.avi,49,1133,789,344,43.59949302915083,morphological_dilation,3,2
0X583DA07459933891.avi,125,2413,1965,448,22.798982188295167,morphological_dilation,3,2
0X583DA07459933891.avi,143,1745,1361,384,28.214548126377665,morphological_dilation,3,2
0X5843363A84693349.avi,68,1415,1087,328,30.17479300827967,morphological_dilation,3,2
0X5843363A84693349.avi,87,965,685,280,40.87591240875913,morphological_dilation,3,2
0X584739FD0DD86A50.avi,2,1628,1250,378,30.240000000000002,morphological_dilation,3,2
0X584739FD0DD86A50.avi,15,1052,736,316,42.934782608695656,morphological_dilation,3,2
0X58476FD2C3A6A4D4.avi,99,1610,1230,380,30.89430894308943,morphological_dilation,3,2
0X58476FD2C3A6A4D4.avi,116,940,636,304,47.79874213836478,morphological_dilation,3,2
0X5849D369214E9D44.avi,40,1417,1069,348,32.55378858746492,morphological_dilation,3,2
0X5849D369214E9D44.avi,52,926,626,300,47.92332268370607,morphological_dilation,3,2
0X5862D7393B1702A1.avi,96,1424,1076,348,32.342007434944236,morphological_dilation,3,2
0X5862D7393B1702A1.avi,113,921,609,312,51.231527093596064,morphological_dilation,3,2
0X5864696B49D8AEFA.avi,70,985,700,285,40.714285714285715,morphological_dilation,3,2
0X5864696B49D8AEFA.avi,83,665,429,236,55.011655011655016,morphological_dilation,3,2
0X5864C38A349E78EB.avi,39,2979,2491,488,19.590525893215577,morphological_dilation,3,2
0X5864C38A349E78EB.avi,51,2708,2256,452,20.0354609929078,morphological_dilation,3,2
0X586512267FF12EFB.avi,54,1915,1515,400,26.4026402640264,morphological_dilation,3,2
0X586512267FF12EFB.avi,75,1201,865,336,38.84393063583815,morphological_dilation,3,2
0X58689D0656F5952E.avi,89,2134,1730,404,23.352601156069362,morphological_dilation,3,2
0X58689D0656F5952E.avi,110,1314,1002,312,31.137724550898206,morphological_dilation,3,2
0X586F5B8D38894CA9.avi,149,2362,1918,444,23.149113660062564,morphological_dilation,3,2
0X586F5B8D38894CA9.avi,167,2021,1603,418,26.076107298814723,morphological_dilation,3,2
0X5870E298D9583F01.avi,43,1413,1085,328,30.230414746543776,morphological_dilation,3,2
0X5870E298D9583F01.avi,61,913,639,274,42.87949921752739,morphological_dilation,3,2
0X58715681A919A46B.avi,41,2022,1614,408,25.27881040892193,morphological_dilation,3,2
0X58715681A919A46B.avi,56,1183,855,328,38.3625730994152,morphological_dilation,3,2
0X5871F4CB38FCA3DD.avi,49,1969,1577,392,24.857324032974002,morphological_dilation,3,2
0X5871F4CB38FCA3DD.avi,67,1262,928,334,35.991379310344826,morphological_dilation,3,2
0X587790E0A7D9D232.avi,47,2295,1859,436,23.45346960731576,morphological_dilation,3,2
0X587790E0A7D9D232.avi,66,1434,1070,364,34.018691588785046,morphological_dilation,3,2
0X587BA6A4BB4E5419.avi,51,1617,1253,364,29.05027932960894,morphological_dilation,3,2
0X587BA6A4BB4E5419.avi,67,1090,782,308,39.38618925831202,morphological_dilation,3,2
0X58839F3785AF3EA5.avi,84,1524,1176,348,29.591836734693878,morphological_dilation,3,2
0X58839F3785AF3EA5.avi,97,973,673,300,44.57652303120357,morphological_dilation,3,2
0X58871E2E411DF847.avi,34,1429,1081,348,32.192414431082334,morphological_dilation,3,2
0X58871E2E411DF847.avi,47,892,616,276,44.8051948051948,morphological_dilation,3,2
0X5888A01BFE3480D4.avi,69,3670,3094,576,18.616677440206853,morphological_dilation,3,2
0X5888A01BFE3480D4.avi,84,2268,1761,507,28.79045996592845,morphological_dilation,3,2
0X588B2DFAF08B8A55.avi,67,1685,1309,376,28.72421695951108,morphological_dilation,3,2
0X588B2DFAF08B8A55.avi,79,1452,1104,348,31.521739130434785,morphological_dilation,3,2
0X588C869314F5D067.avi,6,2613,2145,468,21.818181818181817,morphological_dilation,3,2
0X588C869314F5D067.avi,10,1503,1139,364,31.957857769973664,morphological_dilation,3,2
0X588E162E5DD9DB03.avi,79,1436,1068,368,34.45692883895131,morphological_dilation,3,2
0X588E162E5DD9DB03.avi,96,842,570,272,47.719298245614034,morphological_dilation,3,2
0X588E3EACF2F064F3.avi,62,3186,2678,508,18.96938013442868,morphological_dilation,3,2
0X588E3EACF2F064F3.avi,74,2383,1939,444,22.89840123775142,morphological_dilation,3,2
0X588FDBBA1B4732A1.avi,137,2041,1625,416,25.6,morphological_dilation,3,2
0X588FDBBA1B4732A1.avi,148,1486,1132,354,31.272084805653712,morphological_dilation,3,2
0X589473980BD8A982.avi,42,1619,1255,364,29.00398406374502,morphological_dilation,3,2
0X589473980BD8A982.avi,57,1008,708,300,42.3728813559322,morphological_dilation,3,2
0X5896ABFE924AB523.avi,45,1899,1507,392,26.011944260119442,morphological_dilation,3,2
0X5896ABFE924AB523.avi,64,1244,904,340,37.610619469026545,morphological_dilation,3,2
0X5898C1CFEA50CF3A.avi,94,2003,1566,437,27.905491698595146,morphological_dilation,3,2
0X5898C1CFEA50CF3A.avi,112,1051,719,332,46.17524339360223,morphological_dilation,3,2
0X5899680B2CF3DF20.avi,132,2479,2039,440,21.57920549288867,morphological_dilation,3,2
0X5899680B2CF3DF20.avi,150,1460,1096,364,33.21167883211679,morphological_dilation,3,2
0X589E6E8F092EF3D2.avi,82,1621,1261,360,28.548770816812052,morphological_dilation,3,2
0X589E6E8F092EF3D2.avi,95,857,593,264,44.51939291736931,morphological_dilation,3,2
0X589ED00FEB9EA2CE.avi,139,2260,1812,448,24.724061810154527,morphological_dilation,3,2
0X589ED00FEB9EA2CE.avi,156,1300,956,344,35.98326359832636,morphological_dilation,3,2
0X58A4A57D6F79861D.avi,84,1451,1103,348,31.550317316409792,morphological_dilation,3,2
0X58A4A57D6F79861D.avi,95,933,640,293,45.78125,morphological_dilation,3,2
0X58A857FB59CA0866.avi,62,3165,2669,496,18.583739228175347,morphological_dilation,3,2
0X58A857FB59CA0866.avi,78,1902,1502,400,26.63115845539281,morphological_dilation,3,2
0X58B0DA957D4BC1EC.avi,120,2346,1910,436,22.827225130890053,morphological_dilation,3,2
0X58B0DA957D4BC1EC.avi,137,1292,956,336,35.146443514644346,morphological_dilation,3,2
0X58B2C807C6950870.avi,64,1446,1110,336,30.270270270270274,morphological_dilation,3,2
0X58B2C807C6950870.avi,79,1154,854,300,35.1288056206089,morphological_dilation,3,2
0X58B3481E2ED23F3F.avi,91,1489,1137,352,30.958663148636763,morphological_dilation,3,2
0X58B3481E2ED23F3F.avi,107,1019,721,298,41.33148404993065,morphological_dilation,3,2
0X58B97B8E78F555E5.avi,152,2967,2439,528,21.648216482164823,morphological_dilation,3,2
0X58B97B8E78F555E5.avi,170,2472,1992,480,24.096385542168676,morphological_dilation,3,2
0X58C252BAD9120AAA.avi,4,2269,1821,448,24.601867105985722,morphological_dilation,3,2
0X58C252BAD9120AAA.avi,35,1309,901,408,45.28301886792453,morphological_dilation,3,2
0X58C8439D9869BF58.avi,51,1538,1179,359,30.449533502968617,morphological_dilation,3,2
0X58C8439D9869BF58.avi,60,961,676,285,42.15976331360947,morphological_dilation,3,2
0X58C898AC23AFC561.avi,43,1587,1231,356,28.9195775792039,morphological_dilation,3,2
0X58C898AC23AFC561.avi,57,1031,703,328,46.65718349928876,morphological_dilation,3,2
0X58C9A67666B969C2.avi,36,3072,2572,500,19.440124416796266,morphological_dilation,3,2
0X58C9A67666B969C2.avi,53,1942,1514,428,28.269484808454425,morphological_dilation,3,2
0X58CB708D5F276CE1.avi,35,1295,967,328,33.91933815925543,morphological_dilation,3,2
0X58CB708D5F276CE1.avi,53,809,533,276,51.78236397748592,morphological_dilation,3,2
0X58CC73CB241426DD.avi,94,2075,1679,396,23.5854675402025,morphological_dilation,3,2
0X58CC73CB241426DD.avi,110,1697,1345,352,26.171003717472118,morphological_dilation,3,2
0X58CC8340AFE517B.avi,91,1963,1563,400,25.591810620601407,morphological_dilation,3,2
0X58CC8340AFE517B.avi,101,1327,987,340,34.447821681864234,morphological_dilation,3,2
0X58CEE9E828EEF7CB.avi,53,2197,1761,436,24.758659852356615,morphological_dilation,3,2
0X58CEE9E828EEF7CB.avi,74,1554,1190,364,30.58823529411765,morphological_dilation,3,2
0X58D04EA94BD2181B.avi,66,2665,2165,500,23.094688221709006,morphological_dilation,3,2
0X58D04EA94BD2181B.avi,82,1936,1504,432,28.723404255319153,morphological_dilation,3,2
0X58D3DFC9AE85338E.avi,45,1660,1264,396,31.329113924050635,morphological_dilation,3,2
0X58D3DFC9AE85338E.avi,59,1072,720,352,48.888888888888886,morphological_dilation,3,2
0X58E0C4426D076B8B.avi,79,1767,1387,380,27.397260273972602,morphological_dilation,3,2
0X58E0C4426D076B8B.avi,94,1133,821,312,38.00243605359318,morphological_dilation,3,2
0X58E0D85ABA2FFF6E.avi,28,1589,1237,352,28.455941794664515,morphological_dilation,3,2
0X58E0D85ABA2FFF6E.avi,42,1443,1103,340,30.82502266545784,morphological_dilation,3,2
0X58E3A1FBB2C9A8D1.avi,116,2770,2258,512,22.67493356953056,morphological_dilation,3,2
0X58E3A1FBB2C9A8D1.avi,149,1559,1156,403,34.86159169550173,morphological_dilation,3,2
0X58E68FF5E366ADAD.avi,158,1411,1075,336,31.25581395348837,morphological_dilation,3,2
0X58E68FF5E366ADAD.avi,177,852,588,264,44.89795918367347,morphological_dilation,3,2
0X58E8A4A0DB059360.avi,47,3779,3243,536,16.52790625963614,morphological_dilation,3,2
0X58E8A4A0DB059360.avi,60,3492,2968,524,17.654986522911052,morphological_dilation,3,2
0X58E9941E544B4437.avi,90,2082,1666,416,24.96998799519808,morphological_dilation,3,2
0X58E9941E544B4437.avi,108,1269,925,344,37.189189189189186,morphological_dilation,3,2
0X58EA08A90D21496D.avi,68,2155,1697,458,26.988803771361226,morphological_dilation,3,2
0X58EA08A90D21496D.avi,92,1265,888,377,42.45495495495496,morphological_dilation,3,2
0X58EA44DD398ACEDF.avi,116,1836,1452,384,26.446280991735538,morphological_dilation,3,2
0X58EA44DD398ACEDF.avi,135,1577,1215,362,29.79423868312757,morphological_dilation,3,2
0X58EBB19DD908A04.avi,45,1982,1558,424,27.214377406931966,morphological_dilation,3,2
0X58EBB19DD908A04.avi,61,1176,848,328,38.67924528301887,morphological_dilation,3,2
0X58F1C5FCF1CDAB4D.avi,90,1590,1206,384,31.8407960199005,morphological_dilation,3,2
0X58F1C5FCF1CDAB4D.avi,109,1304,976,328,33.60655737704918,morphological_dilation,3,2
0X58F7EC389A5FA5AE.avi,48,1484,1136,348,30.633802816901408,morphological_dilation,3,2
0X58F7EC389A5FA5AE.avi,65,900,624,276,44.230769230769226,morphological_dilation,3,2
0X58F81331AC8DFB28.avi,43,1532,1160,372,32.068965517241374,morphological_dilation,3,2
0X58F81331AC8DFB28.avi,61,909,617,292,47.3257698541329,morphological_dilation,3,2
0X58F8B32F2F4BB1FC.avi,66,1757,1341,416,31.021625652498138,morphological_dilation,3,2
0X58F8B32F2F4BB1FC.avi,84,1066,734,332,45.23160762942779,morphological_dilation,3,2
0X58FAA29103D77749.avi,48,1891,1475,416,28.203389830508474,morphological_dilation,3,2
0X58FAA29103D77749.avi,66,1124,784,340,43.36734693877551,morphological_dilation,3,2
0X58FABBD1452885A9.avi,82,1724,1344,380,28.273809523809522,morphological_dilation,3,2
0X58FABBD1452885A9.avi,101,987,696,291,41.810344827586206,morphological_dilation,3,2
0X58FDB3BA0B623121.avi,49,1025,737,288,39.07734056987788,morphological_dilation,3,2
0X58FDB3BA0B623121.avi,61,718,462,256,55.41125541125541,morphological_dilation,3,2
0X5906DC737114DBF1.avi,34,1851,1459,392,26.867717614804658,morphological_dilation,3,2
0X5906DC737114DBF1.avi,62,1204,870,334,38.39080459770115,morphological_dilation,3,2
0X5909C0C23F72F79F.avi,83,2966,2470,496,20.08097165991903,morphological_dilation,3,2
0X5909C0C23F72F79F.avi,99,1716,1332,384,28.82882882882883,morphological_dilation,3,2
0X590E3EC2C55BE57D.avi,49,3945,3393,552,16.268788682581786,morphological_dilation,3,2
0X590E3EC2C55BE57D.avi,72,3287,2787,500,17.940437746681017,morphological_dilation,3,2
0X590E81D4160A19D3.avi,44,1314,988,326,32.99595141700405,morphological_dilation,3,2
0X590E81D4160A19D3.avi,56,996,708,288,40.67796610169492,morphological_dilation,3,2
0X5910AD8CFCEBCFBE.avi,100,1470,1130,340,30.08849557522124,morphological_dilation,3,2
0X5910AD8CFCEBCFBE.avi,126,1041,749,292,38.98531375166889,morphological_dilation,3,2
0X591ECF81428086F5.avi,57,1844,1444,400,27.70083102493075,morphological_dilation,3,2
0X591ECF81428086F5.avi,65,1362,1018,344,33.79174852652259,morphological_dilation,3,2
0X5921D38ED2B4AFD.avi,80,1471,1119,352,31.456657730116177,morphological_dilation,3,2
0X5921D38ED2B4AFD.avi,98,976,688,288,41.86046511627907,morphological_dilation,3,2
0X59221E655A0BEB5F.avi,71,2190,1758,432,24.573378839590443,morphological_dilation,3,2
0X59221E655A0BEB5F.avi,86,1145,812,333,41.00985221674877,morphological_dilation,3,2
0X5929F010F6E0B599.avi,3,2698,2226,472,21.20395327942498,morphological_dilation,3,2
0X5929F010F6E0B599.avi,25,2004,1600,404,25.25,morphological_dilation,3,2
0X592B7FFFAB37E75.avi,39,1615,1235,380,30.76923076923077,morphological_dilation,3,2
0X592B7FFFAB37E75.avi,56,1060,720,340,47.22222222222222,morphological_dilation,3,2
0X592BC78654B44045.avi,76,2347,1907,440,23.072889355007867,morphological_dilation,3,2
0X592BC78654B44045.avi,96,1562,1190,372,31.26050420168067,morphological_dilation,3,2
0X592D63DA4757CEFF.avi,96,1572,1172,400,34.129692832764505,morphological_dilation,3,2
0X592D63DA4757CEFF.avi,113,1196,832,364,43.75,morphological_dilation,3,2
0X592EF931C5408F76.avi,75,2415,1951,464,23.78267555099949,morphological_dilation,3,2
0X592EF931C5408F76.avi,92,1403,1019,384,37.68400392541707,morphological_dilation,3,2
0X592F2897A11F51ED.avi,107,1385,1049,336,32.030505243088655,morphological_dilation,3,2
0X592F2897A11F51ED.avi,120,813,533,280,52.5328330206379,morphological_dilation,3,2
0X592F522398D46067.avi,60,792,532,260,48.87218045112782,morphological_dilation,3,2
0X592F522398D46067.avi,102,1398,1008,390,38.69047619047619,morphological_dilation,3,2
0X5932549C293D414.avi,36,988,716,272,37.988826815642454,morphological_dilation,3,2
0X5932549C293D414.avi,53,628,408,220,53.92156862745098,morphological_dilation,3,2
0X5934A7755DBA992F.avi,101,2439,1982,457,23.057517658930372,morphological_dilation,3,2
0X5934A7755DBA992F.avi,119,1559,1177,382,32.4553950722175,morphological_dilation,3,2
0X59381CEC5E5E999E.avi,33,2260,1812,448,24.724061810154527,morphological_dilation,3,2
0X59381CEC5E5E999E.avi,47,1456,1092,364,33.33333333333333,morphological_dilation,3,2
0X593E7BA6491DC8CC.avi,50,1439,1067,372,34.864104967197754,morphological_dilation,3,2
0X593E7BA6491DC8CC.avi,70,955,635,320,50.39370078740157,morphological_dilation,3,2
0X5940511FDA9E382A.avi,84,2928,2412,516,21.393034825870647,morphological_dilation,3,2
0X5940511FDA9E382A.avi,101,2072,1652,420,25.423728813559322,morphological_dilation,3,2
0X594171E23BEE91B3.avi,46,2085,1649,436,26.44026682838084,morphological_dilation,3,2
0X594171E23BEE91B3.avi,65,1403,1051,352,33.4919124643197,morphological_dilation,3,2
0X5942BAEA791A0AB8.avi,36,1599,1235,364,29.47368421052631,morphological_dilation,3,2
0X5942BAEA791A0AB8.avi,51,1091,767,324,42.24250325945241,morphological_dilation,3,2
0X5947CC66C2E5AB66.avi,86,1240,924,316,34.1991341991342,morphological_dilation,3,2
0X5947CC66C2E5AB66.avi,113,765,513,252,49.122807017543856,morphological_dilation,3,2
0X594EE4FCD0F9B2A7.avi,163,2310,1810,500,27.624309392265197,morphological_dilation,3,2
0X594EE4FCD0F9B2A7.avi,176,1499,1103,396,35.902085222121485,morphological_dilation,3,2
0X59526B3C70A1B54D.avi,72,1408,1060,348,32.83018867924528,morphological_dilation,3,2
0X59526B3C70A1B54D.avi,87,998,702,296,42.16524216524217,morphological_dilation,3,2
0X595745DC191C9400.avi,50,1893,1485,408,27.474747474747474,morphological_dilation,3,2
0X595745DC191C9400.avi,65,1137,803,334,41.59402241594022,morphological_dilation,3,2
0X595A8E44AB630A80.avi,59,1866,1470,396,26.93877551020408,morphological_dilation,3,2
0X595A8E44AB630A80.avi,77,1171,855,316,36.95906432748538,morphological_dilation,3,2
0X595CF8F19E1EC5C1.avi,3,2685,2229,456,20.457604306864063,morphological_dilation,3,2
0X595CF8F19E1EC5C1.avi,23,2221,1809,412,22.775013819789937,morphological_dilation,3,2
0X595D5EB09B62A91C.avi,114,1862,1422,440,30.942334739803094,morphological_dilation,3,2
0X595D5EB09B62A91C.avi,129,1099,669,430,64.27503736920778,morphological_dilation,3,2
0X595ECA5F232566EE.avi,48,1453,1077,376,34.91179201485608,morphological_dilation,3,2
0X595ECA5F232566EE.avi,62,1126,770,356,46.23376623376623,morphological_dilation,3,2
0X595F9CFE560DEF4A.avi,53,1723,1359,364,26.78440029433407,morphological_dilation,3,2
0X595F9CFE560DEF4A.avi,68,1014,702,312,44.44444444444444,morphological_dilation,3,2
0X59671F285804943A.avi,71,1527,1165,362,31.072961373390555,morphological_dilation,3,2
0X59671F285804943A.avi,89,1582,1102,480,43.55716878402904,morphological_dilation,3,2
0X596782EB29F20A7F.avi,43,1959,1531,428,27.95558458523841,morphological_dilation,3,2
0X596782EB29F20A7F.avi,59,1309,937,372,39.701173959445036,morphological_dilation,3,2
0X5969A32C106156ED.avi,36,1749,1381,368,26.64735698769008,morphological_dilation,3,2
0X5969A32C106156ED.avi,48,1151,839,312,37.18712753277711,morphological_dilation,3,2
0X5969D01C13D8D7A8.avi,99,1080,780,300,38.46153846153847,morphological_dilation,3,2
0X5969D01C13D8D7A8.avi,116,669,437,232,53.08924485125858,morphological_dilation,3,2
0X596D82CEC244AD7B.avi,3,1561,1213,348,28.689200329760922,morphological_dilation,3,2
0X596D82CEC244AD7B.avi,14,1250,930,320,34.40860215053764,morphological_dilation,3,2
0X596F693EAFBE7717.avi,51,2066,1654,412,24.9093107617896,morphological_dilation,3,2
0X596F693EAFBE7717.avi,74,1295,959,336,35.03649635036496,morphological_dilation,3,2
0X597141ABAB17D04A.avi,43,2267,1843,424,23.00596852957135,morphological_dilation,3,2
0X597141ABAB17D04A.avi,59,1498,1150,348,30.26086956521739,morphological_dilation,3,2
0X597330338F81277E.avi,53,3047,2535,512,20.19723865877712,morphological_dilation,3,2
0X597330338F81277E.avi,71,2085,1650,435,26.36363636363636,morphological_dilation,3,2
0X5977A2AAB900A179.avi,60,1615,1243,372,29.92759452936444,morphological_dilation,3,2
0X5977A2AAB900A179.avi,75,1052,730,322,44.109589041095894,morphological_dilation,3,2
0X5977AE444B36CEBF.avi,32,1313,993,320,32.225579053373615,morphological_dilation,3,2
0X5977AE444B36CEBF.avi,43,1049,757,292,38.57331571994716,morphological_dilation,3,2
0X598838470DE81F43.avi,39,1326,946,380,40.169133192389005,morphological_dilation,3,2
0X598838470DE81F43.avi,54,751,456,295,64.69298245614034,morphological_dilation,3,2
0X598C59061017AD74.avi,50,1307,979,328,33.50357507660878,morphological_dilation,3,2
0X598C59061017AD74.avi,72,848,568,280,49.29577464788733,morphological_dilation,3,2
0X598CCC65250BED12.avi,105,2101,1685,416,24.688427299703264,morphological_dilation,3,2
0X598CCC65250BED12.avi,123,1283,959,324,33.7851929092805,morphological_dilation,3,2
0X5999F4973DBFB6D.avi,55,1829,1433,396,27.634333565945568,morphological_dilation,3,2
0X5999F4973DBFB6D.avi,76,1423,1075,348,32.372093023255815,morphological_dilation,3,2
0X599C81E46591FA88.avi,101,1257,933,324,34.726688102893895,morphological_dilation,3,2
0X599C81E46591FA88.avi,114,828,556,272,48.92086330935252,morphological_dilation,3,2
0X599DDBAEABB5B464.avi,45,965,667,298,44.677661169415295,morphological_dilation,3,2
0X599DDBAEABB5B464.avi,62,534,307,227,73.9413680781759,morphological_dilation,3,2
0X59A016EB2FC57E32.avi,45,1414,1082,332,30.683918669131238,morphological_dilation,3,2
0X59A016EB2FC57E32.avi,62,1210,894,316,35.34675615212528,morphological_dilation,3,2
0X59A388EB10F25B7D.avi,109,1907,1511,396,26.207809397749838,morphological_dilation,3,2
0X59A388EB10F25B7D.avi,127,1251,919,332,36.126224156692054,morphological_dilation,3,2
0X59A575CBF3DC8109.avi,98,2869,2397,472,19.6912807676262,morphological_dilation,3,2
0X59A575CBF3DC8109.avi,125,1726,1358,368,27.098674521354933,morphological_dilation,3,2
0X59ADE18C22F4FF43.avi,80,3086,2578,508,19.705197827773468,morphological_dilation,3,2
0X59ADE18C22F4FF43.avi,97,1937,1521,416,27.350427350427353,morphological_dilation,3,2
0X59AFDDD0D3C041FA.avi,65,2530,2051,479,23.35446123842028,morphological_dilation,3,2
0X59AFDDD0D3C041FA.avi,84,1749,1354,395,29.17282127031019,morphological_dilation,3,2
0X59B142CE6B0B50C3.avi,42,1278,950,328,34.526315789473685,morphological_dilation,3,2
0X59B142CE6B0B50C3.avi,57,876,562,314,55.871886120996436,morphological_dilation,3,2
0X59B44F5607C628B1.avi,83,1824,1444,380,26.31578947368421,morphological_dilation,3,2
0X59B44F5607C628B1.avi,98,989,689,300,43.54136429608128,morphological_dilation,3,2
0X59B507E8C14DA46B.avi,54,1543,1191,352,29.554995801847188,morphological_dilation,3,2
0X59B507E8C14DA46B.avi,69,1658,1184,474,40.03378378378378,morphological_dilation,3,2
0X59B7069E192FA63B.avi,38,1681,1309,372,28.418640183346067,morphological_dilation,3,2
0X59B7069E192FA63B.avi,54,1078,768,310,40.36458333333333,morphological_dilation,3,2
0X59BA9AE7BA8C825A.avi,4,2003,1595,408,25.579937304075234,morphological_dilation,3,2
0X59BA9AE7BA8C825A.avi,20,1296,972,324,33.33333333333333,morphological_dilation,3,2
0X59BB0313F22D6C09.avi,2,1682,1326,356,26.84766214177979,morphological_dilation,3,2
0X59BB0313F22D6C09.avi,24,1129,833,296,35.53421368547419,morphological_dilation,3,2
0X59C4CE70C4F55317.avi,76,2819,2351,468,19.906422798809018,morphological_dilation,3,2
0X59C4CE70C4F55317.avi,91,1730,1338,392,29.297458893871447,morphological_dilation,3,2
0X59CCE27D1E9CA779.avi,56,2431,1983,448,22.59203227433182,morphological_dilation,3,2
0X59CCE27D1E9CA779.avi,73,1472,1065,407,38.21596244131455,morphological_dilation,3,2
0X59CF66815205182B.avi,149,1857,1461,396,27.104722792607806,morphological_dilation,3,2
0X59CF66815205182B.avi,171,1191,871,320,36.739380022962116,morphological_dilation,3,2
0X59D1140D8320A782.avi,56,3243,2524,719,28.486529318541997,morphological_dilation,3,2
0X59D1140D8320A782.avi,73,2295,1763,532,30.17583664208735,morphological_dilation,3,2
0X59D547708F149EC7.avi,38,1468,1140,328,28.771929824561404,morphological_dilation,3,2
0X59D547708F149EC7.avi,56,844,584,260,44.52054794520548,morphological_dilation,3,2
0X59D5F41F45601E03.avi,17,2561,2005,556,27.73067331670823,morphological_dilation,3,2
0X59D5F41F45601E03.avi,62,1275,951,324,34.06940063091483,morphological_dilation,3,2
0X59D638BE286CF4A9.avi,127,1759,1395,364,26.093189964157702,morphological_dilation,3,2
0X59D638BE286CF4A9.avi,146,1185,873,312,35.738831615120276,morphological_dilation,3,2
0X59D7DC35A07FCCA8.avi,2,2124,1704,420,24.647887323943664,morphological_dilation,3,2
0X59D7DC35A07FCCA8.avi,16,1375,1035,340,32.850241545893724,morphological_dilation,3,2
0X59D7E398048E854A.avi,0,1417,1066,351,32.926829268292686,morphological_dilation,3,2
0X59D7E398048E854A.avi,20,922,634,288,45.42586750788644,morphological_dilation,3,2
0X59DBBB5F624D0A21.avi,43,3867,3303,564,17.07538601271571,morphological_dilation,3,2
0X59DBBB5F624D0A21.avi,64,2420,1964,456,23.217922606924642,morphological_dilation,3,2
0X59E3868FDA8BC941.avi,94,2152,1740,412,23.678160919540232,morphological_dilation,3,2
0X59E3868FDA8BC941.avi,112,1281,953,328,34.41762854144806,morphological_dilation,3,2
0X59E39FE1CBF2559F.avi,53,1527,1175,352,29.95744680851064,morphological_dilation,3,2
0X59E39FE1CBF2559F.avi,66,1400,1060,340,32.075471698113205,morphological_dilation,3,2
0X59E764F4C40CE1BC.avi,46,1798,1418,380,26.79830747531735,morphological_dilation,3,2
0X59E764F4C40CE1BC.avi,66,1062,762,300,39.37007874015748,morphological_dilation,3,2
0X59E816BD4AEDF902.avi,2,2580,2116,464,21.928166351606805,morphological_dilation,3,2
0X59E816BD4AEDF902.avi,18,1805,1413,392,27.74239207360226,morphological_dilation,3,2
0X59FA68B7EDBFE685.avi,29,3599,3075,524,17.040650406504064,morphological_dilation,3,2
0X59FA68B7EDBFE685.avi,44,3249,2730,519,19.01098901098901,morphological_dilation,3,2
0X59FB7CD1B07254FB.avi,47,2172,1726,446,25.840092699884128,morphological_dilation,3,2
0X59FB7CD1B07254FB.avi,65,1356,990,366,36.96969696969697,morphological_dilation,3,2
0X59FBCBE4E44F7F6D.avi,52,4705,4061,644,15.858163014035952,morphological_dilation,3,2
0X59FBCBE4E44F7F6D.avi,68,2912,2400,512,21.333333333333336,morphological_dilation,3,2
0X59FD3A9503414674.avi,32,1267,947,320,33.7909186906019,morphological_dilation,3,2
0X59FD3A9503414674.avi,44,887,619,268,43.29563812600969,morphological_dilation,3,2
0X59FD42635ECD7331.avi,100,2072,1668,404,24.22062350119904,morphological_dilation,3,2
0X59FD42635ECD7331.avi,117,1307,959,348,36.28779979144943,morphological_dilation,3,2
0X59FFBB1606082730.avi,46,1481,1125,356,31.644444444444442,morphological_dilation,3,2
0X59FFBB1606082730.avi,67,968,661,307,46.4447806354009,morphological_dilation,3,2
0X5A0136769BFA8729.avi,80,1315,985,330,33.50253807106599,morphological_dilation,3,2
0X5A0136769BFA8729.avi,88,811,543,268,49.355432780847146,morphological_dilation,3,2
0X5A02C1075DC56CD1.avi,96,1772,1372,400,29.154518950437318,morphological_dilation,3,2
0X5A02C1075DC56CD1.avi,114,1116,792,324,40.909090909090914,morphological_dilation,3,2
0X5A043A25D7DE2119.avi,68,2463,1975,488,24.70886075949367,morphological_dilation,3,2
0X5A043A25D7DE2119.avi,83,1629,1213,416,34.295136026380874,morphological_dilation,3,2
0X5A0750FDDF8BB7FD.avi,117,2702,2218,484,21.8214607754734,morphological_dilation,3,2
0X5A0750FDDF8BB7FD.avi,137,2308,1860,448,24.086021505376344,morphological_dilation,3,2
0X5A09A88B11AC098B.avi,52,1327,995,332,33.36683417085427,morphological_dilation,3,2
0X5A09A88B11AC098B.avi,70,900,616,284,46.103896103896105,morphological_dilation,3,2
0X5A1414E405ADE260.avi,135,2562,2122,440,20.735155513666353,morphological_dilation,3,2
0X5A1414E405ADE260.avi,147,1472,1116,356,31.899641577060933,morphological_dilation,3,2
0X5A25AAA2FE2A0137.avi,72,2685,2205,480,21.768707482993197,morphological_dilation,3,2
0X5A25AAA2FE2A0137.avi,87,2303,1863,440,23.617820719269993,morphological_dilation,3,2
0X5A2A86B8340602FB.avi,78,1503,1127,376,33.36291038154392,morphological_dilation,3,2
0X5A2A86B8340602FB.avi,90,888,596,292,48.99328859060403,morphological_dilation,3,2
0X5A31A52541B52293.avi,1,1486,1150,336,29.217391304347828,morphological_dilation,3,2
0X5A31A52541B52293.avi,15,915,651,264,40.55299539170507,morphological_dilation,3,2
0X5A3377D9676EFB25.avi,119,1692,1324,368,27.794561933534744,morphological_dilation,3,2
0X5A3377D9676EFB25.avi,139,1099,811,288,35.511713933415535,morphological_dilation,3,2
0X5A36F3D64B1C022E.avi,0,1402,1066,336,31.51969981238274,morphological_dilation,3,2
0X5A36F3D64B1C022E.avi,20,874,602,272,45.182724252491695,morphological_dilation,3,2
0X5A3CE5A17CF0E7F0.avi,91,2104,1704,400,23.474178403755868,morphological_dilation,3,2
0X5A3CE5A17CF0E7F0.avi,109,1500,1164,336,28.865979381443296,morphological_dilation,3,2
0X5A3D0EB2779B5AE4.avi,119,2175,1751,424,24.214734437464305,morphological_dilation,3,2
0X5A3D0EB2779B5AE4.avi,145,1324,981,343,34.96432212028542,morphological_dilation,3,2
0X5A3DD4EB5CEDEBC8.avi,4,2167,1759,408,23.19499715747584,morphological_dilation,3,2
0X5A3DD4EB5CEDEBC8.avi,13,1976,1584,392,24.747474747474747,morphological_dilation,3,2
0X5A3E12648EA593D7.avi,0,1361,1009,352,34.886025768087215,morphological_dilation,3,2
0X5A3E12648EA593D7.avi,20,1006,698,308,44.126074498567334,morphological_dilation,3,2
0X5A42AF943DBF7D48.avi,126,1823,1435,388,27.038327526132406,morphological_dilation,3,2
0X5A42AF943DBF7D48.avi,142,1124,818,306,37.40831295843521,morphological_dilation,3,2
0X5A434CCEF78B3DF6.avi,32,990,676,314,46.44970414201183,morphological_dilation,3,2
0X5A434CCEF78B3DF6.avi,47,624,368,256,69.56521739130434,morphological_dilation,3,2
0X5A47C55BDD6320C4.avi,73,2250,1798,452,25.139043381535036,morphological_dilation,3,2
0X5A47C55BDD6320C4.avi,88,1327,991,336,33.90514631685166,morphological_dilation,3,2
0X5A49DD0806A586EC.avi,134,1623,1263,360,28.50356294536817,morphological_dilation,3,2
0X5A49DD0806A586EC.avi,161,1070,766,304,39.686684073107045,morphological_dilation,3,2
0X5A4BE58AF293D7E2.avi,98,3822,3277,545,16.631064998474216,morphological_dilation,3,2
0X5A4BE58AF293D7E2.avi,115,2391,1951,440,22.55253716043055,morphological_dilation,3,2
0X5A4E91B49647433.avi,32,1916,1536,380,24.739583333333336,morphological_dilation,3,2
0X5A4E91B49647433.avi,48,1623,1279,344,26.89601250977326,morphological_dilation,3,2
0X5A4F73031A43B787.avi,96,1930,1526,404,26.474442988204455,morphological_dilation,3,2
0X5A4F73031A43B787.avi,109,1057,706,351,49.71671388101983,morphological_dilation,3,2
0X5A50850240C956F4.avi,102,2664,2192,472,21.532846715328464,morphological_dilation,3,2
0X5A50850240C956F4.avi,115,2123,1711,412,24.079485680888368,morphological_dilation,3,2
0X5A522E45FA4E6300.avi,35,3418,2839,579,20.394505107432195,morphological_dilation,3,2
0X5A522E45FA4E6300.avi,48,2025,1535,490,31.921824104234524,morphological_dilation,3,2
0X5A523C343EA4955C.avi,31,1795,1435,360,25.087108013937282,morphological_dilation,3,2
0X5A523C343EA4955C.avi,48,1552,1220,332,27.21311475409836,morphological_dilation,3,2
0X5A61E466361F893C.avi,3,1467,1127,340,30.168589174800353,morphological_dilation,3,2
0X5A61E466361F893C.avi,18,984,704,280,39.77272727272727,morphological_dilation,3,2
0X5A62768CE5183F05.avi,134,2709,2237,472,21.099687080911934,morphological_dilation,3,2
0X5A62768CE5183F05.avi,158,1644,1258,386,30.683624801271858,morphological_dilation,3,2
0X5A63DFB4F51A3EF5.avi,67,1878,1486,392,26.379542395693136,morphological_dilation,3,2
0X5A63DFB4F51A3EF5.avi,81,1598,1234,364,29.497568881685577,morphological_dilation,3,2
0X5A71B9B8BA2DEF24.avi,90,1629,1279,350,27.36512900703675,morphological_dilation,3,2
0X5A71B9B8BA2DEF24.avi,105,909,629,280,44.51510333863275,morphological_dilation,3,2
0X5A78C72546FA94FB.avi,133,1892,1484,408,27.49326145552561,morphological_dilation,3,2
0X5A78C72546FA94FB.avi,150,1170,834,336,40.28776978417266,morphological_dilation,3,2
0X5A790E6D24C6459C.avi,91,1482,1130,352,31.150442477876105,morphological_dilation,3,2
0X5A790E6D24C6459C.avi,111,903,627,276,44.01913875598086,morphological_dilation,3,2
0X5A79CEB906F6DDC0.avi,87,1723,1351,372,27.53515914137676,morphological_dilation,3,2
0X5A79CEB906F6DDC0.avi,102,1084,772,312,40.41450777202073,morphological_dilation,3,2
0X5A7C0A6808352598.avi,74,1517,1141,376,32.95354951796669,morphological_dilation,3,2
0X5A7C0A6808352598.avi,96,976,668,308,46.10778443113773,morphological_dilation,3,2
0X5A7DCFE785461CBF.avi,45,2177,1765,412,23.342776203966007,morphological_dilation,3,2
0X5A7DCFE785461CBF.avi,65,1373,1037,336,32.401157184185145,morphological_dilation,3,2
0X5A81E9B6120301C2.avi,125,1782,1410,372,26.382978723404253,morphological_dilation,3,2
0X5A81E9B6120301C2.avi,149,1106,814,292,35.872235872235876,morphological_dilation,3,2
0X5A829DEE7FF13297.avi,107,1909,1509,400,26.507620941020544,morphological_dilation,3,2
0X5A829DEE7FF13297.avi,122,1145,821,324,39.46406820950061,morphological_dilation,3,2
0X5A862160D0762048.avi,159,2184,1784,400,22.421524663677133,morphological_dilation,3,2
0X5A862160D0762048.avi,190,1459,1107,352,31.79765130984643,morphological_dilation,3,2
0X5A87B593E38B6180.avi,41,1878,1514,364,24.042272126816382,morphological_dilation,3,2
0X5A87B593E38B6180.avi,57,1284,972,312,32.098765432098766,morphological_dilation,3,2
0X5A887EDA76C326E9.avi,86,2787,2279,508,22.290478279947344,morphological_dilation,3,2
0X5A887EDA76C326E9.avi,99,2144,1692,452,26.713947990543733,morphological_dilation,3,2
0X5A8D9673920F03FE.avi,87,1705,1309,396,30.252100840336134,morphological_dilation,3,2
0X5A8D9673920F03FE.avi,96,1497,1109,388,34.98647430117223,morphological_dilation,3,2
0X5A8DC9E4EC4968C4.avi,46,1855,1459,396,27.141877998629198,morphological_dilation,3,2
0X5A8DC9E4EC4968C4.avi,60,1206,866,340,39.260969976905315,morphological_dilation,3,2
0X5A8FDE1B4DFD812B.avi,45,2089,1669,420,25.164769322947873,morphological_dilation,3,2
0X5A8FDE1B4DFD812B.avi,65,1426,1074,352,32.774674115456236,morphological_dilation,3,2
0X5A93E061159C9378.avi,3,1881,1505,376,24.983388704318937,morphological_dilation,3,2
0X5A93E061159C9378.avi,12,1397,1069,328,30.68288119738073,morphological_dilation,3,2
0X5A950A068EC29DF3.avi,3,1329,993,336,33.8368580060423,morphological_dilation,3,2
0X5A950A068EC29DF3.avi,15,894,618,276,44.66019417475729,morphological_dilation,3,2
0X5A9796CCDA84D81B.avi,172,1817,1413,404,28.591648973814575,morphological_dilation,3,2
0X5A9796CCDA84D81B.avi,185,1212,865,347,40.115606936416185,morphological_dilation,3,2
0X5A97B991A66ED479.avi,78,2447,1979,468,23.648307225871655,morphological_dilation,3,2
0X5A97B991A66ED479.avi,94,1485,1113,372,33.42318059299191,morphological_dilation,3,2
0X5A98767A8CA9C6E5.avi,48,1716,1344,372,27.67857142857143,morphological_dilation,3,2
0X5A98767A8CA9C6E5.avi,65,1097,781,316,40.46094750320102,morphological_dilation,3,2
0X5A991DDFE6209331.avi,116,1587,1219,368,30.18867924528302,morphological_dilation,3,2
0X5A991DDFE6209331.avi,130,971,671,300,44.70938897168406,morphological_dilation,3,2
0X5A9D91F5E3591C4.avi,43,1329,971,358,36.8692070030896,morphological_dilation,3,2
0X5A9D91F5E3591C4.avi,59,858,531,327,61.5819209039548,morphological_dilation,3,2
0X5A9E8753F82B2C2.avi,157,1719,1335,384,28.764044943820227,morphological_dilation,3,2
0X5A9E8753F82B2C2.avi,168,1123,803,320,39.8505603985056,morphological_dilation,3,2
0X5AA07A9EDFA136A4.avi,41,2404,1949,455,23.345305284761416,morphological_dilation,3,2
0X5AA07A9EDFA136A4.avi,57,1370,1019,351,34.44553483807655,morphological_dilation,3,2
0X5AA42E877A34343C.avi,3,2068,1633,435,26.638089406001225,morphological_dilation,3,2
0X5AA42E877A34343C.avi,26,1288,917,371,40.458015267175576,morphological_dilation,3,2
0X5AA8BA5FDF19DE00.avi,51,3300,2788,512,18.364418938307033,morphological_dilation,3,2
0X5AA8BA5FDF19DE00.avi,67,1809,1409,400,28.388928317955997,morphological_dilation,3,2
0X5AB0A4C9879E8122.avi,128,3021,2513,508,20.214882610425786,morphological_dilation,3,2
0X5AB0A4C9879E8122.avi,141,2604,2152,452,21.00371747211896,morphological_dilation,3,2
0X5AB4C1E0766C1301.avi,50,1849,1457,392,26.90459849004804,morphological_dilation,3,2
0X5AB4C1E0766C1301.avi,67,1256,916,340,37.117903930131,morphological_dilation,3,2
0X5AB4D8B4AAD49E4B.avi,34,1358,1022,336,32.87671232876712,morphological_dilation,3,2
0X5AB4D8B4AAD49E4B.avi,59,895,611,284,46.48117839607202,morphological_dilation,3,2
0X5ABA2E2F22CE770A.avi,43,1666,1310,356,27.175572519083968,morphological_dilation,3,2
0X5ABA2E2F22CE770A.avi,60,1224,916,308,33.624454148471614,morphological_dilation,3,2
0X5ABA71A482529148.avi,57,1928,1528,400,26.17801047120419,morphological_dilation,3,2
0X5ABA71A482529148.avi,72,1548,1180,368,31.186440677966104,morphological_dilation,3,2
0X5AC51281F3F82853.avi,105,1933,1529,404,26.422498364944406,morphological_dilation,3,2
0X5AC51281F3F82853.avi,127,1212,896,316,35.267857142857146,morphological_dilation,3,2
0X5AC82E1FBDF09C04.avi,139,2139,1715,424,24.723032069970845,morphological_dilation,3,2
0X5AC82E1FBDF09C04.avi,162,1447,1087,360,33.11867525298988,morphological_dilation,3,2
0X5ACD4D6566521DE1.avi,107,2007,1599,408,25.515947467166978,morphological_dilation,3,2
0X5ACD4D6566521DE1.avi,125,1348,984,364,36.99186991869919,morphological_dilation,3,2
0X5AD891D9DF126FE9.avi,45,3247,2709,538,19.859726836471022,morphological_dilation,3,2
0X5AD891D9DF126FE9.avi,62,2349,1876,473,25.21321961620469,morphological_dilation,3,2
0X5ADDDD65BF05427C.avi,54,1899,1487,412,27.706792199058505,morphological_dilation,3,2
0X5ADDDD65BF05427C.avi,74,1180,832,348,41.82692307692308,morphological_dilation,3,2
0X5AE30E7828920A82.avi,64,1927,1519,408,26.85977616853193,morphological_dilation,3,2
0X5AE30E7828920A82.avi,84,1626,1242,384,30.917874396135264,morphological_dilation,3,2
0X5AE4C29227F096C1.avi,60,1879,1495,384,25.685618729096987,morphological_dilation,3,2
0X5AE4C29227F096C1.avi,74,1362,1030,332,32.23300970873787,morphological_dilation,3,2
0X5AE597D0E98182FD.avi,83,1980,1560,420,26.923076923076923,morphological_dilation,3,2
0X5AE597D0E98182FD.avi,102,1215,887,328,36.97857948139797,morphological_dilation,3,2
0X5AEBAD574707A7D8.avi,46,2141,1721,420,24.40441603718768,morphological_dilation,3,2
0X5AEBAD574707A7D8.avi,66,1238,897,341,38.01560758082497,morphological_dilation,3,2
0X5AED88B8F471EBF2.avi,42,2694,2242,452,20.16057091882248,morphological_dilation,3,2
0X5AED88B8F471EBF2.avi,59,2335,1911,424,22.18733647305076,morphological_dilation,3,2
0X5AF5A14F2D47FB44.avi,42,1596,1244,352,28.29581993569132,morphological_dilation,3,2
0X5AF5A14F2D47FB44.avi,55,1078,780,298,38.205128205128204,morphological_dilation,3,2
0X5AF5F4D6A5009696.avi,85,2460,2012,448,22.266401590457257,morphological_dilation,3,2
0X5AF5F4D6A5009696.avi,103,1905,1501,404,26.915389740173218,morphological_dilation,3,2
0X5AFC100934885C21.avi,51,2613,2133,480,22.50351617440225,morphological_dilation,3,2
0X5AFC100934885C21.avi,76,1443,1079,364,33.734939759036145,morphological_dilation,3,2
0X5AFD38843B50FE00.avi,112,2592,2136,456,21.34831460674157,morphological_dilation,3,2
0X5AFD38843B50FE00.avi,128,1446,1102,344,31.21597096188748,morphological_dilation,3,2
0X5B01B459045231D8.avi,51,1606,1246,360,28.892455858747994,morphological_dilation,3,2
0X5B01B459045231D8.avi,73,1073,781,292,37.38796414852753,morphological_dilation,3,2
0X5B0675C0754E2C41.avi,35,1424,1065,359,33.70892018779343,morphological_dilation,3,2
0X5B0675C0754E2C41.avi,50,769,439,330,75.17084282460137,morphological_dilation,3,2
0X5B0DAEFE452D4F2E.avi,38,1587,1231,356,28.9195775792039,morphological_dilation,3,2
0X5B0DAEFE452D4F2E.avi,57,943,655,288,43.969465648854964,morphological_dilation,3,2
0X5B0E31F05985CD68.avi,3,2257,1829,428,23.400765445598687,morphological_dilation,3,2
0X5B0E31F05985CD68.avi,29,1843,1451,392,27.015851137146797,morphological_dilation,3,2
0X5B0FF6323B769A36.avi,0,1641,1289,352,27.307990690457718,morphological_dilation,3,2
0X5B0FF6323B769A36.avi,19,1338,1018,320,31.43418467583497,morphological_dilation,3,2
0X5B10B8EF336047D5.avi,48,3301,2769,532,19.212712170458648,morphological_dilation,3,2
0X5B10B8EF336047D5.avi,64,2851,2359,492,20.856295040271302,morphological_dilation,3,2
0X5B11C88A9BEA16A1.avi,66,2842,2378,464,19.51219512195122,morphological_dilation,3,2
0X5B11C88A9BEA16A1.avi,80,1650,1283,367,28.604832424006236,morphological_dilation,3,2
0X5B1A54EA0582FEB.avi,111,1693,1317,376,28.549734244495063,morphological_dilation,3,2
0X5B1A54EA0582FEB.avi,125,966,666,300,45.04504504504504,morphological_dilation,3,2
0X5B1AF37FB6799661.avi,45,2527,2047,480,23.44894968246214,morphological_dilation,3,2
0X5B1AF37FB6799661.avi,73,1529,1149,380,33.072236727589214,morphological_dilation,3,2
0X5B2165383F6FB790.avi,75,1786,1426,360,25.245441795231415,morphological_dilation,3,2
0X5B2165383F6FB790.avi,90,1471,1127,344,30.523513753327418,morphological_dilation,3,2
0X5B239BAF568E5D96.avi,93,2079,1647,432,26.229508196721312,morphological_dilation,3,2
0X5B239BAF568E5D96.avi,110,1403,1031,372,36.08147429679923,morphological_dilation,3,2
0X5B272B9FE759F096.avi,40,1826,1428,398,27.871148459383754,morphological_dilation,3,2
0X5B272B9FE759F096.avi,59,1170,831,339,40.794223826714806,morphological_dilation,3,2
0X5B281D3A9CC32337.avi,55,1474,1130,344,30.442477876106196,morphological_dilation,3,2
0X5B281D3A9CC32337.avi,77,912,643,269,41.835147744945566,morphological_dilation,3,2
0X5B2C3BAF98374B17.avi,110,2343,1879,464,24.693986162852582,morphological_dilation,3,2
0X5B2C3BAF98374B17.avi,130,1461,1101,360,32.69754768392371,morphological_dilation,3,2
0X5B2ED564F5F520B8.avi,80,2953,2442,511,20.925470925470925,morphological_dilation,3,2
0X5B2ED564F5F520B8.avi,94,1951,1515,436,28.778877887788777,morphological_dilation,3,2
0X5B437B04F1B9248F.avi,53,1173,861,312,36.23693379790941,morphological_dilation,3,2
0X5B437B04F1B9248F.avi,66,647,415,232,55.90361445783133,morphological_dilation,3,2
0X5B486FEDFEF43494.avi,47,1150,835,315,37.72455089820359,morphological_dilation,3,2
0X5B486FEDFEF43494.avi,66,711,463,248,53.56371490280778,morphological_dilation,3,2
0X5B4D0D38F575846D.avi,8,1925,1511,414,27.39907346128392,morphological_dilation,3,2
0X5B4D0D38F575846D.avi,22,2441,1999,442,22.11105552776388,morphological_dilation,3,2
0X5B4FC85CF6045C88.avi,103,2629,2137,492,23.022929340196537,morphological_dilation,3,2
0X5B4FC85CF6045C88.avi,119,1488,1108,380,34.29602888086642,morphological_dilation,3,2
0X5B55C81391366432.avi,147,2519,2068,451,21.808510638297875,morphological_dilation,3,2
0X5B55C81391366432.avi,165,1680,1296,384,29.629629629629626,morphological_dilation,3,2
0X5B597AB91860C164.avi,49,1395,1063,332,31.23236124176858,morphological_dilation,3,2
0X5B597AB91860C164.avi,62,804,556,248,44.60431654676259,morphological_dilation,3,2
0X5B5A271E756F4794.avi,53,1797,1385,412,29.747292418772563,morphological_dilation,3,2
0X5B5A271E756F4794.avi,74,1104,780,324,41.53846153846154,morphological_dilation,3,2
0X5B5C0F6F8005A4BB.avi,126,1895,1495,400,26.755852842809364,morphological_dilation,3,2
0X5B5C0F6F8005A4BB.avi,144,1199,875,324,37.028571428571425,morphological_dilation,3,2
0X5B5C6BF6542C213C.avi,53,1435,1087,348,32.01471941122355,morphological_dilation,3,2
0X5B5C6BF6542C213C.avi,63,820,554,266,48.014440433213,morphological_dilation,3,2
0X5B65F2E4BE4274FB.avi,43,1956,1536,420,27.34375,morphological_dilation,3,2
0X5B65F2E4BE4274FB.avi,62,1107,736,371,50.40760869565217,morphological_dilation,3,2
0X5B669448D3486974.avi,52,1301,979,322,32.89070480081716,morphological_dilation,3,2
0X5B669448D3486974.avi,70,844,569,275,48.33040421792619,morphological_dilation,3,2
0X5B6FCBB75BF8FCB7.avi,69,2663,1811,852,47.04583103257868,morphological_dilation,3,2
0X5B6FCBB75BF8FCB7.avi,84,3431,2558,873,34.128225175918686,morphological_dilation,3,2
0X5B72422497E29451.avi,1,1502,1122,380,33.8680926916221,morphological_dilation,3,2
0X5B72422497E29451.avi,16,965,648,317,48.91975308641975,morphological_dilation,3,2
0X5B7385C417F7F182.avi,37,2084,1692,392,23.167848699763592,morphological_dilation,3,2
0X5B7385C417F7F182.avi,52,1321,985,336,34.11167512690355,morphological_dilation,3,2
0X5B7855A063C00985.avi,36,2708,2229,479,21.48945715567519,morphological_dilation,3,2
0X5B7855A063C00985.avi,53,1703,1315,388,29.50570342205323,morphological_dilation,3,2
0X5B787E051A2A714F.avi,90,1438,1082,356,32.90203327171904,morphological_dilation,3,2
0X5B787E051A2A714F.avi,107,877,593,284,47.89207419898819,morphological_dilation,3,2
0X5B7B5EF7F3E283B2.avi,44,1545,1189,356,29.941126997476868,morphological_dilation,3,2
0X5B7B5EF7F3E283B2.avi,57,1024,724,300,41.43646408839779,morphological_dilation,3,2
0X5B7DCEC4D8C1E6BB.avi,43,2443,2003,440,21.967049425861205,morphological_dilation,3,2
0X5B7DCEC4D8C1E6BB.avi,60,1942,1542,400,25.94033722438392,morphological_dilation,3,2
0X5B82F3AB4A965E2B.avi,94,1880,1492,388,26.005361930294907,morphological_dilation,3,2
0X5B82F3AB4A965E2B.avi,113,1592,1216,376,30.92105263157895,morphological_dilation,3,2
0X5B8551F76C584EE5.avi,92,2954,2458,496,20.179007323026852,morphological_dilation,3,2
0X5B8551F76C584EE5.avi,111,2518,2058,460,22.351797862001945,morphological_dilation,3,2
0X5B88342AB24EEE40.avi,45,2211,1799,412,22.901612006670373,morphological_dilation,3,2
0X5B88342AB24EEE40.avi,61,1370,1034,336,32.495164410058024,morphological_dilation,3,2
0X5B8C506AC0A3CB4B.avi,2,1588,1224,364,29.73856209150327,morphological_dilation,3,2
0X5B8C506AC0A3CB4B.avi,29,985,693,292,42.13564213564214,morphological_dilation,3,2
0X5B942F1EA8824606.avi,18,1942,1546,396,25.614489003880987,morphological_dilation,3,2
0X5B942F1EA8824606.avi,44,2666,2202,464,21.071752951861946,morphological_dilation,3,2
0X5B9B6E6A33D4BF36.avi,46,2881,2393,488,20.39281236941078,morphological_dilation,3,2
0X5B9B6E6A33D4BF36.avi,74,2463,2019,444,21.99108469539376,morphological_dilation,3,2
0X5B9C0EEB93E0BE10.avi,46,1883,1475,408,27.661016949152543,morphological_dilation,3,2
0X5B9C0EEB93E0BE10.avi,66,1181,849,332,39.10482921083628,morphological_dilation,3,2
0X5BA0316D390284D6.avi,44,1592,1232,360,29.22077922077922,morphological_dilation,3,2
0X5BA0316D390284D6.avi,56,905,633,272,42.96998420221169,morphological_dilation,3,2
0X5BA13657704CDD76.avi,44,1740,1360,380,27.941176470588236,morphological_dilation,3,2
0X5BA13657704CDD76.avi,60,974,682,292,42.81524926686217,morphological_dilation,3,2
0X5BA6C5333369EBF9.avi,0,1745,1379,366,26.54097171863669,morphological_dilation,3,2
0X5BA6C5333369EBF9.avi,11,1079,767,312,40.67796610169492,morphological_dilation,3,2
0X5BAA2D1ACBA618B9.avi,61,3062,2562,500,19.516003122560498,morphological_dilation,3,2
0X5BAA2D1ACBA618B9.avi,75,2474,2038,436,21.39352306182532,morphological_dilation,3,2
0X5BAA60FB400B73A6.avi,41,1698,1290,408,31.627906976744185,morphological_dilation,3,2
0X5BAA60FB400B73A6.avi,55,1019,699,320,45.779685264663804,morphological_dilation,3,2
0X5BAB6F2DF148AB55.avi,36,1325,1009,316,31.318136769078297,morphological_dilation,3,2
0X5BAB6F2DF148AB55.avi,50,1239,935,304,32.51336898395722,morphological_dilation,3,2
0X5BAC4129957FC22A.avi,108,2883,2396,487,20.325542570951587,morphological_dilation,3,2
0X5BAC4129957FC22A.avi,128,2085,1665,420,25.225225225225223,morphological_dilation,3,2
0X5BAD1B2D17E1169E.avi,37,1857,1497,360,24.04809619238477,morphological_dilation,3,2
0X5BAD1B2D17E1169E.avi,61,1675,1319,356,26.990144048521607,morphological_dilation,3,2
0X5BB0F7EC8D6E54C0.avi,43,1510,1142,368,32.22416812609457,morphological_dilation,3,2
0X5BB0F7EC8D6E54C0.avi,57,795,527,268,50.853889943074,morphological_dilation,3,2
0X5BB1D4B303FB2548.avi,57,1573,1221,352,28.82882882882883,morphological_dilation,3,2
0X5BB1D4B303FB2548.avi,70,1168,860,308,35.81395348837209,morphological_dilation,3,2
0X5BB42E2E63912CA9.avi,99,2234,1786,448,25.083986562150056,morphological_dilation,3,2
0X5BB42E2E63912CA9.avi,122,1414,1058,356,33.64839319470699,morphological_dilation,3,2
0X5BB5950E48DCABA2.avi,30,1204,882,322,36.507936507936506,morphological_dilation,3,2
0X5BB5950E48DCABA2.avi,43,903,615,288,46.82926829268293,morphological_dilation,3,2
0X5BB7CFFD105A3FAE.avi,56,2251,1823,428,23.477783872737245,morphological_dilation,3,2
0X5BB7CFFD105A3FAE.avi,76,1398,1042,356,34.16506717850288,morphological_dilation,3,2
0X5BBA205CF1389388.avi,84,1758,1382,376,27.206946454413895,morphological_dilation,3,2
0X5BBA205CF1389388.avi,114,1133,825,308,37.333333333333336,morphological_dilation,3,2
0X5BBB947BE9B5CD3E.avi,27,2778,2274,504,22.163588390501317,morphological_dilation,3,2
0X5BBB947BE9B5CD3E.avi,40,1703,1279,424,33.15089913995309,morphological_dilation,3,2
0X5BBDD38A52132F51.avi,61,1287,955,332,34.76439790575917,morphological_dilation,3,2
0X5BBDD38A52132F51.avi,82,807,521,286,54.894433781190024,morphological_dilation,3,2
0X5BC084DE4595DDA9.avi,83,1401,1065,336,31.549295774647888,morphological_dilation,3,2
0X5BC084DE4595DDA9.avi,96,1083,779,304,39.02439024390244,morphological_dilation,3,2
0X5BC4CD6E32784809.avi,51,2018,1606,412,25.653798256537986,morphological_dilation,3,2
0X5BC4CD6E32784809.avi,69,1267,927,340,36.67745415318231,morphological_dilation,3,2
0X5BC7BE982A4B59D0.avi,66,1437,1101,336,30.517711171662125,morphological_dilation,3,2
0X5BC7BE982A4B59D0.avi,81,976,704,272,38.63636363636363,morphological_dilation,3,2
0X5BCCA6A21A48BA1C.avi,52,2578,2122,456,21.489161168708765,morphological_dilation,3,2
0X5BCCA6A21A48BA1C.avi,69,1546,1166,380,32.59005145797599,morphological_dilation,3,2
0X5BCD54C82F8D582D.avi,90,2447,1979,468,23.648307225871655,morphological_dilation,3,2
0X5BCD54C82F8D582D.avi,108,1653,1253,400,31.92338387869114,morphological_dilation,3,2
0X5BCFC1AB74430ADC.avi,53,3813,3201,612,19.119025304592316,morphological_dilation,3,2
0X5BCFC1AB74430ADC.avi,67,2383,1879,504,26.82277807344332,morphological_dilation,3,2
0X5BD28538796B42E1.avi,42,2280,1820,460,25.274725274725274,morphological_dilation,3,2
0X5BD28538796B42E1.avi,56,1359,983,376,38.2502543234995,morphological_dilation,3,2
0X5BDB93DFF509755C.avi,100,1791,1411,380,26.93125442948264,morphological_dilation,3,2
0X5BDB93DFF509755C.avi,114,1101,787,314,39.898348157560356,morphological_dilation,3,2
0X5BDE274D50326F51.avi,70,1109,821,288,35.07917174177832,morphological_dilation,3,2
0X5BDE274D50326F51.avi,86,998,719,279,38.80389429763561,morphological_dilation,3,2
0X5BE1EB81D547BB00.avi,41,2866,2378,488,20.521446593776282,morphological_dilation,3,2
0X5BE1EB81D547BB00.avi,56,1796,1388,408,29.394812680115272,morphological_dilation,3,2
0X5BE6B8A080E4AAF3.avi,105,1792,1412,380,26.912181303116146,morphological_dilation,3,2
0X5BE6B8A080E4AAF3.avi,121,1111,787,324,41.16899618805591,morphological_dilation,3,2
0X5BED87AA6A6DE3C.avi,42,1805,1417,388,27.3817925194072,morphological_dilation,3,2
0X5BED87AA6A6DE3C.avi,55,1123,803,320,39.8505603985056,morphological_dilation,3,2
0X5BEFB1201A511970.avi,31,1137,809,328,40.54388133498146,morphological_dilation,3,2
0X5BEFB1201A511970.avi,44,716,429,287,66.8997668997669,morphological_dilation,3,2
0X5BF53B5D9E37CF85.avi,118,2345,1707,638,37.375512595196255,morphological_dilation,3,2
0X5BF53B5D9E37CF85.avi,138,1306,825,481,58.3030303030303,morphological_dilation,3,2
0X5BFC2EC0D445EA65.avi,57,1974,1542,432,28.01556420233463,morphological_dilation,3,2
0X5BFC2EC0D445EA65.avi,66,1652,1219,433,35.520918785890075,morphological_dilation,3,2
0X5BFC4BEBE8BF82CC.avi,30,1501,1161,340,29.285099052540914,morphological_dilation,3,2
0X5BFC4BEBE8BF82CC.avi,42,1006,718,288,40.11142061281337,morphological_dilation,3,2
0X5BFDF06DBFF53A0A.avi,71,3151,2647,504,19.04042312051379,morphological_dilation,3,2
0X5BFDF06DBFF53A0A.avi,90,2360,1940,420,21.649484536082475,morphological_dilation,3,2
0X5C00619340A86EAA.avi,46,4090,3471,619,17.83347738403918,morphological_dilation,3,2
0X5C00619340A86EAA.avi,67,3690,3107,583,18.76408110717734,morphological_dilation,3,2
0X5C006EA7B061D14E.avi,54,2573,2101,472,22.465492622560685,morphological_dilation,3,2
0X5C006EA7B061D14E.avi,74,1547,1189,358,30.109335576114383,morphological_dilation,3,2
0X5C04297CE92F9474.avi,32,1867,1495,372,24.882943143812707,morphological_dilation,3,2
0X5C04297CE92F9474.avi,44,1633,1285,348,27.08171206225681,morphological_dilation,3,2
0X5C0458BF2E4CF6C7.avi,3,1379,1011,368,36.39960435212661,morphological_dilation,3,2
0X5C0458BF2E4CF6C7.avi,25,863,560,303,54.107142857142854,morphological_dilation,3,2
0X5C05336F5F0ABF6F.avi,87,1820,1440,380,26.38888888888889,morphological_dilation,3,2
0X5C05336F5F0ABF6F.avi,104,1187,871,316,36.28013777267508,morphological_dilation,3,2
0X5C0622310D51F2EA.avi,34,1618,1243,375,30.16894609814964,morphological_dilation,3,2
0X5C0622310D51F2EA.avi,49,1135,823,312,37.91008505467801,morphological_dilation,3,2
0X5C07652BAE8C7302.avi,74,1579,1223,356,29.10874897792314,morphological_dilation,3,2
0X5C07652BAE8C7302.avi,85,1048,740,308,41.62162162162162,morphological_dilation,3,2
0X5C0BCAA2FB4FF1B4.avi,98,1202,898,304,33.85300668151447,morphological_dilation,3,2
0X5C0BCAA2FB4FF1B4.avi,118,955,687,268,39.01018922852984,morphological_dilation,3,2
0X5C0D8A8607A0BCD8.avi,64,2118,1658,460,27.744270205066346,morphological_dilation,3,2
0X5C0D8A8607A0BCD8.avi,80,1331,951,380,39.95793901156677,morphological_dilation,3,2
0X5C0E4F3C27ED9B85.avi,36,1947,1557,390,25.048169556840076,morphological_dilation,3,2
0X5C0E4F3C27ED9B85.avi,54,1339,1027,312,30.37974683544304,morphological_dilation,3,2
0X5C0FD8B1175151FA.avi,43,2738,2254,484,21.472937000887313,morphological_dilation,3,2
0X5C0FD8B1175151FA.avi,59,1920,1509,411,27.236580516898606,morphological_dilation,3,2
0X5C103167BD77DE9C.avi,133,1562,1194,368,30.82077051926298,morphological_dilation,3,2
0X5C103167BD77DE9C.avi,152,1066,742,324,43.66576819407008,morphological_dilation,3,2
0X5C12941016554219.avi,43,1379,1055,324,30.71090047393365,morphological_dilation,3,2
0X5C12941016554219.avi,56,907,631,276,43.74009508716323,morphological_dilation,3,2
0X5C13832F252936F7.avi,165,2468,2024,444,21.936758893280633,morphological_dilation,3,2
0X5C13832F252936F7.avi,203,1374,987,387,39.209726443769,morphological_dilation,3,2
0X5C1E8311A4AA5E96.avi,50,3390,2870,520,18.118466898954704,morphological_dilation,3,2
0X5C1E8311A4AA5E96.avi,71,2382,1898,484,25.500526870389884,morphological_dilation,3,2
0X5C2093C65B92C741.avi,145,1462,1114,348,31.23877917414722,morphological_dilation,3,2
0X5C2093C65B92C741.avi,164,896,616,280,45.45454545454545,morphological_dilation,3,2
0X5C20947D2D3C0638.avi,85,1808,1412,396,28.04532577903683,morphological_dilation,3,2
0X5C20947D2D3C0638.avi,102,1176,847,329,38.84297520661157,morphological_dilation,3,2
0X5C253FDBCD0E300A.avi,82,1608,1236,372,30.097087378640776,morphological_dilation,3,2
0X5C253FDBCD0E300A.avi,100,969,663,306,46.15384615384615,morphological_dilation,3,2
0X5C26378213CC3D5E.avi,52,1481,1133,348,30.71491615180936,morphological_dilation,3,2
0X5C26378213CC3D5E.avi,61,963,651,312,47.926267281105986,morphological_dilation,3,2
0X5C27FE43EBDF4484.avi,1,1542,1182,360,30.456852791878177,morphological_dilation,3,2
0X5C27FE43EBDF4484.avi,20,923,643,280,43.54587869362364,morphological_dilation,3,2
0X5C2959CAADE171C9.avi,47,1411,1063,348,32.73753527751646,morphological_dilation,3,2
0X5C2959CAADE171C9.avi,66,903,627,276,44.01913875598086,morphological_dilation,3,2
0X5C3401A02A219AB6.avi,50,1916,1520,396,26.052631578947366,morphological_dilation,3,2
0X5C3401A02A219AB6.avi,65,1362,1026,336,32.748538011695906,morphological_dilation,3,2
0X5C363EB9E7B8D2D7.avi,49,1654,1282,372,29.017160686427456,morphological_dilation,3,2
0X5C363EB9E7B8D2D7.avi,66,961,673,288,42.79346210995542,morphological_dilation,3,2
0X5C36C47474E66354.avi,75,1679,1311,368,28.07017543859649,morphological_dilation,3,2
0X5C36C47474E66354.avi,84,1138,798,340,42.606516290726816,morphological_dilation,3,2
0X5C3B081C1D5BC264.avi,44,1447,1115,332,29.775784753363226,morphological_dilation,3,2
0X5C3B081C1D5BC264.avi,59,870,598,272,45.48494983277592,morphological_dilation,3,2
0X5C3E19EC804AB89A.avi,106,1397,1045,352,33.68421052631579,morphological_dilation,3,2
0X5C3E19EC804AB89A.avi,122,836,536,300,55.970149253731336,morphological_dilation,3,2
0X5C41AF3F25757D5B.avi,32,1128,812,316,38.91625615763547,morphological_dilation,3,2
0X5C41AF3F25757D5B.avi,46,638,402,236,58.70646766169154,morphological_dilation,3,2
0X5C433F9E3BA1E2DF.avi,25,1675,1283,392,30.55339049103663,morphological_dilation,3,2
0X5C433F9E3BA1E2DF.avi,36,1084,768,316,41.14583333333333,morphological_dilation,3,2
0X5C43DB9C3DA8C861.avi,111,3026,2518,508,20.17474185861795,morphological_dilation,3,2
0X5C43DB9C3DA8C861.avi,130,1890,1470,420,28.57142857142857,morphological_dilation,3,2
0X5C48A57102118A57.avi,38,1092,784,308,39.285714285714285,morphological_dilation,3,2
0X5C48A57102118A57.avi,51,664,419,245,58.47255369928401,morphological_dilation,3,2
0X5C4DAA1DF7F8CA25.avi,112,1451,1093,358,32.75388838060384,morphological_dilation,3,2
0X5C4DAA1DF7F8CA25.avi,130,866,574,292,50.87108013937283,morphological_dilation,3,2
0X5C53EA56AC3783CF.avi,35,2093,1697,396,23.335297583971716,morphological_dilation,3,2
0X5C53EA56AC3783CF.avi,49,1108,812,296,36.45320197044335,morphological_dilation,3,2
0X5C55673175514E32.avi,98,4169,3609,560,15.516763646439458,morphological_dilation,3,2
0X5C55673175514E32.avi,115,3603,3063,540,17.62977473065622,morphological_dilation,3,2
0X5C565C7D7CF4A489.avi,59,2056,1636,420,25.67237163814181,morphological_dilation,3,2
0X5C565C7D7CF4A489.avi,74,1221,895,326,36.424581005586596,morphological_dilation,3,2
0X5C58323A222761B2.avi,121,2476,2020,456,22.574257425742577,morphological_dilation,3,2
0X5C58323A222761B2.avi,139,1777,1381,396,28.674873280231715,morphological_dilation,3,2
0X5C5B9906DC0D9057.avi,98,2221,1790,431,24.078212290502794,morphological_dilation,3,2
0X5C5B9906DC0D9057.avi,110,1396,1056,340,32.196969696969695,morphological_dilation,3,2
0X5C5F3F8BD96C3437.avi,45,1650,1274,376,29.513343799058084,morphological_dilation,3,2
0X5C5F3F8BD96C3437.avi,59,949,649,300,46.22496147919877,morphological_dilation,3,2
0X5C6E9BA3AC1B4ECB.avi,43,1896,1508,388,25.72944297082228,morphological_dilation,3,2
0X5C6E9BA3AC1B4ECB.avi,55,1455,1111,344,30.96309630963096,morphological_dilation,3,2
0X5C70DA5DA096EBF8.avi,121,1776,1388,388,27.953890489913547,morphological_dilation,3,2
0X5C70DA5DA096EBF8.avi,140,1169,837,332,39.66547192353644,morphological_dilation,3,2
0X5C72AD9624A40A3A.avi,61,2859,2387,472,19.773774612484292,morphological_dilation,3,2
0X5C72AD9624A40A3A.avi,83,1759,1363,396,29.05355832721937,morphological_dilation,3,2
0X5C732BCF53162A65.avi,65,930,658,272,41.33738601823708,morphological_dilation,3,2
0X5C732BCF53162A65.avi,66,2224,1586,638,40.22698612862548,morphological_dilation,3,2
0X5C753484DB492ACA.avi,112,1422,1070,352,32.89719626168225,morphological_dilation,3,2
0X5C753484DB492ACA.avi,123,859,579,280,48.35924006908463,morphological_dilation,3,2
0X5C763FA1B573D7A8.avi,94,2275,1835,440,23.978201634877383,morphological_dilation,3,2
0X5C763FA1B573D7A8.avi,104,1919,1507,412,27.33908427339084,morphological_dilation,3,2
0X5C7B3A4A12245C5E.avi,48,1957,1569,388,24.72912683237731,morphological_dilation,3,2
0X5C7B3A4A12245C5E.avi,63,1608,1241,367,29.572925060435136,morphological_dilation,3,2
0X5C7D9604189AB703.avi,54,1518,1142,376,32.9246935201401,morphological_dilation,3,2
0X5C7D9604189AB703.avi,72,974,670,304,45.37313432835821,morphological_dilation,3,2
0X5C7F6275DDC3DB94.avi,81,1417,1065,352,33.051643192488264,morphological_dilation,3,2
0X5C7F6275DDC3DB94.avi,92,830,566,264,46.64310954063604,morphological_dilation,3,2
0X5C80C526C8437CF6.avi,59,1286,962,324,33.679833679833685,morphological_dilation,3,2
0X5C80C526C8437CF6.avi,73,807,535,272,50.8411214953271,morphological_dilation,3,2
0X5C814528DCE46509.avi,44,3401,2877,524,18.21341675356274,morphological_dilation,3,2
0X5C814528DCE46509.avi,62,2210,1762,448,25.425652667423382,morphological_dilation,3,2
0X5C8171EDE5E95BCD.avi,48,1692,1308,384,29.357798165137616,morphological_dilation,3,2
0X5C8171EDE5E95BCD.avi,61,1148,784,364,46.42857142857143,morphological_dilation,3,2
0X5C81C3B8CCCE3B1D.avi,105,1854,1421,433,30.47149894440535,morphological_dilation,3,2
0X5C81C3B8CCCE3B1D.avi,121,1242,849,393,46.28975265017668,morphological_dilation,3,2
0X5C82DDEEA7B83F66.avi,49,1869,1481,388,26.198514517218097,morphological_dilation,3,2
0X5C82DDEEA7B83F66.avi,67,1185,861,324,37.63066202090592,morphological_dilation,3,2
0X5C85CE60422E8717.avi,4,1601,1225,376,30.69387755102041,morphological_dilation,3,2
0X5C85CE60422E8717.avi,32,989,689,300,43.54136429608128,morphological_dilation,3,2
0X5C89E0348E49D500.avi,87,2261,1810,451,24.917127071823206,morphological_dilation,3,2
0X5C89E0348E49D500.avi,105,1757,1368,389,28.43567251461988,morphological_dilation,3,2
0X5C8E74E8A72B2CCE.avi,109,2690,2230,460,20.62780269058296,morphological_dilation,3,2
0X5C8E74E8A72B2CCE.avi,126,1517,1157,360,31.11495246326707,morphological_dilation,3,2
0X5C8FBD78D13B887F.avi,46,2017,1570,447,28.471337579617835,morphological_dilation,3,2
0X5C8FBD78D13B887F.avi,63,1144,736,408,55.434782608695656,morphological_dilation,3,2
0X5C92D4C03C058F68.avi,52,2192,1764,428,24.263038548752835,morphological_dilation,3,2
0X5C92D4C03C058F68.avi,71,1284,956,328,34.30962343096235,morphological_dilation,3,2
0X5C953D8682D4E34B.avi,42,845,576,269,46.70138888888889,morphological_dilation,3,2
0X5C953D8682D4E34B.avi,71,587,295,292,98.98305084745763,morphological_dilation,3,2
0X5C98E42CEB827219.avi,49,1774,1398,376,26.895565092989987,morphological_dilation,3,2
0X5C98E42CEB827219.avi,61,1040,740,300,40.54054054054054,morphological_dilation,3,2
0X5CA1BF7D104E3F20.avi,86,2298,1831,467,25.50518842162753,morphological_dilation,3,2
0X5CA1BF7D104E3F20.avi,97,1270,898,372,41.42538975501114,morphological_dilation,3,2
0X5CA2B7ACC72E7089.avi,114,1522,1174,348,29.642248722316864,morphological_dilation,3,2
0X5CA2B7ACC72E7089.avi,127,862,594,268,45.11784511784512,morphological_dilation,3,2
0X5CA86377C2EDF210.avi,79,2840,2364,476,20.135363790186126,morphological_dilation,3,2
0X5CA86377C2EDF210.avi,99,2394,1958,436,22.26762002042901,morphological_dilation,3,2
0X5CA9EC597BD1151A.avi,0,1869,1487,382,25.68930733019502,morphological_dilation,3,2
0X5CA9EC597BD1151A.avi,13,1150,838,312,37.23150357995227,morphological_dilation,3,2
0X5CAA16702850040C.avi,45,2004,1588,416,26.19647355163728,morphological_dilation,3,2
0X5CAA16702850040C.avi,67,1177,845,332,39.289940828402365,morphological_dilation,3,2
0X5CAF9C965AB286BB.avi,43,1284,956,328,34.30962343096235,morphological_dilation,3,2
0X5CAF9C965AB286BB.avi,59,1017,737,280,37.99185888738128,morphological_dilation,3,2
0X5CAFBD8F2F8DC00B.avi,51,1213,905,308,34.033149171270715,morphological_dilation,3,2
0X5CAFBD8F2F8DC00B.avi,70,738,487,251,51.54004106776181,morphological_dilation,3,2
0X5CB4E030D0C4F388.avi,65,1418,1078,340,31.539888682745826,morphological_dilation,3,2
0X5CB4E030D0C4F388.avi,83,1042,738,304,41.19241192411924,morphological_dilation,3,2
0X5CB4FCCE5C545733.avi,0,1882,1494,388,25.970548862115127,morphological_dilation,3,2
0X5CB4FCCE5C545733.avi,15,1202,882,320,36.281179138321995,morphological_dilation,3,2
0X5CB575476EC80F28.avi,48,1459,1115,344,30.852017937219735,morphological_dilation,3,2
0X5CB575476EC80F28.avi,67,1001,717,284,39.609483960948396,morphological_dilation,3,2
0X5CB89319A7E13712.avi,63,1262,928,334,35.991379310344826,morphological_dilation,3,2
0X5CB89319A7E13712.avi,80,836,540,296,54.81481481481482,morphological_dilation,3,2
0X5CB89528DF79490D.avi,39,1001,685,316,46.131386861313864,morphological_dilation,3,2
0X5CB89528DF79490D.avi,60,615,363,252,69.42148760330579,morphological_dilation,3,2
0X5CBA5F10CE173C78.avi,90,3117,2597,520,20.023103581055064,morphological_dilation,3,2
0X5CBA5F10CE173C78.avi,106,1913,1493,420,28.13127930341594,morphological_dilation,3,2
0X5CBCDC46C155136.avi,62,2529,2066,463,22.410454985479188,morphological_dilation,3,2
0X5CBCDC46C155136.avi,77,1807,1403,404,28.79543834640057,morphological_dilation,3,2
0X5CBF8B43EFDD7D6E.avi,73,2222,1810,412,22.76243093922652,morphological_dilation,3,2
0X5CBF8B43EFDD7D6E.avi,89,1996,1608,388,24.129353233830848,morphological_dilation,3,2
0X5CC16B5FA6C18B06.avi,94,3444,2888,556,19.252077562326868,morphological_dilation,3,2
0X5CC16B5FA6C18B06.avi,105,2109,1637,472,28.833231521075138,morphological_dilation,3,2
0X5CC6EB5C62ABD303.avi,101,3223,2692,531,19.72511144130758,morphological_dilation,3,2
0X5CC6EB5C62ABD303.avi,118,2072,1620,452,27.901234567901234,morphological_dilation,3,2
0X5CC9462160833E16.avi,74,3562,3003,559,18.614718614718615,morphological_dilation,3,2
0X5CC9462160833E16.avi,103,2065,1633,432,26.454378444580527,morphological_dilation,3,2
0X5CCAAAD2D61ACFE9.avi,68,2078,1646,432,26.24544349939247,morphological_dilation,3,2
0X5CCAAAD2D61ACFE9.avi,83,1353,1005,348,34.626865671641795,morphological_dilation,3,2
0X5CCC89BCE8721F66.avi,46,1480,1112,368,33.093525179856115,morphological_dilation,3,2
0X5CCC89BCE8721F66.avi,64,957,657,300,45.662100456621005,morphological_dilation,3,2
0X5CCF81D7227F7671.avi,152,1119,809,310,38.31891223733004,morphological_dilation,3,2
0X5CCF81D7227F7671.avi,162,1383,1037,346,33.365477338476374,morphological_dilation,3,2
0X5CD36D24B82283A8.avi,2,2429,1957,472,24.11854879918242,morphological_dilation,3,2
0X5CD36D24B82283A8.avi,26,1517,1109,408,36.78990081154193,morphological_dilation,3,2
0X5CD3BB239816DE46.avi,2,2186,1772,414,23.363431151241535,morphological_dilation,3,2
0X5CD3BB239816DE46.avi,20,1229,905,324,35.80110497237569,morphological_dilation,3,2
0X5CD9E4FC7E803411.avi,86,1514,1146,368,32.11169284467714,morphological_dilation,3,2
0X5CD9E4FC7E803411.avi,101,990,674,316,46.88427299703264,morphological_dilation,3,2
0X5CDCA095B4FB6100.avi,43,1184,868,316,36.405529953917046,morphological_dilation,3,2
0X5CDCA095B4FB6100.avi,58,662,414,248,59.90338164251207,morphological_dilation,3,2
0X5CDFC7FFCE29EC42.avi,45,1745,1369,376,27.465303140978815,morphological_dilation,3,2
0X5CDFC7FFCE29EC42.avi,63,1334,1006,328,32.60437375745527,morphological_dilation,3,2
0X5CE06D8A08BD9C7.avi,48,1803,1427,376,26.3489838822705,morphological_dilation,3,2
0X5CE06D8A08BD9C7.avi,63,1159,835,324,38.80239520958084,morphological_dilation,3,2
0X5CE16B7E824B54DD.avi,39,1620,1244,376,30.22508038585209,morphological_dilation,3,2
0X5CE16B7E824B54DD.avi,51,1034,726,308,42.42424242424242,morphological_dilation,3,2
0X5CE35FD20E949C11.avi,96,3274,2754,520,18.88162672476398,morphological_dilation,3,2
0X5CE35FD20E949C11.avi,113,2658,2174,484,22.263109475620976,morphological_dilation,3,2
0X5CEAF8CCDF0F1DA1.avi,175,1368,1044,324,31.03448275862069,morphological_dilation,3,2
0X5CEAF8CCDF0F1DA1.avi,191,1117,829,288,34.74065138721351,morphological_dilation,3,2
0X5CEFEEEA65D39669.avi,90,1622,1238,384,31.017770597738288,morphological_dilation,3,2
0X5CEFEEEA65D39669.avi,106,1130,794,336,42.31738035264483,morphological_dilation,3,2
0X5CF840808AC3A51D.avi,52,2223,1779,444,24.957841483979763,morphological_dilation,3,2
0X5CF840808AC3A51D.avi,70,1392,1013,379,37.41362290227048,morphological_dilation,3,2
0X5CFB1249B6E7AB45.avi,52,1928,1521,407,26.758711374095988,morphological_dilation,3,2
0X5CFB1249B6E7AB45.avi,69,1260,916,344,37.55458515283843,morphological_dilation,3,2
0X5CFB2DE05E52418E.avi,50,1183,899,284,31.590656284760843,morphological_dilation,3,2
0X5CFB2DE05E52418E.avi,57,725,509,216,42.43614931237721,morphological_dilation,3,2
0X5CFD1C355DE93894.avi,67,2870,2390,480,20.0836820083682,morphological_dilation,3,2
0X5CFD1C355DE93894.avi,82,2301,1881,420,22.328548644338117,morphological_dilation,3,2
0X5D0DFD26F454D74C.avi,41,1736,1356,380,28.023598820058996,morphological_dilation,3,2
0X5D0DFD26F454D74C.avi,59,1084,772,312,40.41450777202073,morphological_dilation,3,2
0X5D103E4500F4E03B.avi,119,1107,807,300,37.174721189591075,morphological_dilation,3,2
0X5D103E4500F4E03B.avi,135,705,465,240,51.61290322580645,morphological_dilation,3,2
0X5D13B00A9C834084.avi,39,1994,1594,400,25.094102885821833,morphological_dilation,3,2
0X5D13B00A9C834084.avi,58,1276,944,332,35.16949152542373,morphological_dilation,3,2
0X5D159B26B4AFC43B.avi,33,1522,1162,360,30.98106712564544,morphological_dilation,3,2
0X5D159B26B4AFC43B.avi,50,1057,761,296,38.89618922470434,morphological_dilation,3,2
0X5D15F6BD0B9D5CE2.avi,96,3103,2572,531,20.645412130637634,morphological_dilation,3,2
0X5D15F6BD0B9D5CE2.avi,111,1872,1432,440,30.726256983240223,morphological_dilation,3,2
0X5D19F61D8DD2A327.avi,78,1781,1373,408,29.715950473415877,morphological_dilation,3,2
0X5D19F61D8DD2A327.avi,95,1019,711,308,43.319268635724335,morphological_dilation,3,2
0X5D1C4DB993CBEB5F.avi,31,1454,1087,367,33.762649494020245,morphological_dilation,3,2
0X5D1C4DB993CBEB5F.avi,43,801,513,288,56.14035087719298,morphological_dilation,3,2
0X5D20C54CD929741.avi,0,2713,2243,470,20.954079358002677,morphological_dilation,3,2
0X5D20C54CD929741.avi,13,1543,1173,370,31.54305200341006,morphological_dilation,3,2
0X5D278EA9617E43F0.avi,40,1761,1373,388,28.25928623452294,morphological_dilation,3,2
0X5D278EA9617E43F0.avi,59,1163,823,340,41.31227217496962,morphological_dilation,3,2
0X5D29CF199E85BCE7.avi,96,1440,1108,332,29.96389891696751,morphological_dilation,3,2
0X5D29CF199E85BCE7.avi,111,881,601,280,46.58901830282861,morphological_dilation,3,2
0X5D2CD9603F554C22.avi,49,1263,939,324,34.504792332268366,morphological_dilation,3,2
0X5D2CD9603F554C22.avi,68,809,521,288,55.27831094049904,morphological_dilation,3,2
0X5D2DE43B30BAE113.avi,42,2542,2074,468,22.565091610414658,morphological_dilation,3,2
0X5D2DE43B30BAE113.avi,66,2194,1758,436,24.800910125142206,morphological_dilation,3,2
0X5D2F019F366E4CB0.avi,60,1770,1370,400,29.1970802919708,morphological_dilation,3,2
0X5D2F019F366E4CB0.avi,76,1170,839,331,39.45172824791419,morphological_dilation,3,2
0X5D2F7405A43DB64D.avi,48,2006,1606,400,24.906600249066003,morphological_dilation,3,2
0X5D2F7405A43DB64D.avi,65,1190,858,332,38.6946386946387,morphological_dilation,3,2
0X5D38D994C2490EAE.avi,75,1897,1411,486,34.44365698086463,morphological_dilation,3,2
0X5D38D994C2490EAE.avi,90,1391,1043,348,33.36529242569511,morphological_dilation,3,2
0X5D3A01DA317E6D4C.avi,78,1556,1204,352,29.2358803986711,morphological_dilation,3,2
0X5D3A01DA317E6D4C.avi,95,927,643,284,44.16796267496112,morphological_dilation,3,2
0X5D3A4E695699D345.avi,71,2422,1970,452,22.944162436548226,morphological_dilation,3,2
0X5D3A4E695699D345.avi,84,1936,1520,416,27.368421052631582,morphological_dilation,3,2
0X5D3BE1C6F1BDBF8.avi,100,2099,1679,420,25.01488981536629,morphological_dilation,3,2
0X5D3BE1C6F1BDBF8.avi,113,1771,1399,372,26.590421729807005,morphological_dilation,3,2
0X5D3D9A1B411AC0B6.avi,147,2878,2382,496,20.822837951301427,morphological_dilation,3,2
0X5D3D9A1B411AC0B6.avi,167,1878,1454,424,29.160935350756535,morphological_dilation,3,2
0X5D4384C94F609882.avi,38,1566,1214,352,28.995057660626028,morphological_dilation,3,2
0X5D4384C94F609882.avi,55,910,650,260,40.0,morphological_dilation,3,2
0X5D453767BD555153.avi,103,1253,917,336,36.6412213740458,morphological_dilation,3,2
0X5D453767BD555153.avi,123,769,497,272,54.72837022132797,morphological_dilation,3,2
0X5D46AD1CAA0CD528.avi,69,1292,956,336,35.146443514644346,morphological_dilation,3,2
0X5D46AD1CAA0CD528.avi,84,795,507,288,56.80473372781065,morphological_dilation,3,2
0X5D4CE41A2D8F067B.avi,83,1681,1305,376,28.812260536398465,morphological_dilation,3,2
0X5D4CE41A2D8F067B.avi,97,1030,722,308,42.65927977839335,morphological_dilation,3,2
0X5D4D12B2C125581C.avi,0,1864,1492,372,24.932975871313673,morphological_dilation,3,2
0X5D4D12B2C125581C.avi,12,1041,749,292,38.98531375166889,morphological_dilation,3,2
0X5D502551D07D4DA4.avi,92,1423,1087,336,30.910763569457224,morphological_dilation,3,2
0X5D502551D07D4DA4.avi,108,1176,868,308,35.483870967741936,morphological_dilation,3,2
0X5D50280B44A63430.avi,77,1030,734,296,40.32697547683924,morphological_dilation,3,2
0X5D50280B44A63430.avi,90,869,597,272,45.56113902847571,morphological_dilation,3,2
0X5D50BBB7B29F5ED1.avi,23,1156,852,304,35.68075117370892,morphological_dilation,3,2
0X5D50BBB7B29F5ED1.avi,43,741,471,270,57.324840764331206,morphological_dilation,3,2
0X5D52AB9A6C8549D8.avi,47,3092,2585,507,19.613152804642166,morphological_dilation,3,2
0X5D52AB9A6C8549D8.avi,67,1696,1292,404,31.269349845201237,morphological_dilation,3,2
0X5D5897D9D7262386.avi,49,1490,1146,344,30.017452006980804,morphological_dilation,3,2
0X5D5897D9D7262386.avi,61,1160,854,306,35.831381733021075,morphological_dilation,3,2
0X5D5AAA4D4A5C945E.avi,48,1736,1348,388,28.783382789317507,morphological_dilation,3,2
0X5D5AAA4D4A5C945E.avi,66,1046,738,308,41.734417344173444,morphological_dilation,3,2
0X5D5EA202B6453DBE.avi,140,2492,2005,487,24.289276807980052,morphological_dilation,3,2
0X5D5EA202B6453DBE.avi,155,1812,1376,436,31.686046511627907,morphological_dilation,3,2
0X5D653441BD69A02E.avi,33,1530,1150,380,33.04347826086956,morphological_dilation,3,2
0X5D653441BD69A02E.avi,50,934,602,332,55.14950166112956,morphological_dilation,3,2
0X5D6A1608E132B62A.avi,53,1754,1378,376,27.28592162554427,morphological_dilation,3,2
0X5D6A1608E132B62A.avi,67,1172,860,312,36.27906976744186,morphological_dilation,3,2
0X5D6C0055AEA9214F.avi,41,1509,1153,356,30.875975715524717,morphological_dilation,3,2
0X5D6C0055AEA9214F.avi,60,1300,972,328,33.744855967078195,morphological_dilation,3,2
0X5D78417E9211CC18.avi,46,2595,2111,484,22.92752250118427,morphological_dilation,3,2
0X5D78417E9211CC18.avi,65,1998,1550,448,28.903225806451616,morphological_dilation,3,2
0X5D7A013C97D80D53.avi,81,1609,1241,368,29.653505237711524,morphological_dilation,3,2
0X5D7A013C97D80D53.avi,95,1049,749,300,40.053404539385845,morphological_dilation,3,2
0X5D7B0639FC5F0680.avi,100,2449,1982,467,23.562058526740667,morphological_dilation,3,2
0X5D7B0639FC5F0680.avi,119,1537,1169,368,31.479897348160822,morphological_dilation,3,2
0X5D7CE3C255D509DE.avi,111,1626,1262,364,28.84310618066561,morphological_dilation,3,2
0X5D7CE3C255D509DE.avi,121,1123,815,308,37.79141104294478,morphological_dilation,3,2
0X5D7DED9EE53AFE49.avi,56,4351,3735,616,16.49263721552878,morphological_dilation,3,2
0X5D7DED9EE53AFE49.avi,76,2741,2229,512,22.969941677882456,morphological_dilation,3,2
0X5D7FCA50F8853C9.avi,45,2005,1605,400,24.922118380062305,morphological_dilation,3,2
0X5D7FCA50F8853C9.avi,59,1196,876,320,36.5296803652968,morphological_dilation,3,2
0X5D803519EA68C681.avi,37,1430,1086,344,31.675874769797424,morphological_dilation,3,2
0X5D803519EA68C681.avi,53,931,643,288,44.7900466562986,morphological_dilation,3,2
0X5D81397DB541670A.avi,40,1887,1503,384,25.54890219560878,morphological_dilation,3,2
0X5D81397DB541670A.avi,57,1730,1362,368,27.019089574155654,morphological_dilation,3,2
0X5D8CC617E26B46EC.avi,1,1575,1227,348,28.361858190709043,morphological_dilation,3,2
0X5D8CC617E26B46EC.avi,17,1019,731,288,39.398084815321475,morphological_dilation,3,2
0X5D8E881ECEE5F36.avi,55,1950,1558,392,25.1604621309371,morphological_dilation,3,2
0X5D8E881ECEE5F36.avi,70,1238,922,316,34.273318872017356,morphological_dilation,3,2
0X5D923AF380EB455C.avi,65,1452,1120,332,29.642857142857142,morphological_dilation,3,2
0X5D923AF380EB455C.avi,83,961,689,272,39.477503628447025,morphological_dilation,3,2
0X5D96B22626F0D2AA.avi,150,2440,1984,456,22.983870967741936,morphological_dilation,3,2
0X5D96B22626F0D2AA.avi,170,1586,1202,384,31.94675540765391,morphological_dilation,3,2
0X5D989C293C8C2CE4.avi,68,2199,1755,444,25.299145299145298,morphological_dilation,3,2
0X5D989C293C8C2CE4.avi,103,3455,2919,536,18.362452894826994,morphological_dilation,3,2
0X5D98E2C64E1625FB.avi,69,1329,992,337,33.971774193548384,morphological_dilation,3,2
0X5D98E2C64E1625FB.avi,84,1150,830,320,38.55421686746988,morphological_dilation,3,2
0X5DA482A6C4BDC535.avi,100,1508,1104,404,36.594202898550726,morphological_dilation,3,2
0X5DA482A6C4BDC535.avi,115,930,565,365,64.60176991150442,morphological_dilation,3,2
0X5DA69748408F8E20.avi,38,1308,964,344,35.684647302904565,morphological_dilation,3,2
0X5DA69748408F8E20.avi,54,866,578,288,49.82698961937716,morphological_dilation,3,2
0X5DA9D6661907E7F0.avi,60,1648,1276,372,29.153605015673982,morphological_dilation,3,2
0X5DA9D6661907E7F0.avi,67,1059,649,410,63.17411402157165,morphological_dilation,3,2
0X5DAB2DA5F776DE78.avi,55,2321,1877,444,23.654768247202984,morphological_dilation,3,2
0X5DAB2DA5F776DE78.avi,84,1461,1105,356,32.217194570135746,morphological_dilation,3,2
0X5DAB9FDE7CC700DE.avi,56,2616,2180,436,20.0,morphological_dilation,3,2
0X5DAB9FDE7CC700DE.avi,70,2106,1722,384,22.299651567944252,morphological_dilation,3,2
0X5DAE4DC1DC55BB33.avi,46,2412,1976,436,22.06477732793522,morphological_dilation,3,2
0X5DAE4DC1DC55BB33.avi,60,1572,1208,364,30.132450331125828,morphological_dilation,3,2
0X5DAF04808611BAAB.avi,78,1574,1194,380,31.825795644891127,morphological_dilation,3,2
0X5DAF04808611BAAB.avi,95,961,648,313,48.30246913580247,morphological_dilation,3,2
0X5DAFCBD9AF45FE1D.avi,54,1458,1114,344,30.879712746858168,morphological_dilation,3,2
0X5DAFCBD9AF45FE1D.avi,69,875,595,280,47.05882352941176,morphological_dilation,3,2
0X5DB386B94F7C4BC3.avi,42,1546,1202,344,28.618968386023298,morphological_dilation,3,2
0X5DB386B94F7C4BC3.avi,56,896,624,272,43.58974358974359,morphological_dilation,3,2
0X5DB7742B2778FD6B.avi,2,1731,1347,384,28.507795100222715,morphological_dilation,3,2
0X5DB7742B2778FD6B.avi,18,1162,830,332,40.0,morphological_dilation,3,2
0X5DB7FAB9B9BE5D9.avi,47,1994,1582,412,26.04298356510746,morphological_dilation,3,2
0X5DB7FAB9B9BE5D9.avi,54,1245,885,360,40.67796610169492,morphological_dilation,3,2
0X5DB9102BCAA695A1.avi,79,1507,1147,360,31.386224934612034,morphological_dilation,3,2
0X5DB9102BCAA695A1.avi,92,861,581,280,48.19277108433735,morphological_dilation,3,2
0X5DB9401060BD9D0F.avi,39,1610,1258,352,27.980922098569156,morphological_dilation,3,2
0X5DB9401060BD9D0F.avi,53,1046,742,304,40.97035040431267,morphological_dilation,3,2
0X5DB9B61F813D5FF1.avi,81,1209,885,324,36.610169491525426,morphological_dilation,3,2
0X5DB9B61F813D5FF1.avi,102,851,563,288,51.15452930728242,morphological_dilation,3,2
0X5DC35F53CE78C741.avi,19,1680,1316,364,27.659574468085108,morphological_dilation,3,2
0X5DC35F53CE78C741.avi,37,1163,858,305,35.54778554778555,morphological_dilation,3,2
0X5DC400C55208AB98.avi,59,1760,1360,400,29.411764705882355,morphological_dilation,3,2
0X5DC400C55208AB98.avi,79,1031,722,309,42.797783933518005,morphological_dilation,3,2
0X5DC558E6A9C2553D.avi,66,1354,998,356,35.671342685370746,morphological_dilation,3,2
0X5DC558E6A9C2553D.avi,84,759,487,272,55.85215605749486,morphological_dilation,3,2
0X5DC624BE02E6CDD.avi,54,2714,2238,476,21.26899016979446,morphological_dilation,3,2
0X5DC624BE02E6CDD.avi,73,1669,1285,384,29.883268482490273,morphological_dilation,3,2
0X5DC8E85D737912F.avi,34,2030,1634,396,24.23500611995104,morphological_dilation,3,2
0X5DC8E85D737912F.avi,45,1321,993,328,33.03121852970796,morphological_dilation,3,2
0X5DCB0201908CB27F.avi,30,2484,2048,436,21.2890625,morphological_dilation,3,2
0X5DCB0201908CB27F.avi,46,2213,1797,416,23.149693934335,morphological_dilation,3,2
0X5DCD1D381ED8E90A.avi,72,1878,1503,375,24.9500998003992,morphological_dilation,3,2
0X5DCD1D381ED8E90A.avi,88,1098,806,292,36.22828784119106,morphological_dilation,3,2
0X5DCD6E7750BE586B.avi,103,2145,1721,424,24.63683904706566,morphological_dilation,3,2
0X5DCD6E7750BE586B.avi,120,1854,1462,392,26.812585499316004,morphological_dilation,3,2
0X5DCF5EFD375418D2.avi,31,1370,1034,336,32.495164410058024,morphological_dilation,3,2
0X5DCF5EFD375418D2.avi,42,946,654,292,44.64831804281346,morphological_dilation,3,2
0X5DD48C49365DBB71.avi,43,1657,1281,376,29.352068696330992,morphological_dilation,3,2
0X5DD48C49365DBB71.avi,66,1069,745,324,43.48993288590604,morphological_dilation,3,2
0X5DD9F952024DE8FC.avi,3,2151,1716,435,25.34965034965035,morphological_dilation,3,2
0X5DD9F952024DE8FC.avi,16,1522,1146,376,32.809773123909245,morphological_dilation,3,2
0X5DDDBEF2B4D91CD.avi,49,2836,2344,492,20.989761092150168,morphological_dilation,3,2
0X5DDDBEF2B4D91CD.avi,68,1543,1139,404,35.46971027216857,morphological_dilation,3,2
0X5DDE9E68BB099303.avi,72,1353,1023,330,32.25806451612903,morphological_dilation,3,2
0X5DDE9E68BB099303.avi,84,901,617,284,46.029173419773095,morphological_dilation,3,2
0X5DDF6E147ADCC6B9.avi,39,2043,1643,400,24.345709068776628,morphological_dilation,3,2
0X5DDF6E147ADCC6B9.avi,60,1780,1412,368,26.062322946175637,morphological_dilation,3,2
0X5DDFEF522CF8131D.avi,131,1632,1248,384,30.76923076923077,morphological_dilation,3,2
0X5DDFEF522CF8131D.avi,143,986,666,320,48.048048048048045,morphological_dilation,3,2
0X5DE1109B617C307E.avi,66,1430,1098,332,30.2367941712204,morphological_dilation,3,2
0X5DE1109B617C307E.avi,82,978,698,280,40.114613180515754,morphological_dilation,3,2
0X5DE49DD1812E0E53.avi,47,3751,3195,556,17.402190923317683,morphological_dilation,3,2
0X5DE49DD1812E0E53.avi,64,2102,1694,408,24.08500590318772,morphological_dilation,3,2
0X5DE6B657F04A3198.avi,45,2024,1608,416,25.870646766169152,morphological_dilation,3,2
0X5DE6B657F04A3198.avi,60,1272,932,340,36.48068669527897,morphological_dilation,3,2
0X5DEFDC9DAEB29CB.avi,43,1272,928,344,37.06896551724138,morphological_dilation,3,2
0X5DEFDC9DAEB29CB.avi,61,872,588,284,48.29931972789115,morphological_dilation,3,2
0X5DEFFABA480E1940.avi,95,2588,2128,460,21.616541353383457,morphological_dilation,3,2
0X5DEFFABA480E1940.avi,109,1766,1343,423,31.496649292628444,morphological_dilation,3,2
0X5DF0F473022D31E2.avi,141,3113,2601,512,19.684736639753943,morphological_dilation,3,2
0X5DF0F473022D31E2.avi,170,2793,2317,476,20.54380664652568,morphological_dilation,3,2
0X5DF2E3C335BD20EF.avi,54,1492,1136,356,31.338028169014088,morphological_dilation,3,2
0X5DF2E3C335BD20EF.avi,66,910,630,280,44.44444444444444,morphological_dilation,3,2
0X5DFC0C66C150F577.avi,87,2796,2288,508,22.202797202797203,morphological_dilation,3,2
0X5DFC0C66C150F577.avi,104,1933,1509,424,28.098078197481772,morphological_dilation,3,2
0X5E002446A11D8489.avi,53,4612,4024,588,14.612326043737575,morphological_dilation,3,2
0X5E002446A11D8489.avi,71,4319,3735,584,15.635876840696117,morphological_dilation,3,2
0X5E02AABEBE0408C5.avi,40,1266,942,324,34.394904458598724,morphological_dilation,3,2
0X5E02AABEBE0408C5.avi,56,771,487,284,58.31622176591375,morphological_dilation,3,2
0X5E0B75A0ABEBCB7E.avi,2,2145,1710,435,25.438596491228072,morphological_dilation,3,2
0X5E0B75A0ABEBCB7E.avi,25,1257,897,360,40.13377926421405,morphological_dilation,3,2
0X5E0D3394311A3DB0.avi,44,1464,1120,344,30.714285714285715,morphological_dilation,3,2
0X5E0D3394311A3DB0.avi,60,953,661,292,44.175491679273826,morphological_dilation,3,2
0X5E112030E47CF091.avi,64,1392,1056,336,31.818181818181817,morphological_dilation,3,2
0X5E112030E47CF091.avi,81,962,670,292,43.582089552238806,morphological_dilation,3,2
0X5E12E1A64B74534D.avi,103,2679,2191,488,22.272934732998632,morphological_dilation,3,2
0X5E12E1A64B74534D.avi,118,1695,1283,412,32.11223694466095,morphological_dilation,3,2
0X5E153A9644D6CB3E.avi,94,1405,1057,348,32.92336802270577,morphological_dilation,3,2
0X5E153A9644D6CB3E.avi,108,877,593,284,47.89207419898819,morphological_dilation,3,2
0X5E184CFF23C01654.avi,85,4230,3602,628,17.434758467518048,morphological_dilation,3,2
0X5E184CFF23C01654.avi,102,2656,2144,512,23.88059701492537,morphological_dilation,3,2
0X5E1A399B461F9D65.avi,102,1808,1432,376,26.256983240223462,morphological_dilation,3,2
0X5E1A399B461F9D65.avi,120,1226,902,324,35.92017738359202,morphological_dilation,3,2
0X5E1F93C96092699.avi,55,1393,1053,340,32.288698955365625,morphological_dilation,3,2
0X5E1F93C96092699.avi,75,910,623,287,46.06741573033708,morphological_dilation,3,2
0X5E212B2953D6257B.avi,37,1917,1505,412,27.375415282392023,morphological_dilation,3,2
0X5E212B2953D6257B.avi,52,1336,980,356,36.3265306122449,morphological_dilation,3,2
0X5E225B4AE218833F.avi,34,1703,1351,352,26.054774241302738,morphological_dilation,3,2
0X5E225B4AE218833F.avi,44,1395,1071,324,30.252100840336134,morphological_dilation,3,2
0X5E22DFA2350C4782.avi,85,3021,2533,488,19.26569285432294,morphological_dilation,3,2
0X5E22DFA2350C4782.avi,100,2677,2213,464,20.967013104383188,morphological_dilation,3,2
0X5E2543F97CDE7232.avi,62,1898,1494,404,27.041499330655956,morphological_dilation,3,2
0X5E2543F97CDE7232.avi,78,1383,1039,344,33.108758421559195,morphological_dilation,3,2
0X5E27995327EB7725.avi,62,1690,1298,392,30.20030816640986,morphological_dilation,3,2
0X5E27995327EB7725.avi,78,1021,685,336,49.051094890510946,morphological_dilation,3,2
0X5E287E9190871DF2.avi,44,1251,919,332,36.126224156692054,morphological_dilation,3,2
0X5E287E9190871DF2.avi,57,806,522,284,54.406130268199234,morphological_dilation,3,2
0X5E3007301B69283C.avi,102,1494,1146,348,30.36649214659686,morphological_dilation,3,2
0X5E3007301B69283C.avi,125,911,631,280,44.37400950871632,morphological_dilation,3,2
0X5E32371377E0CF89.avi,72,1398,1046,352,33.652007648183556,morphological_dilation,3,2
0X5E32371377E0CF89.avi,86,967,651,316,48.54070660522273,morphological_dilation,3,2
0X5E35565A56DAF332.avi,46,1529,1185,344,29.0295358649789,morphological_dilation,3,2
0X5E35565A56DAF332.avi,66,1045,761,284,37.319316688567675,morphological_dilation,3,2
0X5E356E0DF8F55453.avi,96,1715,1335,380,28.46441947565543,morphological_dilation,3,2
0X5E356E0DF8F55453.avi,112,1172,864,308,35.648148148148145,morphological_dilation,3,2
0X5E3788FE379B291B.avi,123,1234,890,344,38.651685393258425,morphological_dilation,3,2
0X5E3788FE379B291B.avi,142,777,509,268,52.652259332023576,morphological_dilation,3,2
0X5E3A1E160562B7E7.avi,40,1459,1103,356,32.27561196736174,morphological_dilation,3,2
0X5E3A1E160562B7E7.avi,58,849,573,276,48.167539267015705,morphological_dilation,3,2
0X5E3F73AAD75ED4BD.avi,102,2307,1875,432,23.04,morphological_dilation,3,2
0X5E3F73AAD75ED4BD.avi,119,1447,1091,356,32.630614115490374,morphological_dilation,3,2
0X5E41CFB1FB15279D.avi,35,1853,1441,412,28.591256072172104,morphological_dilation,3,2
0X5E41CFB1FB15279D.avi,47,1062,689,373,54.13642960812772,morphological_dilation,3,2
0X5E45BACF9768908A.avi,65,1643,1259,384,30.500397140587772,morphological_dilation,3,2
0X5E45BACF9768908A.avi,85,1113,793,320,40.3530895334174,morphological_dilation,3,2
0X5E46D41281E1995A.avi,2,1176,869,307,35.32796317606444,morphological_dilation,3,2
0X5E46D41281E1995A.avi,20,844,576,268,46.52777777777778,morphological_dilation,3,2
0X5E48A21DE491A78F.avi,40,2014,1598,416,26.032540675844807,morphological_dilation,3,2
0X5E48A21DE491A78F.avi,56,1542,1190,352,29.57983193277311,morphological_dilation,3,2
0X5E5177D22560685E.avi,48,1547,1191,356,29.890848026868177,morphological_dilation,3,2
0X5E5177D22560685E.avi,64,1039,731,308,42.13406292749658,morphological_dilation,3,2
0X5E5373431FA7A041.avi,0,1557,1205,352,29.211618257261414,morphological_dilation,3,2
0X5E5373431FA7A041.avi,16,1001,697,304,43.6154949784792,morphological_dilation,3,2
0X5E53F477513487D6.avi,40,1352,1020,332,32.549019607843135,morphological_dilation,3,2
0X5E53F477513487D6.avi,53,833,568,265,46.654929577464785,morphological_dilation,3,2
0X5E546A0DDFF0EDA9.avi,64,1551,1191,360,30.22670025188917,morphological_dilation,3,2
0X5E546A0DDFF0EDA9.avi,82,1032,732,300,40.98360655737705,morphological_dilation,3,2
0X5E5C9EB6814282D7.avi,43,2012,1604,408,25.43640897755611,morphological_dilation,3,2
0X5E5C9EB6814282D7.avi,60,1149,837,312,37.27598566308244,morphological_dilation,3,2
0X5E606BF217DA216C.avi,37,1775,1399,376,26.87634024303074,morphological_dilation,3,2
0X5E606BF217DA216C.avi,52,1137,827,310,37.48488512696493,morphological_dilation,3,2
0X5E641D68EBD62FAC.avi,53,1464,1112,352,31.654676258992804,morphological_dilation,3,2
0X5E641D68EBD62FAC.avi,62,847,563,284,50.44404973357016,morphological_dilation,3,2
0X5E64AA2424074480.avi,51,1289,941,348,36.98193411264612,morphological_dilation,3,2
0X5E64AA2424074480.avi,63,868,572,296,51.74825174825175,morphological_dilation,3,2
0X5E671D0F5230CA9D.avi,31,3469,2913,556,19.086852042567802,morphological_dilation,3,2
0X5E671D0F5230CA9D.avi,47,2312,1794,518,28.87402452619844,morphological_dilation,3,2
0X5E6CB8D263F993B7.avi,49,1977,1589,388,24.417872876022656,morphological_dilation,3,2
0X5E6CB8D263F993B7.avi,69,1233,925,308,33.2972972972973,morphological_dilation,3,2
0X5E6F87BD8985C7ED.avi,76,1489,1125,364,32.355555555555554,morphological_dilation,3,2
0X5E6F87BD8985C7ED.avi,87,968,641,327,51.014040561622465,morphological_dilation,3,2
0X5E712CB224C8FDD7.avi,51,2295,1843,452,24.525230602278896,morphological_dilation,3,2
0X5E712CB224C8FDD7.avi,62,1451,1087,364,33.48666053357866,morphological_dilation,3,2
0X5E741B2B92850F19.avi,76,1626,1202,424,35.27454242928453,morphological_dilation,3,2
0X5E741B2B92850F19.avi,95,1157,778,379,48.714652956298195,morphological_dilation,3,2
0X5E76ADAC714DF9D7.avi,47,1767,1364,403,29.545454545454547,morphological_dilation,3,2
0X5E76ADAC714DF9D7.avi,64,1134,767,367,47.84876140808344,morphological_dilation,3,2
0X5E77118AF4084B39.avi,101,1569,1197,372,31.07769423558897,morphological_dilation,3,2
0X5E77118AF4084B39.avi,120,1067,751,316,42.07723035952064,morphological_dilation,3,2
0X5E7924276F62CCE6.avi,57,1607,1231,376,30.544272948822094,morphological_dilation,3,2
0X5E7924276F62CCE6.avi,77,975,661,314,47.50378214826021,morphological_dilation,3,2
0X5E7A214EF0BCDF91.avi,56,1817,1437,380,26.443980514961723,morphological_dilation,3,2
0X5E7A214EF0BCDF91.avi,76,1227,911,316,34.68715697036224,morphological_dilation,3,2
0X5E7E76986E672026.avi,127,1264,932,332,35.622317596566525,morphological_dilation,3,2
0X5E7E76986E672026.avi,137,910,622,288,46.30225080385852,morphological_dilation,3,2
0X5E82DDFBC25E755A.avi,45,1257,941,316,33.58129649309245,morphological_dilation,3,2
0X5E82DDFBC25E755A.avi,63,832,564,268,47.5177304964539,morphological_dilation,3,2
0X5E857A59AF8D3FC7.avi,48,1524,1180,344,29.152542372881356,morphological_dilation,3,2
0X5E857A59AF8D3FC7.avi,65,998,710,288,40.563380281690144,morphological_dilation,3,2
0X5E8AB2A9ABFE32DE.avi,54,1257,917,340,37.07742639040349,morphological_dilation,3,2
0X5E8AB2A9ABFE32DE.avi,66,1056,740,316,42.7027027027027,morphological_dilation,3,2
0X5E9020A8FCA5DD1D.avi,0,2782,2274,508,22.33948988566403,morphological_dilation,3,2
0X5E9020A8FCA5DD1D.avi,19,1577,1191,386,32.40973971452561,morphological_dilation,3,2
0X5E9392E23CEAD967.avi,106,1836,1444,392,27.146814404432135,morphological_dilation,3,2
0X5E9392E23CEAD967.avi,114,1031,726,305,42.011019283746556,morphological_dilation,3,2
0X5E94B6F10B6B4BAF.avi,64,2093,1677,416,24.8062015503876,morphological_dilation,3,2
0X5E94B6F10B6B4BAF.avi,81,1333,997,336,33.70110330992979,morphological_dilation,3,2
0X5E9623EDC1B57949.avi,36,1540,1188,352,29.629629629629626,morphological_dilation,3,2
0X5E9623EDC1B57949.avi,61,992,685,307,44.81751824817518,morphological_dilation,3,2
0X5E98971829C12431.avi,2,1928,1520,408,26.842105263157894,morphological_dilation,3,2
0X5E98971829C12431.avi,19,1256,904,352,38.93805309734513,morphological_dilation,3,2
0X5E9AEFC0BAF4C623.avi,38,1391,1037,354,34.13693346190935,morphological_dilation,3,2
0X5E9AEFC0BAF4C623.avi,53,841,565,276,48.849557522123895,morphological_dilation,3,2
0X5E9CA0D95225A239.avi,46,2215,1787,428,23.95075545607163,morphological_dilation,3,2
0X5E9CA0D95225A239.avi,66,1614,1230,384,31.21951219512195,morphological_dilation,3,2
0X5E9CCD59BD6EDE82.avi,93,2231,1787,444,24.84611080022384,morphological_dilation,3,2
0X5E9CCD59BD6EDE82.avi,116,1446,1066,380,35.647279549718576,morphological_dilation,3,2
0X5E9D8DC455446AF2.avi,79,1716,1346,370,27.4888558692422,morphological_dilation,3,2
0X5E9D8DC455446AF2.avi,97,1038,725,313,43.172413793103445,morphological_dilation,3,2
0X5E9DE6D454196225.avi,51,1227,919,308,33.51468988030468,morphological_dilation,3,2
0X5E9DE6D454196225.avi,68,722,458,264,57.64192139737992,morphological_dilation,3,2
0X5E9E8AD35D333062.avi,32,1472,1120,352,31.428571428571427,morphological_dilation,3,2
0X5E9E8AD35D333062.avi,47,1017,721,296,41.05409153952843,morphological_dilation,3,2
0X5EA17A007042B63C.avi,25,1668,1288,380,29.503105590062113,morphological_dilation,3,2
0X5EA17A007042B63C.avi,45,1182,842,340,40.38004750593824,morphological_dilation,3,2
0X5EA2B15862C3C731.avi,80,2377,1941,436,22.46264811952602,morphological_dilation,3,2
0X5EA2B15862C3C731.avi,92,1388,1024,364,35.546875,morphological_dilation,3,2
0X5EA9017E606880F2.avi,39,2086,1678,408,24.31466030989273,morphological_dilation,3,2
0X5EA9017E606880F2.avi,54,1390,1046,344,32.88718929254302,morphological_dilation,3,2
0X5EABE6E6129D65D6.avi,33,1821,1417,404,28.510938602681723,morphological_dilation,3,2
0X5EABE6E6129D65D6.avi,48,1082,770,312,40.519480519480524,morphological_dilation,3,2
0X5EAEC188BED7D1C4.avi,83,1678,1294,384,29.675425038639876,morphological_dilation,3,2
0X5EAEC188BED7D1C4.avi,96,1085,761,324,42.57555847568988,morphological_dilation,3,2
0X5EB091B7ACE3715E.avi,34,1930,1514,416,27.476882430647294,morphological_dilation,3,2
0X5EB091B7ACE3715E.avi,52,1655,1275,380,29.80392156862745,morphological_dilation,3,2
0X5EB1538110DC1DD1.avi,46,2645,2197,448,20.391442876649975,morphological_dilation,3,2
0X5EB1538110DC1DD1.avi,66,1548,1184,364,30.743243243243246,morphological_dilation,3,2
0X5EB2063FDB36FFEA.avi,44,3074,2566,508,19.79734996102884,morphological_dilation,3,2
0X5EB2063FDB36FFEA.avi,63,1928,1508,420,27.851458885941643,morphological_dilation,3,2
0X5EB9A4515645E82F.avi,104,2006,1590,416,26.163522012578618,morphological_dilation,3,2
0X5EB9A4515645E82F.avi,122,1153,811,342,42.17016029593095,morphological_dilation,3,2
0X5EBAF494862BBD3A.avi,99,1302,974,328,33.67556468172484,morphological_dilation,3,2
0X5EBAF494862BBD3A.avi,111,862,574,288,50.174216027874564,morphological_dilation,3,2
0X5EBEECA55C0C6874.avi,83,1334,1010,324,32.07920792079208,morphological_dilation,3,2
0X5EBEECA55C0C6874.avi,93,821,538,283,52.60223048327137,morphological_dilation,3,2
0X5EBF4BEB0CB630A3.avi,31,1804,1412,392,27.762039660056658,morphological_dilation,3,2
0X5EBF4BEB0CB630A3.avi,44,1075,763,312,40.89121887287025,morphological_dilation,3,2
0X5EC277F47019A41.avi,49,1454,1106,348,31.464737793851715,morphological_dilation,3,2
0X5EC277F47019A41.avi,68,1038,687,351,51.09170305676856,morphological_dilation,3,2
0X5EC2E237164BE880.avi,53,1492,1144,348,30.419580419580424,morphological_dilation,3,2
0X5EC2E237164BE880.avi,65,1036,748,288,38.50267379679144,morphological_dilation,3,2
0X5EC4ED845000D86B.avi,2,2806,2294,512,22.319093286835223,morphological_dilation,3,2
0X5EC4ED845000D86B.avi,19,1945,1509,436,28.893306825712394,morphological_dilation,3,2
0X5EC7168075AF1BA4.avi,77,2174,1722,452,26.24854819976771,morphological_dilation,3,2
0X5EC7168075AF1BA4.avi,94,1592,1193,399,33.44509639564124,morphological_dilation,3,2
0X5EC8EAD631405070.avi,35,1145,843,302,35.82443653618031,morphological_dilation,3,2
0X5EC8EAD631405070.avi,52,748,474,274,57.80590717299579,morphological_dilation,3,2
0X5ECD55B830580E47.avi,95,1486,1138,348,30.579964850615116,morphological_dilation,3,2
0X5ECD55B830580E47.avi,111,857,581,276,47.50430292598967,morphological_dilation,3,2
0X5ECF73A4906CB2BB.avi,65,1171,859,312,36.32130384167637,morphological_dilation,3,2
0X5ECF73A4906CB2BB.avi,80,695,451,244,54.1019955654102,morphological_dilation,3,2
0X5ED20CE22B61EEB.avi,0,3941,3393,548,16.150898909519597,morphological_dilation,3,2
0X5ED20CE22B61EEB.avi,16,3506,2990,516,17.25752508361204,morphological_dilation,3,2
0X5ED542F7582888B9.avi,33,2229,1765,464,26.288951841359776,morphological_dilation,3,2
0X5ED542F7582888B9.avi,45,1211,756,455,60.18518518518518,morphological_dilation,3,2
0X5ED71DED6F063F9D.avi,28,1933,1549,384,24.790187217559716,morphological_dilation,3,2
0X5ED71DED6F063F9D.avi,37,1443,1117,326,29.185317815577438,morphological_dilation,3,2
0X5ED7410527085C8A.avi,29,1815,1431,384,26.834381551362686,morphological_dilation,3,2
0X5ED7410527085C8A.avi,42,1185,857,328,38.2730455075846,morphological_dilation,3,2
0X5ED7D8B4C5E04559.avi,0,1754,1366,388,28.40409956076135,morphological_dilation,3,2
0X5ED7D8B4C5E04559.avi,20,1064,741,323,43.58974358974359,morphological_dilation,3,2
0X5EDDEA1B2AB83813.avi,47,1011,715,296,41.3986013986014,morphological_dilation,3,2
0X5EDDEA1B2AB83813.avi,63,664,408,256,62.745098039215684,morphological_dilation,3,2
0X5EDF35043B9394FB.avi,36,2094,1682,412,24.494649227110582,morphological_dilation,3,2
0X5EDF35043B9394FB.avi,50,1329,993,336,33.8368580060423,morphological_dilation,3,2
0X5EE2390AFEA958E7.avi,86,2440,1968,472,23.983739837398375,morphological_dilation,3,2
0X5EE2390AFEA958E7.avi,113,1599,1191,408,34.25692695214106,morphological_dilation,3,2
0X5EE2857858E0E31E.avi,36,1882,1498,384,25.634178905206944,morphological_dilation,3,2
0X5EE2857858E0E31E.avi,54,1153,841,312,37.098692033293695,morphological_dilation,3,2
0X5EE96AA34060E43F.avi,154,2292,1860,432,23.225806451612904,morphological_dilation,3,2
0X5EE96AA34060E43F.avi,171,1934,1554,380,24.45302445302445,morphological_dilation,3,2
0X5EED7E17AC927985.avi,111,2415,1975,440,22.278481012658226,morphological_dilation,3,2
0X5EED7E17AC927985.avi,127,1821,1429,392,27.43177046885934,morphological_dilation,3,2
0X5EF3AA26F477E5F0.avi,68,1605,1229,376,30.5939788445891,morphological_dilation,3,2
0X5EF3AA26F477E5F0.avi,84,946,654,292,44.64831804281346,morphological_dilation,3,2
0X5EF5ECDC62D658E3.avi,167,2448,1988,460,23.138832997987926,morphological_dilation,3,2
0X5EF5ECDC62D658E3.avi,184,1541,1157,384,33.18928262748487,morphological_dilation,3,2
0X5F0602402478B90A.avi,103,2058,1646,412,25.03037667071689,morphological_dilation,3,2
0X5F0602402478B90A.avi,118,1528,1152,376,32.63888888888889,morphological_dilation,3,2
0X5F079E27A83C0B8.avi,41,2353,1901,452,23.776959495002632,morphological_dilation,3,2
0X5F079E27A83C0B8.avi,58,1638,1270,368,28.976377952755904,morphological_dilation,3,2
0X5F0D24B258388D8A.avi,1,1960,1556,404,25.96401028277635,morphological_dilation,3,2
0X5F0D24B258388D8A.avi,16,1127,811,316,38.964241676942045,morphological_dilation,3,2
0X5F0E22A55AB2E76A.avi,35,2566,2122,444,20.923656927426958,morphological_dilation,3,2
0X5F0E22A55AB2E76A.avi,46,1738,1362,376,27.606461086637296,morphological_dilation,3,2
0X5F1003C57B850AB3.avi,87,1915,1515,400,26.4026402640264,morphological_dilation,3,2
0X5F1003C57B850AB3.avi,101,1282,942,340,36.09341825902335,morphological_dilation,3,2
0X5F12F829DE9997AD.avi,4,1479,1131,348,30.76923076923077,morphological_dilation,3,2
0X5F12F829DE9997AD.avi,16,996,704,292,41.47727272727273,morphological_dilation,3,2
0X5F1EC9AD081BBF4B.avi,45,1572,1208,364,30.132450331125828,morphological_dilation,3,2
0X5F1EC9AD081BBF4B.avi,62,998,695,303,43.597122302158276,morphological_dilation,3,2
0X5F1F624CC0B3FE23.avi,44,1944,1532,412,26.89295039164491,morphological_dilation,3,2
0X5F1F624CC0B3FE23.avi,64,1221,905,316,34.91712707182321,morphological_dilation,3,2
0X5F20AE1435A6B695.avi,2,1667,1299,368,28.329484218629712,morphological_dilation,3,2
0X5F20AE1435A6B695.avi,13,992,692,300,43.35260115606936,morphological_dilation,3,2
0X5F2D3F92EECFA8D5.avi,55,1492,1132,360,31.802120141342755,morphological_dilation,3,2
0X5F2D3F92EECFA8D5.avi,71,884,612,272,44.44444444444444,morphological_dilation,3,2
0X5F2E4B2D0CB4142D.avi,43,1190,878,312,35.53530751708428,morphological_dilation,3,2
0X5F2E4B2D0CB4142D.avi,58,761,505,256,50.693069306930695,morphological_dilation,3,2
0X5F2ECBF007EA81FC.avi,41,1855,1459,396,27.141877998629198,morphological_dilation,3,2
0X5F2ECBF007EA81FC.avi,61,1331,987,344,34.853090172239106,morphological_dilation,3,2
0X5F32DC0F9F9F9792.avi,73,2419,1983,436,21.986888552697934,morphological_dilation,3,2
0X5F32DC0F9F9F9792.avi,93,1560,1192,368,30.87248322147651,morphological_dilation,3,2
0X5F34377891ED32EA.avi,71,2242,1818,424,23.32233223322332,morphological_dilation,3,2
0X5F34377891ED32EA.avi,83,1476,1132,344,30.3886925795053,morphological_dilation,3,2
0X5F353F8436745263.avi,58,1941,1521,420,27.613412228796847,morphological_dilation,3,2
0X5F353F8436745263.avi,79,1201,853,348,40.79718640093787,morphological_dilation,3,2
0X5F39CB85ADCAA00A.avi,93,1226,902,324,35.92017738359202,morphological_dilation,3,2
0X5F39CB85ADCAA00A.avi,111,744,500,244,48.8,morphological_dilation,3,2
0X5F39D3F256239FE7.avi,69,1811,1427,384,26.90960056061668,morphological_dilation,3,2
0X5F39D3F256239FE7.avi,86,1153,841,312,37.098692033293695,morphological_dilation,3,2
0X5F39F03B6B113B95.avi,88,1792,1420,372,26.197183098591548,morphological_dilation,3,2
0X5F39F03B6B113B95.avi,106,1065,769,296,38.491547464239275,morphological_dilation,3,2
0X5F3B72BA85B714EA.avi,159,1878,1490,388,26.040268456375838,morphological_dilation,3,2
0X5F3B72BA85B714EA.avi,181,1117,813,304,37.392373923739235,morphological_dilation,3,2
0X5F3D04F591FED07C.avi,44,1692,1312,380,28.96341463414634,morphological_dilation,3,2
0X5F3D04F591FED07C.avi,61,1083,771,312,40.46692607003891,morphological_dilation,3,2
0X5F3F5EAB6FBC7672.avi,61,2672,2182,490,22.45646196150321,morphological_dilation,3,2
0X5F3F5EAB6FBC7672.avi,80,1740,1316,424,32.21884498480243,morphological_dilation,3,2
0X5F40FC2C2367EA92.avi,0,2877,2401,476,19.825072886297377,morphological_dilation,3,2
0X5F40FC2C2367EA92.avi,19,1784,1408,376,26.704545454545453,morphological_dilation,3,2
0X5F4167C2888CCA6E.avi,44,2266,1818,448,24.64246424642464,morphological_dilation,3,2
0X5F4167C2888CCA6E.avi,59,1690,1285,405,31.517509727626457,morphological_dilation,3,2
0X5F41E6D608B38A9.avi,35,1675,1295,380,29.343629343629345,morphological_dilation,3,2
0X5F41E6D608B38A9.avi,49,939,635,304,47.874015748031496,morphological_dilation,3,2
0X5F42C272ABD66AE4.avi,86,2004,1592,412,25.879396984924625,morphological_dilation,3,2
0X5F42C272ABD66AE4.avi,106,1462,1095,367,33.51598173515982,morphological_dilation,3,2
0X5F4816B7130382CE.avi,127,2568,2076,492,23.699421965317917,morphological_dilation,3,2
0X5F4816B7130382CE.avi,145,1617,1193,424,35.5406538139145,morphological_dilation,3,2
0X5F48AC99F9E2CD25.avi,39,1623,1239,384,30.99273607748184,morphological_dilation,3,2
0X5F48AC99F9E2CD25.avi,53,954,645,309,47.906976744186046,morphological_dilation,3,2
0X5F4A6C5D0B52CB1D.avi,32,1362,1030,332,32.23300970873787,morphological_dilation,3,2
0X5F4A6C5D0B52CB1D.avi,48,1026,726,300,41.32231404958678,morphological_dilation,3,2
0X5F4B5FB16CE96C06.avi,90,2436,1976,460,23.279352226720647,morphological_dilation,3,2
0X5F4B5FB16CE96C06.avi,99,1509,1117,392,35.09400179051029,morphological_dilation,3,2
0X5F4C295A8969E33F.avi,0,1744,1360,384,28.235294117647058,morphological_dilation,3,2
0X5F4C295A8969E33F.avi,18,1236,912,324,35.526315789473685,morphological_dilation,3,2
0X5F531849D180DED2.avi,77,1909,1517,392,25.84047462096243,morphological_dilation,3,2
0X5F531849D180DED2.avi,93,1117,793,324,40.85750315258512,morphological_dilation,3,2
0X5F5640713F873F54.avi,39,1591,1215,376,30.946502057613166,morphological_dilation,3,2
0X5F5640713F873F54.avi,55,949,653,296,45.3292496171516,morphological_dilation,3,2
0X5F5765C5B693F91D.avi,35,1824,1422,402,28.270042194092827,morphological_dilation,3,2
0X5F5765C5B693F91D.avi,49,1103,778,325,41.77377892030849,morphological_dilation,3,2
0X5F590C7F893948D1.avi,110,1923,1500,423,28.199999999999996,morphological_dilation,3,2
0X5F590C7F893948D1.avi,124,1237,885,352,39.77401129943503,morphological_dilation,3,2
0X5F592AA5BA91F733.avi,51,2580,2109,471,22.33285917496444,morphological_dilation,3,2
0X5F592AA5BA91F733.avi,65,1514,1126,388,34.4582593250444,morphological_dilation,3,2
0X5F599F607D804C81.avi,81,2269,1849,420,22.71498107084911,morphological_dilation,3,2
0X5F599F607D804C81.avi,98,1441,1097,344,31.358249772105744,morphological_dilation,3,2
0X5F5B9F5A80414884.avi,42,3175,2647,528,19.94710993577635,morphological_dilation,3,2
0X5F5B9F5A80414884.avi,57,2143,1689,454,26.87981053878034,morphological_dilation,3,2
0X5F5C118F20590038.avi,0,2056,1632,424,25.98039215686275,morphological_dilation,3,2
0X5F5C118F20590038.avi,27,1176,848,328,38.67924528301887,morphological_dilation,3,2
0X5F5C26021613D05C.avi,81,2290,1882,408,21.679064824654624,morphological_dilation,3,2
0X5F5C26021613D05C.avi,99,1384,1056,328,31.060606060606062,morphological_dilation,3,2
0X5F5E8594B9028EFE.avi,59,1742,1358,384,28.276877761413843,morphological_dilation,3,2
0X5F5E8594B9028EFE.avi,79,1043,727,316,43.46629986244842,morphological_dilation,3,2
0X5F60579417AF2B21.avi,69,1890,1464,426,29.098360655737704,morphological_dilation,3,2
0X5F60579417AF2B21.avi,79,1695,1286,409,31.804043545878695,morphological_dilation,3,2
0X5F6521B0A37F45B0.avi,76,2600,2120,480,22.641509433962266,morphological_dilation,3,2
0X5F6521B0A37F45B0.avi,92,1528,1148,380,33.10104529616725,morphological_dilation,3,2
0X5F69BF2FA33746C8.avi,50,1207,891,316,35.46576879910213,morphological_dilation,3,2
0X5F69BF2FA33746C8.avi,67,786,510,276,54.11764705882353,morphological_dilation,3,2
0X5F6DFF1FFF8D2BFE.avi,32,1401,1053,348,33.04843304843305,morphological_dilation,3,2
0X5F6DFF1FFF8D2BFE.avi,51,840,551,289,52.45009074410163,morphological_dilation,3,2
0X5F6F8D308353F7CE.avi,60,1793,1405,388,27.615658362989326,morphological_dilation,3,2
0X5F6F8D308353F7CE.avi,78,1267,931,336,36.09022556390977,morphological_dilation,3,2
0X5F72A5975CB4B31E.avi,73,2014,1607,407,25.326695706285,morphological_dilation,3,2
0X5F72A5975CB4B31E.avi,93,1141,829,312,37.635705669481304,morphological_dilation,3,2
0X5F79069BED47E4C6.avi,119,1522,1170,352,30.085470085470085,morphological_dilation,3,2
0X5F79069BED47E4C6.avi,134,1101,755,346,45.82781456953642,morphological_dilation,3,2
0X5F7A3F7ECEF71001.avi,52,1881,1501,380,25.31645569620253,morphological_dilation,3,2
0X5F7A3F7ECEF71001.avi,68,1422,1078,344,31.910946196660483,morphological_dilation,3,2
0X5F7AB9B7BAD4A939.avi,45,1289,957,332,34.69174503657263,morphological_dilation,3,2
0X5F7AB9B7BAD4A939.avi,60,794,522,272,52.10727969348659,morphological_dilation,3,2
0X5F7F7043D608F24B.avi,81,2553,2089,464,22.21158449018669,morphological_dilation,3,2
0X5F7F7043D608F24B.avi,97,1701,1309,392,29.946524064171122,morphological_dilation,3,2
0X5F82B5955E52718.avi,103,1466,1098,368,33.51548269581057,morphological_dilation,3,2
0X5F82B5955E52718.avi,117,1075,735,340,46.25850340136054,morphological_dilation,3,2
0X5F8388DE6166AD27.avi,1,1653,1297,356,27.44795682343871,morphological_dilation,3,2
0X5F8388DE6166AD27.avi,26,1019,731,288,39.398084815321475,morphological_dilation,3,2
0X5F8AF2961E9475B3.avi,36,1587,1187,400,33.69839932603201,morphological_dilation,3,2
0X5F8AF2961E9475B3.avi,53,1039,696,343,49.2816091954023,morphological_dilation,3,2
0X5F8C726D21FDA787.avi,39,2070,1634,436,26.682986536107713,morphological_dilation,3,2
0X5F8C726D21FDA787.avi,59,1226,874,352,40.274599542334094,morphological_dilation,3,2
0X5F8FAC42E57B94CD.avi,74,1097,789,308,39.036755386565275,morphological_dilation,3,2
0X5F8FAC42E57B94CD.avi,94,705,434,271,62.44239631336406,morphological_dilation,3,2
0X5F904F6B8EF34899.avi,48,1423,1095,328,29.954337899543376,morphological_dilation,3,2
0X5F904F6B8EF34899.avi,63,1095,806,289,35.8560794044665,morphological_dilation,3,2
0X5F905B70EFA3CB8F.avi,82,2822,2334,488,20.908311910882603,morphological_dilation,3,2
0X5F905B70EFA3CB8F.avi,99,1718,1310,408,31.14503816793893,morphological_dilation,3,2
0X5F91AE0375EB306B.avi,48,2267,1785,482,27.00280112044818,morphological_dilation,3,2
0X5F91AE0375EB306B.avi,64,1334,943,391,41.46341463414634,morphological_dilation,3,2
0X5F9248C06FAC691F.avi,61,1766,1406,360,25.604551920341397,morphological_dilation,3,2
0X5F9248C06FAC691F.avi,77,1239,925,314,33.945945945945944,morphological_dilation,3,2
0X5F92648A23C26089.avi,32,1712,1300,412,31.692307692307693,morphological_dilation,3,2
0X5F92648A23C26089.avi,47,1162,794,368,46.34760705289673,morphological_dilation,3,2
0X5F92B35F19F2778C.avi,1,2030,1610,420,26.08695652173913,morphological_dilation,3,2
0X5F92B35F19F2778C.avi,21,1142,810,332,40.98765432098765,morphological_dilation,3,2
0X5F9A892A7F5222F4.avi,133,1427,1079,348,32.252085264133456,morphological_dilation,3,2
0X5F9A892A7F5222F4.avi,148,859,591,268,45.346869712351946,morphological_dilation,3,2
0X5F9B39788332C852.avi,153,1240,908,332,36.56387665198238,morphological_dilation,3,2
0X5F9B39788332C852.avi,160,783,511,272,53.22896281800391,morphological_dilation,3,2
0X5F9DA73AAF7E7428.avi,37,1755,1391,364,26.168224299065418,morphological_dilation,3,2
0X5F9DA73AAF7E7428.avi,48,1497,1161,336,28.940568475452196,morphological_dilation,3,2
0X5F9E72417A7A94D9.avi,70,1882,1498,384,25.634178905206944,morphological_dilation,3,2
0X5F9E72417A7A94D9.avi,93,1141,825,316,38.303030303030305,morphological_dilation,3,2
0X5FA0D09981EB84F1.avi,94,2264,1832,432,23.580786026200872,morphological_dilation,3,2
0X5FA0D09981EB84F1.avi,110,1439,1079,360,33.364226135310474,morphological_dilation,3,2
0X5FA3A479D0505A61.avi,39,1619,1247,372,29.83159582999198,morphological_dilation,3,2
0X5FA3A479D0505A61.avi,55,1255,923,332,35.969664138678226,morphological_dilation,3,2
0X5FA790083ACE0F7F.avi,152,1561,1181,380,32.17612193056731,morphological_dilation,3,2
0X5FA790083ACE0F7F.avi,171,1181,832,349,41.94711538461539,morphological_dilation,3,2
0X5FAFD4377E381228.avi,3,1377,1025,352,34.34146341463415,morphological_dilation,3,2
0X5FAFD4377E381228.avi,14,832,544,288,52.94117647058824,morphological_dilation,3,2
0X5FB48001BCDB3E0.avi,44,1573,1213,360,29.67848309975268,morphological_dilation,3,2
0X5FB48001BCDB3E0.avi,60,994,698,296,42.40687679083094,morphological_dilation,3,2
0X5FB52EE24AD4E07C.avi,48,2925,2449,476,19.436504695794202,morphological_dilation,3,2
0X5FB52EE24AD4E07C.avi,65,2564,2120,444,20.943396226415096,morphological_dilation,3,2
0X5FBA39712E8BCEA6.avi,2,2172,1732,440,25.40415704387991,morphological_dilation,3,2
0X5FBA39712E8BCEA6.avi,16,1290,954,336,35.22012578616352,morphological_dilation,3,2
0X5FBBC76F7AD9FB4D.avi,75,2607,2147,460,21.425244527247322,morphological_dilation,3,2
0X5FBBC76F7AD9FB4D.avi,92,1503,1127,376,33.36291038154392,morphological_dilation,3,2
0X5FBC73FCF4098545.avi,130,1923,1523,400,26.263952724885097,morphological_dilation,3,2
0X5FBC73FCF4098545.avi,148,1146,826,320,38.7409200968523,morphological_dilation,3,2
0X5FBE580FA447E32F.avi,50,1167,859,308,35.85564610011641,morphological_dilation,3,2
0X5FBE580FA447E32F.avi,70,733,477,256,53.66876310272537,morphological_dilation,3,2
0X5FBF7F1AFD7D17DE.avi,153,1834,1426,408,28.611500701262273,morphological_dilation,3,2
0X5FBF7F1AFD7D17DE.avi,161,1074,750,324,43.2,morphological_dilation,3,2
0X5FC40E07B2195664.avi,2,2243,1799,444,24.680377987770985,morphological_dilation,3,2
0X5FC40E07B2195664.avi,19,1591,1223,368,30.08994276369583,morphological_dilation,3,2
0X5FC7EA9FAD9F2429.avi,72,1184,880,304,34.54545454545455,morphological_dilation,3,2
0X5FC7EA9FAD9F2429.avi,88,874,601,273,45.4242928452579,morphological_dilation,3,2
0X5FC9BFA75DBC770F.avi,125,2868,2360,508,21.525423728813557,morphological_dilation,3,2
0X5FC9BFA75DBC770F.avi,141,2071,1631,440,26.977314530962598,morphological_dilation,3,2
0X5FCC240D997BA3BC.avi,58,1112,812,300,36.94581280788177,morphological_dilation,3,2
0X5FCC240D997BA3BC.avi,71,678,438,240,54.794520547945204,morphological_dilation,3,2
0X5FCD756AC42FC6.avi,81,2090,1654,436,26.360338573155985,morphological_dilation,3,2
0X5FCD756AC42FC6.avi,104,1325,973,352,36.17677286742035,morphological_dilation,3,2
0X5FCE4BD2E5E26851.avi,125,1805,1445,360,24.91349480968858,morphological_dilation,3,2
0X5FCE4BD2E5E26851.avi,137,1677,1321,356,26.949280847842545,morphological_dilation,3,2
0X5FCFF589A81B4B5E.avi,0,2209,1785,424,23.75350140056022,morphological_dilation,3,2
0X5FCFF589A81B4B5E.avi,18,1618,1266,352,27.804107424960506,morphological_dilation,3,2
0X5FD2001CD8BCA24A.avi,93,2114,1694,420,24.793388429752067,morphological_dilation,3,2
0X5FD2001CD8BCA24A.avi,107,1342,998,344,34.46893787575151,morphological_dilation,3,2
0X5FD48AFE4017BCC.avi,35,2867,2375,492,20.71578947368421,morphological_dilation,3,2
0X5FD48AFE4017BCC.avi,73,1730,1334,396,29.685157421289354,morphological_dilation,3,2
0X5FD68F47AE2AA638.avi,115,1992,1572,420,26.717557251908396,morphological_dilation,3,2
0X5FD68F47AE2AA638.avi,134,1253,909,344,37.843784378437846,morphological_dilation,3,2
0X5FD81C7210683832.avi,60,1029,733,296,40.381991814461124,morphological_dilation,3,2
0X5FD81C7210683832.avi,73,726,440,286,65.0,morphological_dilation,3,2
0X5FD94B2F57CB25FB.avi,107,1951,1486,465,31.292059219380885,morphological_dilation,3,2
0X5FD94B2F57CB25FB.avi,125,1059,682,377,55.278592375366564,morphological_dilation,3,2
0X5FDA14C54E57DB3E.avi,104,1555,1203,352,29.260182876142977,morphological_dilation,3,2
0X5FDA14C54E57DB3E.avi,120,1222,918,304,33.11546840958606,morphological_dilation,3,2
0X5FDC113292CB6B3C.avi,40,1265,933,332,35.58413719185423,morphological_dilation,3,2
0X5FDC113292CB6B3C.avi,54,861,569,292,51.31810193321616,morphological_dilation,3,2
0X5FDCAAC518A41715.avi,47,2517,2037,480,23.5640648011782,morphological_dilation,3,2
0X5FDCAAC518A41715.avi,63,1623,1211,412,34.02146985962015,morphological_dilation,3,2
0X5FE2CC293BF88CCD.avi,60,1921,1507,414,27.471798274717983,morphological_dilation,3,2
0X5FE2CC293BF88CCD.avi,71,1581,1162,419,36.05851979345955,morphological_dilation,3,2
0X5FE3EB348D80C6BE.avi,72,2121,1701,420,24.691358024691358,morphological_dilation,3,2
0X5FE3EB348D80C6BE.avi,92,1326,982,344,35.03054989816701,morphological_dilation,3,2
0X5FE4D902A22D3041.avi,56,2814,2311,503,21.765469493725657,morphological_dilation,3,2
0X5FE4D902A22D3041.avi,72,1543,1159,384,33.13201035375323,morphological_dilation,3,2
0X5FE6439A0CCEF482.avi,3,2369,1933,436,22.55561303673047,morphological_dilation,3,2
0X5FE6439A0CCEF482.avi,30,2151,1739,412,23.691776883266243,morphological_dilation,3,2
0X5FE8732DE9D96FD5.avi,112,2791,2311,480,20.77022933794894,morphological_dilation,3,2
0X5FE8732DE9D96FD5.avi,126,2036,1628,408,25.061425061425062,morphological_dilation,3,2
0X5FEDCE3F39D06328.avi,101,1619,1244,375,30.144694533762056,morphological_dilation,3,2
0X5FEDCE3F39D06328.avi,117,1029,717,312,43.51464435146444,morphological_dilation,3,2
0X5FF1487741A82553.avi,27,1551,1191,360,30.22670025188917,morphological_dilation,3,2
0X5FF1487741A82553.avi,38,865,565,300,53.09734513274337,morphological_dilation,3,2
0X5FF75E97ECDC71E8.avi,64,1355,1023,332,32.453567937438905,morphological_dilation,3,2
0X5FF75E97ECDC71E8.avi,76,866,598,268,44.81605351170568,morphological_dilation,3,2
0X5FF8D238E3A43BA9.avi,84,2855,2383,472,19.80696600923206,morphological_dilation,3,2
0X5FF8D238E3A43BA9.avi,106,2571,2123,448,21.10221384832784,morphological_dilation,3,2
0X5FFEB2AD9B3A5E25.avi,85,1560,1200,360,30.0,morphological_dilation,3,2
0X5FFEB2AD9B3A5E25.avi,100,871,595,276,46.38655462184874,morphological_dilation,3,2
0X6000435AE572F06C.avi,55,1824,1440,384,26.666666666666668,morphological_dilation,3,2
0X6000435AE572F06C.avi,71,1252,916,336,36.681222707423586,morphological_dilation,3,2
0X60028DC7A7F31CE3.avi,41,1243,915,328,35.84699453551913,morphological_dilation,3,2
0X60028DC7A7F31CE3.avi,56,791,522,269,51.53256704980843,morphological_dilation,3,2
0X6004FEA607F2EB9C.avi,135,1202,898,304,33.85300668151447,morphological_dilation,3,2
0X6004FEA607F2EB9C.avi,146,791,527,264,50.094876660341555,morphological_dilation,3,2
0X6008D258A5B5E73.avi,55,3255,2755,500,18.148820326678766,morphological_dilation,3,2
0X6008D258A5B5E73.avi,77,2044,1632,412,25.245098039215684,morphological_dilation,3,2
0X600BBB200766F979.avi,50,1518,1174,344,29.3015332197615,morphological_dilation,3,2
0X600BBB200766F979.avi,70,989,706,283,40.084985835694056,morphological_dilation,3,2
0X600FA3ECBB488EAC.avi,43,1569,1201,368,30.641132389675267,morphological_dilation,3,2
0X600FA3ECBB488EAC.avi,60,1006,714,292,40.896358543417364,morphological_dilation,3,2
0X60121B222FC4B4C4.avi,141,1793,1405,388,27.615658362989326,morphological_dilation,3,2
0X60121B222FC4B4C4.avi,160,1167,814,353,43.36609336609337,morphological_dilation,3,2
0X601A0FE2BA2F9F68.avi,45,1702,1318,384,29.1350531107739,morphological_dilation,3,2
0X601A0FE2BA2F9F68.avi,62,1384,1032,352,34.10852713178294,morphological_dilation,3,2
0X601B706CC84025BD.avi,68,2218,1774,444,25.02818489289741,morphological_dilation,3,2
0X601B706CC84025BD.avi,88,1596,1184,412,34.7972972972973,morphological_dilation,3,2
0X602005216EB0FAB3.avi,3,1817,1438,379,26.35605006954103,morphological_dilation,3,2
0X602005216EB0FAB3.avi,20,1098,794,304,38.287153652392945,morphological_dilation,3,2
0X6020D0C5C256684D.avi,43,1447,1095,352,32.146118721461185,morphological_dilation,3,2
0X6020D0C5C256684D.avi,58,948,644,304,47.20496894409938,morphological_dilation,3,2
0X602148BCD6E57281.avi,204,1489,1141,348,30.499561787905343,morphological_dilation,3,2
0X602148BCD6E57281.avi,219,1039,727,312,42.91609353507565,morphological_dilation,3,2
0X6022F9F42D2E8E06.avi,82,2007,1603,404,25.202744853399878,morphological_dilation,3,2
0X6022F9F42D2E8E06.avi,104,1168,840,328,39.04761904761905,morphological_dilation,3,2
0X60232C8C3F8E33D5.avi,2,2633,2133,500,23.441162681669013,morphological_dilation,3,2
0X60232C8C3F8E33D5.avi,15,1492,1104,388,35.14492753623188,morphological_dilation,3,2
0X602624BAE73DF1D0.avi,116,1625,1261,364,28.865979381443296,morphological_dilation,3,2
0X602624BAE73DF1D0.avi,128,1034,726,308,42.42424242424242,morphological_dilation,3,2
0X6029ADEDDBD5A8E7.avi,0,1517,1149,368,32.02785030461271,morphological_dilation,3,2
0X6029ADEDDBD5A8E7.avi,12,940,652,288,44.171779141104295,morphological_dilation,3,2
0X602B5FA15C1B1391.avi,68,2528,2056,472,22.957198443579767,morphological_dilation,3,2
0X602B5FA15C1B1391.avi,93,1712,1300,412,31.692307692307693,morphological_dilation,3,2
0X602DD210408CBD35.avi,37,1481,1121,360,32.114183764495984,morphological_dilation,3,2
0X602DD210408CBD35.avi,54,1013,701,312,44.50784593437946,morphological_dilation,3,2
0X60300FD6116E3023.avi,81,1364,1056,308,29.166666666666668,morphological_dilation,3,2
0X60300FD6116E3023.avi,98,1014,730,284,38.9041095890411,morphological_dilation,3,2
0X603072212882EC57.avi,171,1655,1287,368,28.593628593628594,morphological_dilation,3,2
0X603072212882EC57.avi,190,1022,722,300,41.55124653739612,morphological_dilation,3,2
0X603265F67987D61.avi,37,1355,1023,332,32.453567937438905,morphological_dilation,3,2
0X603265F67987D61.avi,51,866,586,280,47.781569965870304,morphological_dilation,3,2
0X6034BDAD7FE51795.avi,0,1574,1222,352,28.805237315875615,morphological_dilation,3,2
0X6034BDAD7FE51795.avi,22,1058,762,296,38.84514435695538,morphological_dilation,3,2
0X60361B7F301DEBB7.avi,48,1687,1320,367,27.8030303030303,morphological_dilation,3,2
0X60361B7F301DEBB7.avi,65,982,682,300,43.988269794721404,morphological_dilation,3,2
0X6037105349598904.avi,15,1264,948,316,33.33333333333333,morphological_dilation,3,2
0X6037105349598904.avi,31,962,661,301,45.53706505295008,morphological_dilation,3,2
0X603C4DE06BAD2DE.avi,90,1675,1319,356,26.990144048521607,morphological_dilation,3,2
0X603C4DE06BAD2DE.avi,110,1093,797,296,37.13927227101631,morphological_dilation,3,2
0X60419B3EB3939EF0.avi,99,2174,1726,448,25.955967555040555,morphological_dilation,3,2
0X60419B3EB3939EF0.avi,122,1429,1085,344,31.70506912442396,morphological_dilation,3,2
0X6043DEDF42873A99.avi,83,2785,2301,484,21.034332898739677,morphological_dilation,3,2
0X6043DEDF42873A99.avi,95,1761,1357,404,29.771554900515845,morphological_dilation,3,2
0X604740AA1AC8E769.avi,59,2063,1659,404,24.35201928872815,morphological_dilation,3,2
0X604740AA1AC8E769.avi,78,1373,1021,352,34.476003917727716,morphological_dilation,3,2
0X6047605B3F7507A9.avi,58,1640,1288,352,27.32919254658385,morphological_dilation,3,2
0X6047605B3F7507A9.avi,71,1124,816,308,37.745098039215684,morphological_dilation,3,2
0X60478355C2E0BB48.avi,45,1483,1147,336,29.293809938971226,morphological_dilation,3,2
0X60478355C2E0BB48.avi,57,954,678,276,40.707964601769916,morphological_dilation,3,2
0X6047BEFB56F3FBA8.avi,39,1594,1226,368,30.0163132137031,morphological_dilation,3,2
0X6047BEFB56F3FBA8.avi,56,907,599,308,51.41903171953256,morphological_dilation,3,2
0X604F9762C755B48A.avi,31,1919,1507,412,27.33908427339084,morphological_dilation,3,2
0X604F9762C755B48A.avi,47,1295,939,356,37.912673056443026,morphological_dilation,3,2
0X6050E603BC35F0D.avi,121,1266,950,316,33.26315789473684,morphological_dilation,3,2
0X6050E603BC35F0D.avi,125,1274,872,402,46.10091743119266,morphological_dilation,3,2
0X6052BE44A33ADDFE.avi,69,1866,1475,391,26.508474576271183,morphological_dilation,3,2
0X6052BE44A33ADDFE.avi,86,1381,1057,324,30.65279091769158,morphological_dilation,3,2
0X605383A20B7C658F.avi,114,1346,1026,320,31.189083820662766,morphological_dilation,3,2
0X605383A20B7C658F.avi,128,927,647,280,43.27666151468315,morphological_dilation,3,2
0X605AAC45ACC879B4.avi,4,1535,1195,340,28.451882845188287,morphological_dilation,3,2
0X605AAC45ACC879B4.avi,17,1193,883,310,35.107587768969424,morphological_dilation,3,2
0X60616EC56172D3AE.avi,76,1570,1182,388,32.82571912013537,morphological_dilation,3,2
0X60616EC56172D3AE.avi,92,1014,690,324,46.95652173913044,morphological_dilation,3,2
0X6062D547329B34C8.avi,45,2046,1650,396,24.0,morphological_dilation,3,2
0X6062D547329B34C8.avi,66,1485,1149,336,29.242819843342037,morphological_dilation,3,2
0X60649A42C11E721B.avi,88,1151,835,316,37.84431137724551,morphological_dilation,3,2
0X60649A42C11E721B.avi,101,611,379,232,61.21372031662269,morphological_dilation,3,2
0X606543C2636A46F9.avi,0,1168,836,332,39.71291866028708,morphological_dilation,3,2
0X606543C2636A46F9.avi,11,740,472,268,56.779661016949156,morphological_dilation,3,2
0X6066F7CF79AD6EA2.avi,52,2099,1667,432,25.91481703659268,morphological_dilation,3,2
0X6066F7CF79AD6EA2.avi,65,1241,897,344,38.35005574136009,morphological_dilation,3,2
0X606B12A9CF68A876.avi,62,1665,1269,396,31.20567375886525,morphological_dilation,3,2
0X606B12A9CF68A876.avi,76,1015,695,320,46.043165467625904,morphological_dilation,3,2
0X606B7F30476EEA0C.avi,44,1781,1389,392,28.22174226061915,morphological_dilation,3,2
0X606B7F30476EEA0C.avi,58,1194,858,336,39.16083916083916,morphological_dilation,3,2
0X606EAE26DB4E8B0F.avi,49,1414,1070,344,32.149532710280376,morphological_dilation,3,2
0X606EAE26DB4E8B0F.avi,71,887,615,272,44.22764227642276,morphological_dilation,3,2
0X60758344D1A615C7.avi,0,1410,1046,364,34.79923518164436,morphological_dilation,3,2
0X60758344D1A615C7.avi,18,929,627,302,48.165869218500795,morphological_dilation,3,2
0X6075BCC604236225.avi,130,2577,2133,444,20.81575246132208,morphological_dilation,3,2
0X6075BCC604236225.avi,148,1772,1374,398,28.966521106259098,morphological_dilation,3,2
0X607768213ECF3816.avi,283,2066,1650,416,25.212121212121215,morphological_dilation,3,2
0X607768213ECF3816.avi,303,1606,1226,380,30.99510603588907,morphological_dilation,3,2
0X6077DDC915D49EF4.avi,88,1689,1329,360,27.088036117381492,morphological_dilation,3,2
0X6077DDC915D49EF4.avi,107,1164,844,320,37.91469194312796,morphological_dilation,3,2
0X607994E451ABE328.avi,36,1540,1176,364,30.952380952380953,morphological_dilation,3,2
0X607994E451ABE328.avi,56,1066,754,312,41.37931034482759,morphological_dilation,3,2
0X607D6FED035C7266.avi,0,3344,2816,528,18.75,morphological_dilation,3,2
0X607D6FED035C7266.avi,21,2252,1781,471,26.44581695676586,morphological_dilation,3,2
0X607D76B3B384B981.avi,91,3178,2682,496,18.493661446681582,morphological_dilation,3,2
0X607D76B3B384B981.avi,109,1689,1318,371,28.148710166919578,morphological_dilation,3,2
0X607F41470C215868.avi,47,2501,2037,464,22.778595974472264,morphological_dilation,3,2
0X607F41470C215868.avi,63,1729,1345,384,28.550185873605948,morphological_dilation,3,2
0X6081A68BDA364282.avi,38,2221,1790,431,24.078212290502794,morphological_dilation,3,2
0X6081A68BDA364282.avi,55,1318,966,352,36.43892339544513,morphological_dilation,3,2
0X60824E65E2F8D4E4.avi,47,3784,3244,540,16.646115906288532,morphological_dilation,3,2
0X60824E65E2F8D4E4.avi,63,3360,2832,528,18.64406779661017,morphological_dilation,3,2
0X60879BF7C40D3E7F.avi,47,2194,1762,432,24.51759364358683,morphological_dilation,3,2
0X60879BF7C40D3E7F.avi,67,1391,1047,344,32.855778414517665,morphological_dilation,3,2
0X6089507F265F3867.avi,36,1830,1434,396,27.615062761506277,morphological_dilation,3,2
0X6089507F265F3867.avi,49,1126,810,316,39.01234567901234,morphological_dilation,3,2
0X608CC80E40F3C7C7.avi,30,1884,1496,388,25.935828877005346,morphological_dilation,3,2
0X608CC80E40F3C7C7.avi,36,1190,882,308,34.92063492063492,morphological_dilation,3,2
0X608CDE34163C8C6E.avi,136,3012,2496,516,20.673076923076923,morphological_dilation,3,2
0X608CDE34163C8C6E.avi,152,2127,1699,428,25.1912889935256,morphological_dilation,3,2
0X608ED3201BB2F9A.avi,91,2310,1886,424,22.481442205726403,morphological_dilation,3,2
0X608ED3201BB2F9A.avi,106,1562,1190,372,31.26050420168067,morphological_dilation,3,2
0X6093A86B26D1D702.avi,18,1159,851,308,36.19271445358402,morphological_dilation,3,2
0X6093A86B26D1D702.avi,26,833,565,268,47.43362831858407,morphological_dilation,3,2
0X60951C0848721E82.avi,76,2639,2155,484,22.45939675174014,morphological_dilation,3,2
0X60951C0848721E82.avi,94,1573,1181,392,33.1922099915326,morphological_dilation,3,2
0X609BFE0CDDFB9E.avi,107,1823,1372,451,32.87172011661808,morphological_dilation,3,2
0X609BFE0CDDFB9E.avi,123,1150,814,336,41.27764127764127,morphological_dilation,3,2
0X609D602D6AA2CE06.avi,52,1313,981,332,33.84301732925586,morphological_dilation,3,2
0X609D602D6AA2CE06.avi,68,827,555,272,49.009009009009006,morphological_dilation,3,2
0X60A115AC08C5AA98.avi,24,1661,1301,360,27.671022290545732,morphological_dilation,3,2
0X60A115AC08C5AA98.avi,38,1097,797,300,37.641154328732746,morphological_dilation,3,2
0X60A1CB79D9C78AC4.avi,66,1769,1377,392,28.467683369644153,morphological_dilation,3,2
0X60A1CB79D9C78AC4.avi,81,1063,747,316,42.302543507362785,morphological_dilation,3,2
0X60A29B95CB50D7C8.avi,108,2567,2103,464,22.063718497384688,morphological_dilation,3,2
0X60A29B95CB50D7C8.avi,131,2258,1822,436,23.929747530186606,morphological_dilation,3,2
0X60A3D09BF576C9E0.avi,42,1449,1113,336,30.18867924528302,morphological_dilation,3,2
0X60A3D09BF576C9E0.avi,57,937,657,280,42.6179604261796,morphological_dilation,3,2
0X60A3DA455577B5DD.avi,64,1249,941,308,32.731137088204036,morphological_dilation,3,2
0X60A3DA455577B5DD.avi,82,790,538,252,46.84014869888476,morphological_dilation,3,2
0X60AC03ACF886B39.avi,56,2117,1694,423,24.970484061393154,morphological_dilation,3,2
0X60AC03ACF886B39.avi,72,1277,925,352,38.054054054054056,morphological_dilation,3,2
0X60AC441DE6762A5C.avi,98,1004,716,288,40.22346368715084,morphological_dilation,3,2
0X60AC441DE6762A5C.avi,127,1337,1017,320,31.465093411996065,morphological_dilation,3,2
0X60B9AED929D32AE2.avi,27,2210,1762,448,25.425652667423382,morphological_dilation,3,2
0X60B9AED929D32AE2.avi,35,1945,1517,428,28.213579433091628,morphological_dilation,3,2
0X60BD2CFEF17230C5.avi,43,1718,1350,368,27.25925925925926,morphological_dilation,3,2
0X60BD2CFEF17230C5.avi,60,1088,792,296,37.37373737373738,morphological_dilation,3,2
0X60C1562BC81D2CFD.avi,102,1521,1173,348,29.66751918158568,morphological_dilation,3,2
0X60C1562BC81D2CFD.avi,118,1375,1039,336,32.338787295476415,morphological_dilation,3,2
0X60C2CB2D74D114DB.avi,41,2754,2267,487,21.48213498014998,morphological_dilation,3,2
0X60C2CB2D74D114DB.avi,78,1715,1303,412,31.619339984650807,morphological_dilation,3,2
0X60C2DAE488E24E8C.avi,93,2256,1812,444,24.503311258278146,morphological_dilation,3,2
0X60C2DAE488E24E8C.avi,111,1826,1406,420,29.871977240398294,morphological_dilation,3,2
0X60CA87B38DB62D25.avi,0,1450,1114,336,30.16157989228007,morphological_dilation,3,2
0X60CA87B38DB62D25.avi,16,890,618,272,44.01294498381877,morphological_dilation,3,2
0X60CB0FCDB867416E.avi,59,1607,1243,364,29.283990345937248,morphological_dilation,3,2
0X60CB0FCDB867416E.avi,86,1029,729,300,41.1522633744856,morphological_dilation,3,2
0X60CBB487D539A682.avi,63,1614,1262,352,27.892234548335974,morphological_dilation,3,2
0X60CBB487D539A682.avi,82,950,658,292,44.37689969604863,morphological_dilation,3,2
0X60D12EB75747418E.avi,30,902,630,272,43.17460317460318,morphological_dilation,3,2
0X60D12EB75747418E.avi,41,574,346,228,65.89595375722543,morphological_dilation,3,2
0X60D399F5596817FD.avi,85,2459,2031,428,21.073362875430824,morphological_dilation,3,2
0X60D399F5596817FD.avi,99,1988,1592,396,24.87437185929648,morphological_dilation,3,2
0X60D4CF900E8AB3F1.avi,79,1621,1245,376,30.200803212851408,morphological_dilation,3,2
0X60D4CF900E8AB3F1.avi,92,929,625,304,48.64,morphological_dilation,3,2
0X60D51EC3F6430CD.avi,48,2181,1745,436,24.98567335243553,morphological_dilation,3,2
0X60D51EC3F6430CD.avi,69,1602,1210,392,32.396694214876035,morphological_dilation,3,2
0X60DA39A95735153C.avi,47,2458,2014,444,22.045680238331677,morphological_dilation,3,2
0X60DA39A95735153C.avi,66,1893,1501,392,26.11592271818787,morphological_dilation,3,2
0X60E2385E5BBB7D56.avi,49,1345,981,364,37.10499490316004,morphological_dilation,3,2
0X60E2385E5BBB7D56.avi,64,781,489,292,59.71370143149284,morphological_dilation,3,2
0X60E288E158D9E124.avi,51,1693,1289,404,31.342125678820793,morphological_dilation,3,2
0X60E288E158D9E124.avi,69,1403,981,422,43.01732925586136,morphological_dilation,3,2
0X60E313E6FCCDA537.avi,51,1970,1570,400,25.477707006369428,morphological_dilation,3,2
0X60E313E6FCCDA537.avi,67,1247,919,328,35.69096844396083,morphological_dilation,3,2
0X60E541E360EAC699.avi,108,1429,1093,336,30.741079597438244,morphological_dilation,3,2
0X60E541E360EAC699.avi,130,882,612,270,44.11764705882353,morphological_dilation,3,2
0X60E7BC3E1AEE124D.avi,51,815,555,260,46.846846846846844,morphological_dilation,3,2
0X60E7BC3E1AEE124D.avi,72,541,325,216,66.46153846153847,morphological_dilation,3,2
0X60E8EFD910ABD27C.avi,52,1085,781,304,38.92445582586428,morphological_dilation,3,2
0X60E8EFD910ABD27C.avi,63,641,383,258,67.36292428198433,morphological_dilation,3,2
0X60EAA5FCA47FB694.avi,34,1630,1262,368,29.160063391442154,morphological_dilation,3,2
0X60EAA5FCA47FB694.avi,44,1039,723,316,43.706777316735824,morphological_dilation,3,2
0X60EB9960DC4D3AAE.avi,88,1519,1177,342,29.056924384027187,morphological_dilation,3,2
0X60EB9960DC4D3AAE.avi,106,1177,853,324,37.98358733880422,morphological_dilation,3,2
0X60EBADBFFED44673.avi,66,1859,1459,400,27.416038382453735,morphological_dilation,3,2
0X60EBADBFFED44673.avi,84,1096,764,332,43.455497382198956,morphological_dilation,3,2
0X60F0EBEA2ECCA7.avi,94,1468,1116,352,31.54121863799283,morphological_dilation,3,2
0X60F0EBEA2ECCA7.avi,110,919,618,301,48.70550161812297,morphological_dilation,3,2
0X60FA846306768D7A.avi,41,1332,1004,328,32.669322709163346,morphological_dilation,3,2
0X60FA846306768D7A.avi,54,855,575,280,48.69565217391305,morphological_dilation,3,2
0X60FB3BE1AD72FC10.avi,63,1905,1491,414,27.76659959758551,morphological_dilation,3,2
0X60FB3BE1AD72FC10.avi,85,1344,984,360,36.58536585365854,morphological_dilation,3,2
0X610001D2751C532F.avi,58,1923,1539,384,24.951267056530213,morphological_dilation,3,2
0X610001D2751C532F.avi,77,1220,908,312,34.36123348017621,morphological_dilation,3,2
0X610039E9EFEE05C1.avi,49,2001,1597,404,25.297432686286786,morphological_dilation,3,2
0X610039E9EFEE05C1.avi,65,1344,1000,344,34.4,morphological_dilation,3,2
0X610772D3F421D8D3.avi,50,2401,1955,446,22.813299232736572,morphological_dilation,3,2
0X610772D3F421D8D3.avi,63,1773,1385,388,28.014440433212997,morphological_dilation,3,2
0X610C81B6610DB1C2.avi,64,3295,2763,532,19.254433586681145,morphological_dilation,3,2
0X610C81B6610DB1C2.avi,74,2173,1693,480,28.352037802717074,morphological_dilation,3,2
0X61109ADAC48286FB.avi,32,1882,1483,399,26.904922454484154,morphological_dilation,3,2
0X61109ADAC48286FB.avi,49,1363,1013,350,34.550839091806516,morphological_dilation,3,2
0X6114052E1AFCB17F.avi,3,1505,1157,348,30.077787381158167,morphological_dilation,3,2
0X6114052E1AFCB17F.avi,15,904,636,268,42.138364779874216,morphological_dilation,3,2
0X6117B0541E9603CF.avi,28,1507,1151,356,30.929626411815814,morphological_dilation,3,2
0X6117B0541E9603CF.avi,50,1036,732,304,41.53005464480874,morphological_dilation,3,2
0X611ECE95FA6631BD.avi,4,1518,1146,372,32.460732984293195,morphological_dilation,3,2
0X611ECE95FA6631BD.avi,18,965,653,312,47.77947932618683,morphological_dilation,3,2
0X61285FAE5B4098E3.avi,58,2052,1640,412,25.121951219512194,morphological_dilation,3,2
0X61285FAE5B4098E3.avi,75,1219,891,328,36.81257014590348,morphological_dilation,3,2
0X61290D261B4E1A2A.avi,82,1781,1405,376,26.761565836298935,morphological_dilation,3,2
0X61290D261B4E1A2A.avi,104,1124,816,308,37.745098039215684,morphological_dilation,3,2
0X612D302A7898B7B.avi,101,1605,1257,348,27.684964200477324,morphological_dilation,3,2
0X612D302A7898B7B.avi,119,978,698,280,40.114613180515754,morphological_dilation,3,2
0X613C65C873F42B48.avi,78,1568,1192,376,31.543624161073826,morphological_dilation,3,2
0X613C65C873F42B48.avi,94,972,660,312,47.27272727272727,morphological_dilation,3,2
0X613E15ACF68A8CD4.avi,63,1149,841,308,36.623067776456594,morphological_dilation,3,2
0X613E15ACF68A8CD4.avi,74,692,431,261,60.556844547563806,morphological_dilation,3,2
0X613F92D8E9051054.avi,49,1907,1511,396,26.207809397749838,morphological_dilation,3,2
0X613F92D8E9051054.avi,66,1290,962,328,34.0956340956341,morphological_dilation,3,2
0X6142773DC5AFEEE6.avi,25,1039,747,292,39.08969210174029,morphological_dilation,3,2
0X6142773DC5AFEEE6.avi,30,718,462,256,55.41125541125541,morphological_dilation,3,2
0X614667C1081DDA78.avi,44,1723,1343,380,28.294862248696944,morphological_dilation,3,2
0X614667C1081DDA78.avi,58,1002,702,300,42.73504273504273,morphological_dilation,3,2
0X61486985C6B1E049.avi,102,2436,2004,432,21.55688622754491,morphological_dilation,3,2
0X61486985C6B1E049.avi,120,1391,1047,344,32.855778414517665,morphological_dilation,3,2
0X61490A9A563BA496.avi,45,1279,954,325,34.067085953878404,morphological_dilation,3,2
0X61490A9A563BA496.avi,58,863,583,280,48.02744425385935,morphological_dilation,3,2
0X614B3F106CA8115E.avi,61,1824,1425,399,28.000000000000004,morphological_dilation,3,2
0X614B3F106CA8115E.avi,78,1122,802,320,39.900249376558605,morphological_dilation,3,2
0X6155412BB652E5B1.avi,47,2584,2116,468,22.117202268431,morphological_dilation,3,2
0X6155412BB652E5B1.avi,66,1378,1014,364,35.8974358974359,morphological_dilation,3,2
0X61587D736C90E3D4.avi,68,2697,2211,486,21.98100407055631,morphological_dilation,3,2
0X61587D736C90E3D4.avi,85,1793,1377,416,30.21060275962237,morphological_dilation,3,2
0X6158BD0A77933B5E.avi,32,1772,1388,384,27.6657060518732,morphological_dilation,3,2
0X6158BD0A77933B5E.avi,50,1180,844,336,39.81042654028436,morphological_dilation,3,2
0X615BECB59AC3A22A.avi,58,2375,1931,444,22.993267736923872,morphological_dilation,3,2
0X615BECB59AC3A22A.avi,78,1506,1126,380,33.747779751332146,morphological_dilation,3,2
0X615D7146FC5C9460.avi,54,2297,1869,428,22.899946495452113,morphological_dilation,3,2
0X615D7146FC5C9460.avi,68,1532,1168,364,31.164383561643838,morphological_dilation,3,2
0X615DAAF2A2E00D4F.avi,104,2169,1745,424,24.297994269340975,morphological_dilation,3,2
0X615DAAF2A2E00D4F.avi,116,1179,847,332,39.19716646989374,morphological_dilation,3,2
0X61606A54D357AD12.avi,113,1865,1448,417,28.79834254143646,morphological_dilation,3,2
0X61606A54D357AD12.avi,127,1156,810,346,42.71604938271605,morphological_dilation,3,2
0X61621ADA8491FEE2.avi,1,2911,2431,480,19.74496092143151,morphological_dilation,3,2
0X61621ADA8491FEE2.avi,19,2233,1794,439,24.470457079152734,morphological_dilation,3,2
0X6163E4FAB71D46F6.avi,36,2467,2007,460,22.9197807673144,morphological_dilation,3,2
0X6163E4FAB71D46F6.avi,53,1314,962,352,36.590436590436596,morphological_dilation,3,2
0X6164CF5637491D60.avi,52,1849,1455,394,27.079037800687285,morphological_dilation,3,2
0X6164CF5637491D60.avi,66,1106,794,312,39.29471032745592,morphological_dilation,3,2
0X61667A832FA493EC.avi,38,1634,1274,360,28.257456828885402,morphological_dilation,3,2
0X61667A832FA493EC.avi,54,1038,734,304,41.41689373297003,morphological_dilation,3,2
0X6166B74ED1E05A2F.avi,112,997,705,292,41.41843971631206,morphological_dilation,3,2
0X6166B74ED1E05A2F.avi,129,654,402,252,62.68656716417911,morphological_dilation,3,2
0X6168F0F0714C1C1C.avi,56,1902,1506,396,26.294820717131472,morphological_dilation,3,2
0X6168F0F0714C1C1C.avi,77,1187,868,319,36.75115207373272,morphological_dilation,3,2
0X616B4664CD092CC4.avi,140,2516,2072,444,21.428571428571427,morphological_dilation,3,2
0X616B4664CD092CC4.avi,158,2140,1732,408,23.556581986143186,morphological_dilation,3,2
0X616F20C3E89D4CC2.avi,139,1380,1052,328,31.1787072243346,morphological_dilation,3,2
0X616F20C3E89D4CC2.avi,160,876,600,276,46.0,morphological_dilation,3,2
0X6172BF6CBE1B8C63.avi,49,1670,1302,368,28.264208909370197,morphological_dilation,3,2
0X6172BF6CBE1B8C63.avi,63,1078,774,304,39.276485788113696,morphological_dilation,3,2
0X617470804AED8010.avi,52,1980,1568,412,26.27551020408163,morphological_dilation,3,2
0X617470804AED8010.avi,69,1288,936,352,37.60683760683761,morphological_dilation,3,2
0X6178BEFF04E5441F.avi,40,2149,1726,423,24.507531865585168,morphological_dilation,3,2
0X6178BEFF04E5441F.avi,58,1366,1010,356,35.24752475247524,morphological_dilation,3,2
0X617D5C19D1A8FF89.avi,2,2132,1712,420,24.53271028037383,morphological_dilation,3,2
0X617D5C19D1A8FF89.avi,18,1246,930,316,33.97849462365591,morphological_dilation,3,2
0X617DAA674148287E.avi,115,2038,1614,424,26.270136307311027,morphological_dilation,3,2
0X617DAA674148287E.avi,132,1167,835,332,39.76047904191617,morphological_dilation,3,2
0X6182F7FF4D48777.avi,89,1099,799,300,37.546933667083856,morphological_dilation,3,2
0X6182F7FF4D48777.avi,106,661,429,232,54.07925407925408,morphological_dilation,3,2
0X618385631E2F91.avi,50,1413,1053,360,34.18803418803419,morphological_dilation,3,2
0X618385631E2F91.avi,67,804,528,276,52.27272727272727,morphological_dilation,3,2
0X6183BA1218A8B1E.avi,65,1288,960,328,34.166666666666664,morphological_dilation,3,2
0X6183BA1218A8B1E.avi,84,789,513,276,53.80116959064327,morphological_dilation,3,2
0X61848F995A02B06C.avi,6,1404,1068,336,31.46067415730337,morphological_dilation,3,2
0X61848F995A02B06C.avi,21,962,669,293,43.796711509716,morphological_dilation,3,2
0X6185F36B24251475.avi,158,2046,1646,400,24.30133657351154,morphological_dilation,3,2
0X6185F36B24251475.avi,175,1350,1018,332,32.61296660117878,morphological_dilation,3,2
0X618C08CFF808D832.avi,110,2063,1647,416,25.258044930176077,morphological_dilation,3,2
0X618C08CFF808D832.avi,125,1236,904,332,36.72566371681416,morphological_dilation,3,2
0X619010C76D709BCF.avi,43,1203,875,328,37.48571428571428,morphological_dilation,3,2
0X619010C76D709BCF.avi,60,767,495,272,54.94949494949495,morphological_dilation,3,2
0X61970056C330866C.avi,116,1878,1475,403,27.322033898305087,morphological_dilation,3,2
0X61970056C330866C.avi,134,1123,811,312,38.47102342786683,morphological_dilation,3,2
0X6197221CFF744122.avi,96,1761,1365,396,29.010989010989015,morphological_dilation,3,2
0X6197221CFF744122.avi,111,1196,860,336,39.06976744186046,morphological_dilation,3,2
0X619AAFC89B03A69F.avi,75,1422,1078,344,31.910946196660483,morphological_dilation,3,2
0X619AAFC89B03A69F.avi,84,882,602,280,46.51162790697674,morphological_dilation,3,2
0X619D735DD1D98D84.avi,57,1766,1390,376,27.050359712230215,morphological_dilation,3,2
0X619D735DD1D98D84.avi,74,1084,780,304,38.97435897435898,morphological_dilation,3,2
0X619FFCEFBDF0CCF4.avi,82,1464,1120,344,30.714285714285715,morphological_dilation,3,2
0X619FFCEFBDF0CCF4.avi,95,964,672,292,43.452380952380956,morphological_dilation,3,2
0X61A410BB1F05392A.avi,53,2081,1665,416,24.984984984984983,morphological_dilation,3,2
0X61A410BB1F05392A.avi,74,1319,979,340,34.72931562819203,morphological_dilation,3,2
0X61A5A8A298CBB992.avi,72,1453,1081,372,34.41258094357077,morphological_dilation,3,2
0X61A5A8A298CBB992.avi,90,963,638,325,50.94043887147336,morphological_dilation,3,2
0X61AC0ADC7C9D98E0.avi,175,2311,1847,464,25.121819166215488,morphological_dilation,3,2
0X61AC0ADC7C9D98E0.avi,191,1413,1037,376,36.25843780135005,morphological_dilation,3,2
0X61AF888022B3E17.avi,41,2133,1713,420,24.518388791593697,morphological_dilation,3,2
0X61AF888022B3E17.avi,61,1365,1029,336,32.6530612244898,morphological_dilation,3,2
0X61AFEA2C1EB13D90.avi,111,1924,1524,400,26.246719160104988,morphological_dilation,3,2
0X61AFEA2C1EB13D90.avi,129,1219,883,336,38.052095130237824,morphological_dilation,3,2
0X61B17DE63E91ABC1.avi,87,868,585,283,48.376068376068375,morphological_dilation,3,2
0X61B17DE63E91ABC1.avi,98,662,390,272,69.74358974358974,morphological_dilation,3,2
0X61B352290CDB2133.avi,50,983,691,292,42.2575976845152,morphological_dilation,3,2
0X61B352290CDB2133.avi,69,1473,1133,340,30.008826125330977,morphological_dilation,3,2
0X61B56FE2FAAE1DFE.avi,50,2210,1746,464,26.57502863688431,morphological_dilation,3,2
0X61B56FE2FAAE1DFE.avi,65,1212,848,364,42.924528301886795,morphological_dilation,3,2
0X61B69402642621FA.avi,141,3083,2563,520,20.288724151385097,morphological_dilation,3,2
0X61B69402642621FA.avi,167,2354,1881,473,25.146198830409354,morphological_dilation,3,2
0X61B6E8FB5F3B7F28.avi,2,1159,851,308,36.19271445358402,morphological_dilation,3,2
0X61B6E8FB5F3B7F28.avi,20,739,479,260,54.27974947807933,morphological_dilation,3,2
0X61B7F331C88097E6.avi,37,1650,1284,366,28.504672897196258,morphological_dilation,3,2
0X61B7F331C88097E6.avi,50,991,703,288,40.96728307254623,morphological_dilation,3,2
0X61BB4CE860D8FF7C.avi,147,2038,1618,420,25.95797280593325,morphological_dilation,3,2
0X61BB4CE860D8FF7C.avi,163,1374,1009,365,36.174430128840434,morphological_dilation,3,2
0X61BCFDD03D7D72CC.avi,61,2406,1970,436,22.131979695431472,morphological_dilation,3,2
0X61BCFDD03D7D72CC.avi,77,2223,1803,420,23.294509151414307,morphological_dilation,3,2
0X61C5D71CDDD1F6FC.avi,38,1174,854,320,37.470725995316165,morphological_dilation,3,2
0X61C5D71CDDD1F6FC.avi,50,691,443,248,55.98194130925508,morphological_dilation,3,2
0X61C7B5C2F114DA60.avi,55,1435,1087,348,32.01471941122355,morphological_dilation,3,2
0X61C7B5C2F114DA60.avi,70,866,586,280,47.781569965870304,morphological_dilation,3,2
0X61CBB091699F9FAD.avi,32,2778,2286,492,21.522309711286088,morphological_dilation,3,2
0X61CBB091699F9FAD.avi,52,1756,1356,400,29.49852507374631,morphological_dilation,3,2
0X61D67DBEE3CA29C.avi,58,2351,1891,460,24.325753569539927,morphological_dilation,3,2
0X61D67DBEE3CA29C.avi,78,1560,1160,400,34.48275862068966,morphological_dilation,3,2
0X61D81D3A714A2CAE.avi,55,3201,2687,514,19.129140305173056,morphological_dilation,3,2
0X61D81D3A714A2CAE.avi,78,1987,1583,404,25.521162349968414,morphological_dilation,3,2
0X61DBD51F03B76427.avi,124,2327,1887,440,23.317435082140964,morphological_dilation,3,2
0X61DBD51F03B76427.avi,141,1559,1183,376,31.783601014370245,morphological_dilation,3,2
0X61DD02434C3C63E7.avi,33,2498,2030,468,23.054187192118228,morphological_dilation,3,2
0X61DD02434C3C63E7.avi,46,1514,1131,383,33.863837312113176,morphological_dilation,3,2
0X61E16B47E6FD8A4C.avi,46,2696,2220,476,21.44144144144144,morphological_dilation,3,2
0X61E16B47E6FD8A4C.avi,68,1681,1285,396,30.817120622568094,morphological_dilation,3,2
0X61E568C03C41267A.avi,128,1541,1181,360,30.482641828958513,morphological_dilation,3,2
0X61E568C03C41267A.avi,141,998,720,278,38.611111111111114,morphological_dilation,3,2
0X61E9FEC719B239A0.avi,57,1406,1066,340,31.894934333958723,morphological_dilation,3,2
0X61E9FEC719B239A0.avi,74,882,596,286,47.98657718120805,morphological_dilation,3,2
0X61EA0CBB056791FE.avi,56,1327,1015,312,30.738916256157633,morphological_dilation,3,2
0X61EA0CBB056791FE.avi,78,1038,750,288,38.4,morphological_dilation,3,2
0X61EB498F3D0E42F.avi,88,1531,1167,364,31.191088260497,morphological_dilation,3,2
0X61EB498F3D0E42F.avi,104,979,653,326,49.92343032159265,morphological_dilation,3,2
0X61ED29875A107302.avi,92,3214,2703,511,18.904920458749537,morphological_dilation,3,2
0X61ED29875A107302.avi,112,2708,2221,487,21.927059882935616,morphological_dilation,3,2
0X61F021642A416187.avi,34,3492,2908,584,20.082530949105916,morphological_dilation,3,2
0X61F021642A416187.avi,60,2245,1757,488,27.774615822424586,morphological_dilation,3,2
0X61F17BA2035CC3FB.avi,30,1987,1567,420,26.802807913209953,morphological_dilation,3,2
0X61F17BA2035CC3FB.avi,39,1533,1169,364,31.137724550898206,morphological_dilation,3,2
0X61F438D1BB39E331.avi,124,1800,1416,384,27.11864406779661,morphological_dilation,3,2
0X61F438D1BB39E331.avi,144,1289,953,336,35.257082896117524,morphological_dilation,3,2
0X61FBBED6FD9504DB.avi,58,1500,1140,360,31.57894736842105,morphological_dilation,3,2
0X61FBBED6FD9504DB.avi,74,975,675,300,44.44444444444444,morphological_dilation,3,2
0X6200291BC8CEC0A8.avi,0,2515,2087,428,20.50790608528989,morphological_dilation,3,2
0X6200291BC8CEC0A8.avi,17,1800,1424,376,26.40449438202247,morphological_dilation,3,2
0X6200509F3CB51BF4.avi,82,1862,1470,392,26.666666666666668,morphological_dilation,3,2
0X6200509F3CB51BF4.avi,95,1393,1054,339,32.16318785578748,morphological_dilation,3,2
0X62020DF45F8F65CF.avi,33,1336,1016,320,31.496062992125985,morphological_dilation,3,2
0X62020DF45F8F65CF.avi,48,903,627,276,44.01913875598086,morphological_dilation,3,2
0X620373BE146E6C3B.avi,125,2545,2012,533,26.491053677932406,morphological_dilation,3,2
0X620373BE146E6C3B.avi,137,2123,1535,588,38.306188925081436,morphological_dilation,3,2
0X620622F3C57A2D34.avi,128,1614,1234,380,30.79416531604538,morphological_dilation,3,2
0X620622F3C57A2D34.avi,141,1061,731,330,45.1436388508892,morphological_dilation,3,2
0X62069BBDFB47067D.avi,122,1695,1331,364,27.347858752817427,morphological_dilation,3,2
0X62069BBDFB47067D.avi,138,998,714,284,39.77591036414566,morphological_dilation,3,2
0X6210992ADCECE486.avi,18,1456,1084,372,34.31734317343174,morphological_dilation,3,2
0X6210992ADCECE486.avi,47,2275,1815,460,25.344352617079892,morphological_dilation,3,2
0X62120394E2CFDA1C.avi,123,1783,1388,395,28.45821325648415,morphological_dilation,3,2
0X62120394E2CFDA1C.avi,140,1040,728,312,42.857142857142854,morphological_dilation,3,2
0X62120814160BA377.avi,166,2200,1788,412,23.042505592841163,morphological_dilation,3,2
0X62120814160BA377.avi,203,2666,2159,507,23.48309402501158,morphological_dilation,3,2
0X62167C07ED3F8E50.avi,130,2103,1691,412,24.36428149024246,morphological_dilation,3,2
0X62167C07ED3F8E50.avi,149,1238,910,328,36.043956043956044,morphological_dilation,3,2
0X6216A1CA7F78D802.avi,57,1881,1473,408,27.698574338085542,morphological_dilation,3,2
0X6216A1CA7F78D802.avi,75,1297,937,360,38.4204909284952,morphological_dilation,3,2
0X621A5AF262880B0E.avi,45,1557,1205,352,29.211618257261414,morphological_dilation,3,2
0X621A5AF262880B0E.avi,59,1152,836,316,37.79904306220095,morphological_dilation,3,2
0X621E8EA95716994D.avi,0,2121,1701,420,24.691358024691358,morphological_dilation,3,2
0X621E8EA95716994D.avi,17,1143,835,308,36.88622754491018,morphological_dilation,3,2
0X62232F7C971D7804.avi,0,1583,1227,356,29.013854930725348,morphological_dilation,3,2
0X62232F7C971D7804.avi,22,893,613,280,45.67699836867863,morphological_dilation,3,2
0X6223EE23BD172BD8.avi,106,3212,2700,512,18.962962962962962,morphological_dilation,3,2
0X6223EE23BD172BD8.avi,137,1546,1170,376,32.136752136752136,morphological_dilation,3,2
0X62281AB3009C0842.avi,112,2090,1666,424,25.45018007202881,morphological_dilation,3,2
0X62281AB3009C0842.avi,123,1216,884,332,37.55656108597285,morphological_dilation,3,2
0X62288B92A04EB557.avi,75,2605,2105,500,23.75296912114014,morphological_dilation,3,2
0X62288B92A04EB557.avi,93,1379,1011,368,36.39960435212661,morphological_dilation,3,2
0X6229CB36DB9F05A5.avi,91,892,616,276,44.8051948051948,morphological_dilation,3,2
0X6229CB36DB9F05A5.avi,113,1530,1166,364,31.217838765008576,morphological_dilation,3,2
0X622CBB289D9ADCB.avi,67,3337,2825,512,18.123893805309734,morphological_dilation,3,2
0X622CBB289D9ADCB.avi,78,2081,1669,412,24.68544038346315,morphological_dilation,3,2
0X622E1E920459AF0B.avi,48,2027,1623,404,24.892174984596426,morphological_dilation,3,2
0X622E1E920459AF0B.avi,62,1314,972,342,35.18518518518518,morphological_dilation,3,2
0X6231E19CD6477630.avi,74,1447,1107,340,30.713640469738028,morphological_dilation,3,2
0X6231E19CD6477630.avi,88,876,600,276,46.0,morphological_dilation,3,2
0X623553186A86B3F1.avi,38,2496,2056,440,21.40077821011673,morphological_dilation,3,2
0X623553186A86B3F1.avi,52,1461,1105,356,32.217194570135746,morphological_dilation,3,2
0X62363A0046BBD232.avi,57,2932,2428,504,20.757825370675455,morphological_dilation,3,2
0X62363A0046BBD232.avi,73,2361,1913,448,23.41871406168322,morphological_dilation,3,2
0X62370545D10D6B3C.avi,56,1323,975,348,35.69230769230769,morphological_dilation,3,2
0X62370545D10D6B3C.avi,69,900,592,308,52.02702702702703,morphological_dilation,3,2
0X6237090A1B16DEFA.avi,53,2001,1609,392,24.362958359229335,morphological_dilation,3,2
0X6237090A1B16DEFA.avi,75,1392,1060,332,31.32075471698113,morphological_dilation,3,2
0X623A44344DB4C3D9.avi,85,1983,1576,407,25.824873096446698,morphological_dilation,3,2
0X623A44344DB4C3D9.avi,105,1196,866,330,38.106235565819865,morphological_dilation,3,2
0X623F4667A42B8338.avi,31,1389,1026,363,35.38011695906433,morphological_dilation,3,2
0X623F4667A42B8338.avi,47,924,620,304,49.03225806451613,morphological_dilation,3,2
0X6242E545D9E88971.avi,65,1621,1253,368,29.36951316839585,morphological_dilation,3,2
0X6242E545D9E88971.avi,81,1073,761,312,40.99868593955322,morphological_dilation,3,2
0X62431BB9CF3A33EE.avi,46,1188,868,320,36.86635944700461,morphological_dilation,3,2
0X62431BB9CF3A33EE.avi,59,809,529,280,52.93005671077504,morphological_dilation,3,2
0X6243CDE6C761DC2C.avi,1,1311,999,312,31.23123123123123,morphological_dilation,3,2
0X6243CDE6C761DC2C.avi,24,791,543,248,45.67219152854512,morphological_dilation,3,2
0X6244378B616F4BF6.avi,6,2235,1779,456,25.632377740303543,morphological_dilation,3,2
0X6244378B616F4BF6.avi,33,1357,997,360,36.10832497492478,morphological_dilation,3,2
0X624452DF15668C3B.avi,96,1223,887,336,37.88049605411499,morphological_dilation,3,2
0X624452DF15668C3B.avi,111,729,465,264,56.774193548387096,morphological_dilation,3,2
0X6244974E7C452D0.avi,94,3516,2976,540,18.14516129032258,morphological_dilation,3,2
0X6244974E7C452D0.avi,114,2503,2047,456,22.27650219833903,morphological_dilation,3,2
0X62473A8FCF726A75.avi,52,3846,3331,515,15.460822575803062,morphological_dilation,3,2
0X62473A8FCF726A75.avi,71,2263,1791,472,26.353992183137915,morphological_dilation,3,2
0X6248A53F54109542.avi,37,1498,1142,356,31.17338003502627,morphological_dilation,3,2
0X6248A53F54109542.avi,54,969,661,308,46.59606656580938,morphological_dilation,3,2
0X6249ED892A1300E0.avi,91,1681,1297,384,29.606784888203546,morphological_dilation,3,2
0X6249ED892A1300E0.avi,110,1313,981,332,33.84301732925586,morphological_dilation,3,2
0X624AF19C96CC325F.avi,42,2011,1607,404,25.140012445550713,morphological_dilation,3,2
0X624AF19C96CC325F.avi,54,1255,927,328,35.382955771305284,morphological_dilation,3,2
0X624B1190D5E5D04D.avi,46,1253,917,336,36.6412213740458,morphological_dilation,3,2
0X624B1190D5E5D04D.avi,62,847,563,284,50.44404973357016,morphological_dilation,3,2
0X624C7BEBC641CEDA.avi,102,1431,1071,360,33.61344537815126,morphological_dilation,3,2
0X624C7BEBC641CEDA.avi,110,874,582,292,50.171821305841924,morphological_dilation,3,2
0X6252B9DC16FA14BD.avi,106,1969,1565,404,25.814696485623003,morphological_dilation,3,2
0X6252B9DC16FA14BD.avi,123,1296,944,352,37.28813559322034,morphological_dilation,3,2
0X6254DB24438A055B.avi,55,1795,1403,392,27.94012829650748,morphological_dilation,3,2
0X6254DB24438A055B.avi,71,1117,793,324,40.85750315258512,morphological_dilation,3,2
0X62559BC253A97E51.avi,2,3205,2661,544,20.443442314919203,morphological_dilation,3,2
0X62559BC253A97E51.avi,20,1925,1486,439,29.542395693135937,morphological_dilation,3,2
0X626B5EC75243A0D3.avi,4,1626,1262,364,28.84310618066561,morphological_dilation,3,2
0X626B5EC75243A0D3.avi,15,976,696,280,40.229885057471265,morphological_dilation,3,2
0X62717DC37FD004CF.avi,38,3206,2702,504,18.65284974093264,morphological_dilation,3,2
0X62717DC37FD004CF.avi,54,1996,1592,404,25.376884422110553,morphological_dilation,3,2
0X6272075AEC0BA960.avi,57,1861,1489,372,24.98321020819342,morphological_dilation,3,2
0X6272075AEC0BA960.avi,70,1529,1173,356,30.34953111679454,morphological_dilation,3,2
0X627232266CC3F5DC.avi,150,1704,1312,392,29.878048780487802,morphological_dilation,3,2
0X627232266CC3F5DC.avi,167,1140,820,320,39.02439024390244,morphological_dilation,3,2
0X62731DCE5C886642.avi,44,2213,1801,412,22.876179900055522,morphological_dilation,3,2
0X62731DCE5C886642.avi,56,1446,1094,352,32.17550274223035,morphological_dilation,3,2
0X62741A42E524CAD7.avi,41,1657,1293,364,28.151585460170146,morphological_dilation,3,2
0X62741A42E524CAD7.avi,57,1088,784,304,38.775510204081634,morphological_dilation,3,2
0X6275BB18E7A8D320.avi,57,1089,805,284,35.27950310559006,morphological_dilation,3,2
0X6275BB18E7A8D320.avi,71,736,492,244,49.59349593495935,morphological_dilation,3,2
0X6277D1C8274F5454.avi,84,1226,910,316,34.72527472527472,morphological_dilation,3,2
0X6277D1C8274F5454.avi,99,699,466,233,50.0,morphological_dilation,3,2
0X627A4DFBE5B59E7C.avi,73,1906,1490,416,27.91946308724832,morphological_dilation,3,2
0X627A4DFBE5B59E7C.avi,88,1317,965,352,36.476683937823836,morphological_dilation,3,2
0X627C3A92D257F19E.avi,60,3221,2689,532,19.784306433618447,morphological_dilation,3,2
0X627C3A92D257F19E.avi,80,2591,2123,468,22.044276966556758,morphological_dilation,3,2
0X627F73BBD2A57DEF.avi,49,1619,1267,352,27.782162588792424,morphological_dilation,3,2
0X627F73BBD2A57DEF.avi,68,1024,744,280,37.634408602150536,morphological_dilation,3,2
0X6282B0330D95ED3F.avi,124,1749,1361,388,28.508449669360765,morphological_dilation,3,2
0X6282B0330D95ED3F.avi,144,1352,1008,344,34.12698412698413,morphological_dilation,3,2
0X6283969D8953FECF.avi,90,1313,989,324,32.76036400404449,morphological_dilation,3,2
0X6283969D8953FECF.avi,109,912,622,290,46.62379421221865,morphological_dilation,3,2
0X6286F6DFC7F835B8.avi,39,1397,1005,392,39.00497512437811,morphological_dilation,3,2
0X6286F6DFC7F835B8.avi,53,1079,722,357,49.445983379501385,morphological_dilation,3,2
0X628BD140F1FC1557.avi,54,2294,1874,420,22.411953041622198,morphological_dilation,3,2
0X628BD140F1FC1557.avi,74,1420,1092,328,30.036630036630036,morphological_dilation,3,2
0X628E52E0848610F5.avi,59,1327,1009,318,31.516352824578792,morphological_dilation,3,2
0X628E52E0848610F5.avi,78,945,661,284,42.96520423600605,morphological_dilation,3,2
0X6290DAA1DBA189F9.avi,55,2892,2329,563,24.173465006440534,morphological_dilation,3,2
0X6290DAA1DBA189F9.avi,86,2206,1754,452,25.769669327251993,morphological_dilation,3,2
0X6294FD3F7487AA1D.avi,40,2154,1742,412,23.65097588978186,morphological_dilation,3,2
0X6294FD3F7487AA1D.avi,64,1873,1482,391,26.383265856950068,morphological_dilation,3,2
0X6296137ED4994429.avi,132,2334,1894,440,23.231256599788807,morphological_dilation,3,2
0X6296137ED4994429.avi,154,1353,993,360,36.25377643504532,morphological_dilation,3,2
0X629BAD750FB326D1.avi,2,3625,3073,552,17.962902700943705,morphological_dilation,3,2
0X629BAD750FB326D1.avi,20,2213,1750,463,26.457142857142856,morphological_dilation,3,2
0X629D824243E63810.avi,109,1650,1275,375,29.411764705882355,morphological_dilation,3,2
0X629D824243E63810.avi,129,1205,879,326,37.087599544937426,morphological_dilation,3,2
0X62A25E56B1AEE78B.avi,67,2298,1846,452,24.48537378114843,morphological_dilation,3,2
0X62A25E56B1AEE78B.avi,87,1339,997,342,34.302908726178536,morphological_dilation,3,2
0X62A2EFEA0863B781.avi,37,1699,1331,368,27.64838467317806,morphological_dilation,3,2
0X62A2EFEA0863B781.avi,54,1006,714,292,40.896358543417364,morphological_dilation,3,2
0X62A98C9A5B58A031.avi,59,1703,1343,360,26.80565897244974,morphological_dilation,3,2
0X62A98C9A5B58A031.avi,78,1142,838,304,36.27684964200477,morphological_dilation,3,2
0X62AADFDC4467B5EE.avi,46,2107,1683,424,25.193107546048722,morphological_dilation,3,2
0X62AADFDC4467B5EE.avi,70,1228,892,336,37.66816143497758,morphological_dilation,3,2
0X62ABD820E0F2FBD0.avi,36,1936,1536,400,26.041666666666668,morphological_dilation,3,2
0X62ABD820E0F2FBD0.avi,54,1227,907,320,35.28114663726571,morphological_dilation,3,2
0X62B37D47688D7F3C.avi,43,1784,1400,384,27.42857142857143,morphological_dilation,3,2
0X62B37D47688D7F3C.avi,62,1517,1161,356,30.663221360895783,morphological_dilation,3,2
0X62B3D1284E90B92E.avi,41,1758,1382,376,27.206946454413895,morphological_dilation,3,2
0X62B3D1284E90B92E.avi,52,1078,782,296,37.851662404092075,morphological_dilation,3,2
0X62B760F36DAD3A27.avi,90,1641,1281,360,28.10304449648712,morphological_dilation,3,2
0X62B760F36DAD3A27.avi,103,1482,1142,340,29.772329246935204,morphological_dilation,3,2
0X62BAD1AAAE139375.avi,46,2041,1617,424,26.22139764996908,morphological_dilation,3,2
0X62BAD1AAAE139375.avi,60,1232,877,355,40.478905359179016,morphological_dilation,3,2
0X62BE5E914D5C6FAE.avi,99,1451,1095,356,32.51141552511416,morphological_dilation,3,2
0X62BE5E914D5C6FAE.avi,115,935,643,292,45.41213063763608,morphological_dilation,3,2
0X62CA2DF80D04673E.avi,35,2637,2130,507,23.80281690140845,morphological_dilation,3,2
0X62CA2DF80D04673E.avi,52,1472,1088,384,35.294117647058826,morphological_dilation,3,2
0X62CFD637D29F0AF8.avi,49,3357,2837,520,18.329221008107154,morphological_dilation,3,2
0X62CFD637D29F0AF8.avi,69,2823,2347,476,20.28121005538986,morphological_dilation,3,2
0X62D0E438B69C344A.avi,118,1501,1149,352,30.63533507397737,morphological_dilation,3,2
0X62D0E438B69C344A.avi,133,909,621,288,46.3768115942029,morphological_dilation,3,2
0X62D1775AFFC83C5A.avi,59,1666,1298,368,28.35130970724191,morphological_dilation,3,2
0X62D1775AFFC83C5A.avi,75,1038,732,306,41.80327868852459,morphological_dilation,3,2
0X62D954A4644CE358.avi,71,2032,1620,412,25.432098765432098,morphological_dilation,3,2
0X62D954A4644CE358.avi,81,1448,1080,368,34.074074074074076,morphological_dilation,3,2
0X62D9FBC429BB5C83.avi,91,2232,1801,431,23.931149361465852,morphological_dilation,3,2
0X62D9FBC429BB5C83.avi,109,1868,1468,400,27.247956403269757,morphological_dilation,3,2
0X62E2F987FDE1D54.avi,91,1240,924,316,34.1991341991342,morphological_dilation,3,2
0X62E2F987FDE1D54.avi,109,805,522,283,54.214559386973185,morphological_dilation,3,2
0X62E6931F0936350D.avi,103,1806,1422,384,27.004219409282697,morphological_dilation,3,2
0X62E6931F0936350D.avi,119,1179,851,328,38.54289071680376,morphological_dilation,3,2
0X62EA10A73F0557B9.avi,21,2402,1908,494,25.89098532494759,morphological_dilation,3,2
0X62EA10A73F0557B9.avi,35,1596,1192,404,33.89261744966443,morphological_dilation,3,2
0X62F8023D8467B4D5.avi,39,1213,909,304,33.44334433443345,morphological_dilation,3,2
0X62F8023D8467B4D5.avi,54,875,607,268,44.15156507413509,morphological_dilation,3,2
0X62FFA6AFAF764AC0.avi,107,1972,1560,412,26.410256410256412,morphological_dilation,3,2
0X62FFA6AFAF764AC0.avi,123,1141,815,326,40.0,morphological_dilation,3,2
0X6300A58D8CF5363A.avi,60,1376,1044,332,31.800766283524908,morphological_dilation,3,2
0X6300A58D8CF5363A.avi,71,819,559,260,46.51162790697674,morphological_dilation,3,2
0X63065D5C24C3DE6D.avi,74,1239,895,344,38.435754189944134,morphological_dilation,3,2
0X63065D5C24C3DE6D.avi,93,828,536,292,54.47761194029851,morphological_dilation,3,2
0X630742E78187417.avi,55,1426,1066,360,33.771106941838646,morphological_dilation,3,2
0X630742E78187417.avi,73,869,585,284,48.547008547008545,morphological_dilation,3,2
0X63088AEC76D7604D.avi,43,1493,1109,384,34.62578899909829,morphological_dilation,3,2
0X63088AEC76D7604D.avi,68,944,624,320,51.28205128205128,morphological_dilation,3,2
0X630BF397D6215496.avi,55,1417,1054,363,34.440227703984824,morphological_dilation,3,2
0X630BF397D6215496.avi,72,836,560,276,49.28571428571429,morphological_dilation,3,2
0X630FC0272AE524D3.avi,3,1838,1450,388,26.75862068965517,morphological_dilation,3,2
0X630FC0272AE524D3.avi,21,1293,969,324,33.43653250773993,morphological_dilation,3,2
0X6311A3EA62D07100.avi,46,1553,1194,359,30.067001675041876,morphological_dilation,3,2
0X6311A3EA62D07100.avi,67,905,617,288,46.677471636953,morphological_dilation,3,2
0X63136117F9AD3DBB.avi,72,1505,1129,376,33.30380868024801,morphological_dilation,3,2
0X63136117F9AD3DBB.avi,85,1248,904,344,38.05309734513274,morphological_dilation,3,2
0X63155061FC7D2CB3.avi,100,1971,1559,412,26.427196921103267,morphological_dilation,3,2
0X63155061FC7D2CB3.avi,119,1292,948,344,36.28691983122363,morphological_dilation,3,2
0X63179AA447034992.avi,55,1949,1557,392,25.176621708413617,morphological_dilation,3,2
0X63179AA447034992.avi,67,1283,951,332,34.910620399579386,morphological_dilation,3,2
0X6317D4F7D0A23188.avi,99,1454,1102,352,31.941923774954628,morphological_dilation,3,2
0X6317D4F7D0A23188.avi,110,903,615,288,46.82926829268293,morphological_dilation,3,2
0X631F8BE60B6A906D.avi,114,2896,2404,492,20.465890183028286,morphological_dilation,3,2
0X631F8BE60B6A906D.avi,133,2529,2066,463,22.410454985479188,morphological_dilation,3,2
0X6325022EA6862495.avi,105,1129,841,288,34.244946492271104,morphological_dilation,3,2
0X6325022EA6862495.avi,115,881,605,276,45.6198347107438,morphological_dilation,3,2
0X63252420012C79A2.avi,66,1337,989,348,35.18705763397371,morphological_dilation,3,2
0X63252420012C79A2.avi,77,882,582,300,51.546391752577314,morphological_dilation,3,2
0X6326541E9E879019.avi,72,1618,1266,352,27.804107424960506,morphological_dilation,3,2
0X6326541E9E879019.avi,85,1330,1018,312,30.648330058939095,morphological_dilation,3,2
0X632854AB56B55732.avi,39,2098,1682,416,24.732461355529132,morphological_dilation,3,2
0X632854AB56B55732.avi,54,1944,1537,407,26.48015614834092,morphological_dilation,3,2
0X63290B350833B632.avi,64,1384,1040,344,33.07692307692307,morphological_dilation,3,2
0X63290B350833B632.avi,74,790,518,272,52.509652509652504,morphological_dilation,3,2
0X632AD4E483D87CBD.avi,153,1624,1240,384,30.967741935483872,morphological_dilation,3,2
0X632AD4E483D87CBD.avi,175,989,623,366,58.74799357945425,morphological_dilation,3,2
0X632B8D7EB7551F43.avi,44,1871,1487,384,25.82380632145259,morphological_dilation,3,2
0X632B8D7EB7551F43.avi,60,1261,929,332,35.737351991388586,morphological_dilation,3,2
0X632DA7234D99F30B.avi,82,1498,1146,352,30.715532286212916,morphological_dilation,3,2
0X632DA7234D99F30B.avi,98,935,647,288,44.513137557959816,morphological_dilation,3,2
0X632E6D2931E7704E.avi,97,2326,1862,464,24.919441460794843,morphological_dilation,3,2
0X632E6D2931E7704E.avi,113,1239,850,389,45.76470588235294,morphological_dilation,3,2
0X6332A156BE67C37E.avi,36,1839,1418,421,29.689703808180536,morphological_dilation,3,2
0X6332A156BE67C37E.avi,52,1132,784,348,44.38775510204081,morphological_dilation,3,2
0X6333AD6F4B44CF29.avi,83,921,623,298,47.8330658105939,morphological_dilation,3,2
0X6333AD6F4B44CF29.avi,98,602,341,261,76.53958944281524,morphological_dilation,3,2
0X63350654272A9811.avi,66,2187,1767,420,23.769100169779286,morphological_dilation,3,2
0X63350654272A9811.avi,75,1648,1276,372,29.153605015673982,morphological_dilation,3,2
0X63374545596F960E.avi,58,1256,940,316,33.61702127659574,morphological_dilation,3,2
0X63374545596F960E.avi,71,911,647,264,40.80370942812983,morphological_dilation,3,2
0X63399D9E4FC71C87.avi,36,1737,1369,368,26.880934989043098,morphological_dilation,3,2
0X63399D9E4FC71C87.avi,47,1090,782,308,39.38618925831202,morphological_dilation,3,2
0X633BC22840D1D199.avi,26,1782,1390,392,28.201438848920862,morphological_dilation,3,2
0X633BC22840D1D199.avi,43,1235,891,344,38.60830527497194,morphological_dilation,3,2
0X633CC4D354E3419.avi,28,2421,1965,456,23.206106870229007,morphological_dilation,3,2
0X633CC4D354E3419.avi,43,1590,1210,380,31.40495867768595,morphological_dilation,3,2
0X633E0E424144D38F.avi,106,2299,1859,440,23.668639053254438,morphological_dilation,3,2
0X633E0E424144D38F.avi,125,1454,1098,356,32.42258652094718,morphological_dilation,3,2
0X633F7FD1EA0A3F2C.avi,52,2602,2150,452,21.02325581395349,morphological_dilation,3,2
0X633F7FD1EA0A3F2C.avi,68,2144,1744,400,22.93577981651376,morphological_dilation,3,2
0X6344130313AAE198.avi,47,1773,1381,392,28.38522809558291,morphological_dilation,3,2
0X6344130313AAE198.avi,66,1042,718,324,45.12534818941504,morphological_dilation,3,2
0X63451086D7DCA911.avi,50,2233,1805,428,23.71191135734072,morphological_dilation,3,2
0X63451086D7DCA911.avi,69,1467,1095,372,33.97260273972603,morphological_dilation,3,2
0X634BBF686F057DC1.avi,67,1354,1010,344,34.05940594059406,morphological_dilation,3,2
0X634BBF686F057DC1.avi,86,1143,827,316,38.21039903264813,morphological_dilation,3,2
0X635245BE8BDD5C3B.avi,30,1482,1144,338,29.545454545454547,morphological_dilation,3,2
0X635245BE8BDD5C3B.avi,43,1259,939,320,34.07880724174654,morphological_dilation,3,2
0X63599F4698755CC6.avi,106,1894,1510,384,25.43046357615894,morphological_dilation,3,2
0X63599F4698755CC6.avi,123,1504,1164,340,29.20962199312715,morphological_dilation,3,2
0X635B3A98A1465315.avi,53,3212,2660,552,20.75187969924812,morphological_dilation,3,2
0X635B3A98A1465315.avi,75,2116,1668,448,26.85851318944844,morphological_dilation,3,2
0X6362AFA11DF8776.avi,106,1625,1222,403,32.97872340425532,morphological_dilation,3,2
0X6362AFA11DF8776.avi,124,966,629,337,53.57710651828299,morphological_dilation,3,2
0X63669FF28E1B1D95.avi,56,1944,1552,392,25.257731958762886,morphological_dilation,3,2
0X63669FF28E1B1D95.avi,73,1196,888,308,34.68468468468468,morphological_dilation,3,2
0X63688D15225DA448.avi,102,2645,2185,460,21.052631578947366,morphological_dilation,3,2
0X63688D15225DA448.avi,122,1766,1358,408,30.04418262150221,morphological_dilation,3,2
0X636B7F7511BA829B.avi,61,1546,1178,368,31.239388794567063,morphological_dilation,3,2
0X636B7F7511BA829B.avi,83,1039,727,312,42.91609353507565,morphological_dilation,3,2
0X63753ABBDD15107.avi,45,1491,1135,356,31.365638766519822,morphological_dilation,3,2
0X63753ABBDD15107.avi,63,937,653,284,43.49157733537519,morphological_dilation,3,2
0X6378B47399B56C39.avi,3,1077,785,292,37.19745222929936,morphological_dilation,3,2
0X6378B47399B56C39.avi,14,868,608,260,42.76315789473684,morphological_dilation,3,2
0X6378E7F2202D8664.avi,43,1229,893,336,37.62597984322508,morphological_dilation,3,2
0X6378E7F2202D8664.avi,55,791,519,272,52.408477842003855,morphological_dilation,3,2
0X637941B5909C74C6.avi,120,1674,1318,356,27.010622154779966,morphological_dilation,3,2
0X637941B5909C74C6.avi,138,1166,858,308,35.8974358974359,morphological_dilation,3,2
0X637ADE9407BD0F0B.avi,59,1084,788,296,37.56345177664975,morphological_dilation,3,2
0X637ADE9407BD0F0B.avi,73,713,469,244,52.02558635394456,morphological_dilation,3,2
0X63800FF8C04208F7.avi,54,1348,1000,348,34.8,morphological_dilation,3,2
0X63800FF8C04208F7.avi,63,820,510,310,60.78431372549019,morphological_dilation,3,2
0X638132579FB600C9.avi,129,2025,1637,388,23.701893708002444,morphological_dilation,3,2
0X638132579FB600C9.avi,142,1241,929,312,33.58449946178686,morphological_dilation,3,2
0X6381C1737EEC6177.avi,44,2065,1649,416,25.227410551849605,morphological_dilation,3,2
0X6381C1737EEC6177.avi,62,1437,1097,340,30.993618960802188,morphological_dilation,3,2
0X63822A2B901BCE0B.avi,27,1620,1236,384,31.06796116504854,morphological_dilation,3,2
0X63822A2B901BCE0B.avi,39,1237,901,336,37.29189789123196,morphological_dilation,3,2
0X6382AE8EB4B73A3D.avi,90,1024,724,300,41.43646408839779,morphological_dilation,3,2
0X6382AE8EB4B73A3D.avi,105,1449,1093,356,32.570905763952425,morphological_dilation,3,2
0X6383E7D4E6CBF731.avi,51,1403,1059,344,32.48347497639282,morphological_dilation,3,2
0X6383E7D4E6CBF731.avi,64,1013,709,304,42.877291960507755,morphological_dilation,3,2
0X63847BB266FD181A.avi,50,2498,2006,492,24.52642073778664,morphological_dilation,3,2
0X63847BB266FD181A.avi,64,2010,1543,467,30.265716137394687,morphological_dilation,3,2
0X6388D094BE0DB303.avi,43,1578,1190,388,32.60504201680672,morphological_dilation,3,2
0X6388D094BE0DB303.avi,58,921,601,320,53.244592346089846,morphological_dilation,3,2
0X638C6EE2A3F451E2.avi,54,1208,904,304,33.6283185840708,morphological_dilation,3,2
0X638C6EE2A3F451E2.avi,61,602,360,242,67.22222222222223,morphological_dilation,3,2
0X63922430844177C0.avi,0,1617,1242,375,30.193236714975846,morphological_dilation,3,2
0X63922430844177C0.avi,16,960,664,296,44.57831325301205,morphological_dilation,3,2
0X639419C07A6F4E33.avi,140,1856,1472,384,26.08695652173913,morphological_dilation,3,2
0X639419C07A6F4E33.avi,157,1140,832,308,37.019230769230774,morphological_dilation,3,2
0X63A09D1D7547F9F5.avi,47,1601,1257,344,27.3667462211615,morphological_dilation,3,2
0X63A09D1D7547F9F5.avi,60,1435,1107,328,29.629629629629626,morphological_dilation,3,2
0X63A25BC012687C7B.avi,38,1970,1586,384,24.211853720050442,morphological_dilation,3,2
0X63A25BC012687C7B.avi,54,1281,965,316,32.7461139896373,morphological_dilation,3,2
0X63A2FB5EC2E1389E.avi,30,1557,1197,360,30.075187969924812,morphological_dilation,3,2
0X63A2FB5EC2E1389E.avi,44,1017,705,312,44.25531914893617,morphological_dilation,3,2
0X63A4F48C162A36DF.avi,95,2012,1608,404,25.12437810945274,morphological_dilation,3,2
0X63A4F48C162A36DF.avi,109,1208,890,318,35.73033707865169,morphological_dilation,3,2
0X63A60FC760B18850.avi,178,1651,1219,432,35.438884331419196,morphological_dilation,3,2
0X63A60FC760B18850.avi,217,919,530,389,73.39622641509433,morphological_dilation,3,2
0X63A862F83C131D52.avi,23,1937,1529,408,26.68410725964683,morphological_dilation,3,2
0X63A862F83C131D52.avi,44,1412,1036,376,36.293436293436294,morphological_dilation,3,2
0X63AAC8D84C8943CD.avi,101,1530,1170,360,30.76923076923077,morphological_dilation,3,2
0X63AAC8D84C8943CD.avi,119,894,626,268,42.81150159744409,morphological_dilation,3,2
0X63ACB6EE3DB9AEA2.avi,56,1432,1084,348,32.10332103321033,morphological_dilation,3,2
0X63ACB6EE3DB9AEA2.avi,73,912,614,298,48.534201954397396,morphological_dilation,3,2
0X63AF6B967333B029.avi,2,2111,1691,420,24.83737433471319,morphological_dilation,3,2
0X63AF6B967333B029.avi,17,1295,947,348,36.74762407602957,morphological_dilation,3,2
0X63B0796D03779A29.avi,50,2405,1973,432,21.895590471363406,morphological_dilation,3,2
0X63B0796D03779A29.avi,72,1989,1613,376,23.310601363918167,morphological_dilation,3,2
0X63B0B34DDE691EE7.avi,83,1895,1511,384,25.413633355393777,morphological_dilation,3,2
0X63B0B34DDE691EE7.avi,98,1421,1085,336,30.967741935483872,morphological_dilation,3,2
0X63C0C93E76565075.avi,56,6895,6216,679,10.923423423423422,morphological_dilation,3,2
0X63C0C93E76565075.avi,72,4747,4059,688,16.949987681695,morphological_dilation,3,2
0X63C523280C2468E5.avi,82,2146,1714,432,25.204200700116687,morphological_dilation,3,2
0X63C523280C2468E5.avi,96,1278,906,372,41.05960264900662,morphological_dilation,3,2
0X63C937BD4B524E5B.avi,1,1777,1397,380,27.20114531138153,morphological_dilation,3,2
0X63C937BD4B524E5B.avi,19,1159,835,324,38.80239520958084,morphological_dilation,3,2
0X63CC93D7D9696690.avi,113,1336,1012,324,32.015810276679844,morphological_dilation,3,2
0X63CC93D7D9696690.avi,131,839,569,270,47.45166959578208,morphological_dilation,3,2
0X63CF06323DEE2000.avi,82,2734,2250,484,21.511111111111113,morphological_dilation,3,2
0X63CF06323DEE2000.avi,102,1510,1134,376,33.15696649029982,morphological_dilation,3,2
0X63CFB3C6EE79599C.avi,7,1418,1090,328,30.091743119266056,morphological_dilation,3,2
0X63CFB3C6EE79599C.avi,18,947,675,272,40.2962962962963,morphological_dilation,3,2
0X63CFF3F10BD4D1E8.avi,53,2439,1975,464,23.49367088607595,morphological_dilation,3,2
0X63CFF3F10BD4D1E8.avi,70,1475,1111,364,32.76327632763276,morphological_dilation,3,2
0X63D04F4EEBAEBD3E.avi,106,3251,2719,532,19.566016917984552,morphological_dilation,3,2
0X63D04F4EEBAEBD3E.avi,126,1750,1334,416,31.184407796101947,morphological_dilation,3,2
0X63D0E9E163F1A41A.avi,44,1085,769,316,41.0923276983095,morphological_dilation,3,2
0X63D0E9E163F1A41A.avi,56,703,430,273,63.48837209302326,morphological_dilation,3,2
0X63D186913EF56E46.avi,44,2032,1644,388,23.600973236009732,morphological_dilation,3,2
0X63D186913EF56E46.avi,61,1273,965,308,31.917098445595855,morphological_dilation,3,2
0X63D28BAEA7C66804.avi,31,1728,1352,376,27.810650887573964,morphological_dilation,3,2
0X63D28BAEA7C66804.avi,45,1136,808,328,40.5940594059406,morphological_dilation,3,2
0X63D855538102DCA1.avi,67,1315,979,336,34.32073544433095,morphological_dilation,3,2
0X63D855538102DCA1.avi,85,865,579,286,49.395509499136445,morphological_dilation,3,2
0X63DAA4BAC6177001.avi,67,2296,1852,444,23.974082073434126,morphological_dilation,3,2
0X63DAA4BAC6177001.avi,85,1290,910,380,41.75824175824176,morphological_dilation,3,2
0X63E41C64661C0696.avi,140,1683,1301,382,29.362029208301305,morphological_dilation,3,2
0X63E41C64661C0696.avi,159,909,621,288,46.3768115942029,morphological_dilation,3,2
0X63E434559D0852DE.avi,64,1585,1229,356,28.966639544344996,morphological_dilation,3,2
0X63E434559D0852DE.avi,85,1139,843,296,35.11269276393831,morphological_dilation,3,2
0X63E4C2DD767A2E7F.avi,67,1622,1246,376,30.17656500802568,morphological_dilation,3,2
0X63E4C2DD767A2E7F.avi,86,1333,985,348,35.32994923857868,morphological_dilation,3,2
0X63E4EABEC5781C.avi,50,1618,1246,372,29.85553772070626,morphological_dilation,3,2
0X63E4EABEC5781C.avi,65,745,487,258,52.977412731006154,morphological_dilation,3,2
0X63E53A89D55764E3.avi,34,2085,1678,407,24.25506555423123,morphological_dilation,3,2
0X63E53A89D55764E3.avi,51,1665,1299,366,28.17551963048499,morphological_dilation,3,2
0X63E6231DF8337689.avi,48,1653,1273,380,29.850746268656714,morphological_dilation,3,2
0X63E6231DF8337689.avi,62,1105,801,304,37.95255930087391,morphological_dilation,3,2
0X63EFA5F7FFFB0014.avi,82,2861,2361,500,21.17746717492588,morphological_dilation,3,2
0X63EFA5F7FFFB0014.avi,101,2001,1581,420,26.56546489563567,morphological_dilation,3,2
0X63F67FDA7F9B0C34.avi,95,2372,1936,436,22.520661157024794,morphological_dilation,3,2
0X63F67FDA7F9B0C34.avi,107,1721,1329,392,29.49586155003762,morphological_dilation,3,2
0X63F79AE85D25960E.avi,37,1550,1210,340,28.09917355371901,morphological_dilation,3,2
0X63F79AE85D25960E.avi,51,1075,775,300,38.70967741935484,morphological_dilation,3,2
0X63FD72B89AACC089.avi,75,1453,1089,364,33.42516069788797,morphological_dilation,3,2
0X63FD72B89AACC089.avi,88,990,686,304,44.31486880466473,morphological_dilation,3,2
0X63FECBA90BA79F81.avi,151,2720,2260,460,20.353982300884958,morphological_dilation,3,2
0X63FECBA90BA79F81.avi,169,1594,1234,360,29.17341977309562,morphological_dilation,3,2
0X6400D44A81CDC666.avi,31,1224,900,324,36.0,morphological_dilation,3,2
0X6400D44A81CDC666.avi,41,657,405,252,62.22222222222222,morphological_dilation,3,2
0X6406F656D85D613.avi,39,1784,1396,388,27.793696275071632,morphological_dilation,3,2
0X6406F656D85D613.avi,56,1289,953,336,35.257082896117524,morphological_dilation,3,2
0X64099CA1B1AE23FD.avi,2,1402,1062,340,32.015065913371,morphological_dilation,3,2
0X64099CA1B1AE23FD.avi,17,860,572,288,50.349650349650354,morphological_dilation,3,2
0X640B3C771632C834.avi,184,2587,2115,472,22.31678486997636,morphological_dilation,3,2
0X640B3C771632C834.avi,207,1607,1227,380,30.969845150774244,morphological_dilation,3,2
0X640BEAA86E433A60.avi,25,1214,905,309,34.14364640883978,morphological_dilation,3,2
0X640BEAA86E433A60.avi,45,727,491,236,48.06517311608962,morphological_dilation,3,2
0X640CE139BAA401B2.avi,73,2856,2352,504,21.428571428571427,morphological_dilation,3,2
0X640CE139BAA401B2.avi,92,1663,1273,390,30.63629222309505,morphological_dilation,3,2
0X640DF0986ACFEB8C.avi,46,1420,1082,338,31.23844731977819,morphological_dilation,3,2
0X640DF0986ACFEB8C.avi,67,890,612,278,45.42483660130719,morphological_dilation,3,2
0X641187BA5EAA4331.avi,94,2003,1591,412,25.895663104965433,morphological_dilation,3,2
0X641187BA5EAA4331.avi,111,1296,956,340,35.56485355648535,morphological_dilation,3,2
0X64153B07B714C730.avi,34,1510,1162,348,29.948364888123923,morphological_dilation,3,2
0X64153B07B714C730.avi,49,944,636,308,48.42767295597484,morphological_dilation,3,2
0X641675ED5FBFD2FB.avi,47,1735,1363,372,27.292736610418196,morphological_dilation,3,2
0X641675ED5FBFD2FB.avi,61,1023,727,296,40.715268225584595,morphological_dilation,3,2
0X6418370A8B0A2187.avi,141,2237,1809,428,23.659480375898287,morphological_dilation,3,2
0X6418370A8B0A2187.avi,167,1842,1450,392,27.034482758620687,morphological_dilation,3,2
0X64188A16B85C8527.avi,35,3201,2685,516,19.217877094972067,morphological_dilation,3,2
0X64188A16B85C8527.avi,47,1765,1365,400,29.304029304029307,morphological_dilation,3,2
0X64196964401D2938.avi,41,1671,1275,396,31.058823529411768,morphological_dilation,3,2
0X64196964401D2938.avi,56,958,666,292,43.84384384384384,morphological_dilation,3,2
0X641D26A1B0745A7E.avi,156,1694,1278,416,32.550860719874805,morphological_dilation,3,2
0X641D26A1B0745A7E.avi,170,1107,699,408,58.36909871244635,morphological_dilation,3,2
0X6423EE8AA54159E9.avi,130,1965,1569,396,25.239005736137663,morphological_dilation,3,2
0X6423EE8AA54159E9.avi,141,1103,791,312,39.443742098609356,morphological_dilation,3,2
0X6426324539E692CB.avi,92,2200,1792,408,22.767857142857142,morphological_dilation,3,2
0X6426324539E692CB.avi,110,1523,1171,352,30.0597779675491,morphological_dilation,3,2
0X642AB0D752EAB589.avi,38,1479,1119,360,32.171581769437,morphological_dilation,3,2
0X642AB0D752EAB589.avi,52,906,622,284,45.659163987138264,morphological_dilation,3,2
0X642D54AB691E0FC0.avi,66,1887,1507,380,25.215660252156603,morphological_dilation,3,2
0X642D54AB691E0FC0.avi,87,1211,895,316,35.3072625698324,morphological_dilation,3,2
0X642E639A8CDE539B.avi,89,1600,1224,376,30.718954248366014,morphological_dilation,3,2
0X642E639A8CDE539B.avi,141,1483,1017,466,45.82104228121927,morphological_dilation,3,2
0X642E683AF1A5244C.avi,47,1858,1466,392,26.73942701227831,morphological_dilation,3,2
0X642E683AF1A5244C.avi,63,1136,809,327,40.42027194066749,morphological_dilation,3,2
0X64342D77565BCE3.avi,103,1877,1485,392,26.397306397306398,morphological_dilation,3,2
0X64342D77565BCE3.avi,117,1131,815,316,38.77300613496932,morphological_dilation,3,2
0X64346E030157ED80.avi,136,2055,1619,436,26.930203829524395,morphological_dilation,3,2
0X64346E030157ED80.avi,156,1195,859,336,39.11525029103609,morphological_dilation,3,2
0X643525F6DB08BF41.avi,34,1375,1047,328,31.32760267430755,morphological_dilation,3,2
0X643525F6DB08BF41.avi,45,872,600,272,45.33333333333333,morphological_dilation,3,2
0X643B9D92868C371B.avi,0,1733,1357,376,27.708179808400885,morphological_dilation,3,2
0X643B9D92868C371B.avi,14,986,682,304,44.57478005865102,morphological_dilation,3,2
0X643D753BD3302E6B.avi,92,1668,1280,388,30.312499999999996,morphological_dilation,3,2
0X643D753BD3302E6B.avi,106,960,656,304,46.34146341463415,morphological_dilation,3,2
0X64402E4398BFCFC2.avi,80,1000,700,300,42.857142857142854,morphological_dilation,3,2
0X64402E4398BFCFC2.avi,98,627,379,248,65.4353562005277,morphological_dilation,3,2
0X6440E65AC7ED5668.avi,0,1000,708,292,41.24293785310734,morphological_dilation,3,2
0X6440E65AC7ED5668.avi,16,600,360,240,66.66666666666666,morphological_dilation,3,2
0X644477CB728755E0.avi,92,1617,1243,374,30.08849557522124,morphological_dilation,3,2
0X644477CB728755E0.avi,109,1049,745,304,40.80536912751678,morphological_dilation,3,2
0X64452FF284C03039.avi,1,1582,1222,360,29.45990180032733,morphological_dilation,3,2
0X64452FF284C03039.avi,14,1014,710,304,42.816901408450704,morphological_dilation,3,2
0X6446D01F5B6E082.avi,70,2279,1863,416,22.32957595276436,morphological_dilation,3,2
0X6446D01F5B6E082.avi,84,2031,1627,404,24.830977258758452,morphological_dilation,3,2
0X6447EF85C60A98FC.avi,161,2118,1698,420,24.73498233215548,morphological_dilation,3,2
0X6447EF85C60A98FC.avi,174,1256,912,344,37.719298245614034,morphological_dilation,3,2
0X644EF08C46882EC3.avi,40,1997,1601,396,24.734540911930043,morphological_dilation,3,2
0X644EF08C46882EC3.avi,57,1177,843,334,39.62040332147094,morphological_dilation,3,2
0X64567227AC006B23.avi,50,998,710,288,40.563380281690144,morphological_dilation,3,2
0X64567227AC006B23.avi,64,832,557,275,49.371633752244165,morphological_dilation,3,2
0X6456DAE3F9D1538B.avi,93,2033,1641,392,23.8878732480195,morphological_dilation,3,2
0X6456DAE3F9D1538B.avi,106,1424,1076,348,32.342007434944236,morphological_dilation,3,2
0X6456F968787519E7.avi,77,3027,2519,508,20.16673283048829,morphological_dilation,3,2
0X6456F968787519E7.avi,98,1960,1544,416,26.94300518134715,morphological_dilation,3,2
0X6459870D85C30216.avi,104,1731,1367,364,26.627651792245793,morphological_dilation,3,2
0X6459870D85C30216.avi,120,1112,808,304,37.62376237623762,morphological_dilation,3,2
0X645D545CEC6B682.avi,41,1869,1481,388,26.198514517218097,morphological_dilation,3,2
0X645D545CEC6B682.avi,62,1374,1038,336,32.369942196531795,morphological_dilation,3,2
0X645DA49E73828690.avi,66,1941,1529,412,26.94571615434925,morphological_dilation,3,2
0X645DA49E73828690.avi,81,1145,817,328,40.1468788249694,morphological_dilation,3,2
0X645F2FD9B7EB9211.avi,66,1406,1070,336,31.401869158878505,morphological_dilation,3,2
0X645F2FD9B7EB9211.avi,83,838,558,280,50.179211469534046,morphological_dilation,3,2
0X6460CABD12C329D4.avi,61,3334,2802,532,18.98643825838687,morphological_dilation,3,2
0X6460CABD12C329D4.avi,78,2447,1991,456,22.903063787041688,morphological_dilation,3,2
0X6462C027F89C1319.avi,48,2385,1933,452,23.38334195550957,morphological_dilation,3,2
0X6462C027F89C1319.avi,65,1834,1434,400,27.89400278940028,morphological_dilation,3,2
0X64645749B8E566B9.avi,67,1977,1541,436,28.29331602855289,morphological_dilation,3,2
0X64645749B8E566B9.avi,84,1277,913,364,39.86856516976999,morphological_dilation,3,2
0X6467B6237F51BCE.avi,43,1877,1497,380,25.384101536406146,morphological_dilation,3,2
0X6467B6237F51BCE.avi,59,1289,957,332,34.69174503657263,morphological_dilation,3,2
0X6467DCE2362FB3B3.avi,49,3297,2769,528,19.068255687974,morphological_dilation,3,2
0X6467DCE2362FB3B3.avi,70,2035,1604,431,26.870324189526183,morphological_dilation,3,2
0X646CABD4DAB1BF83.avi,78,1854,1470,384,26.122448979591837,morphological_dilation,3,2
0X646CABD4DAB1BF83.avi,93,1231,891,340,38.15937149270482,morphological_dilation,3,2
0X6471525F25F5395F.avi,82,1684,1277,407,31.871574001566174,morphological_dilation,3,2
0X6471525F25F5395F.avi,96,962,654,308,47.09480122324159,morphological_dilation,3,2
0X647499F6DA710D4F.avi,121,1620,1272,348,27.358490566037734,morphological_dilation,3,2
0X647499F6DA710D4F.avi,140,1131,811,320,39.457459926017265,morphological_dilation,3,2
0X6475EE6823D4912D.avi,30,1440,1072,368,34.32835820895522,morphological_dilation,3,2
0X6475EE6823D4912D.avi,40,969,665,304,45.714285714285715,morphological_dilation,3,2
0X647668461C467044.avi,40,1956,1556,400,25.70694087403599,morphological_dilation,3,2
0X647668461C467044.avi,54,998,694,304,43.804034582132566,morphological_dilation,3,2
0X6478438459208AD5.avi,33,1366,1026,340,33.13840155945419,morphological_dilation,3,2
0X6478438459208AD5.avi,45,1099,783,316,40.357598978288635,morphological_dilation,3,2
0X647970156BD4D14A.avi,57,1837,1461,376,25.735797399041754,morphological_dilation,3,2
0X647970156BD4D14A.avi,76,1257,937,320,34.15154749199573,morphological_dilation,3,2
0X6479BEFEFDB47B80.avi,34,2245,1821,424,23.28390993959363,morphological_dilation,3,2
0X6479BEFEFDB47B80.avi,49,1460,1116,344,30.824372759856633,morphological_dilation,3,2
0X647C3D4FCD2C623C.avi,54,1310,970,340,35.051546391752574,morphological_dilation,3,2
0X647C3D4FCD2C623C.avi,66,952,648,304,46.913580246913575,morphological_dilation,3,2
0X647C40B261C13DD4.avi,44,1629,1253,376,30.007980845969673,morphological_dilation,3,2
0X647C40B261C13DD4.avi,59,993,689,304,44.12191582002903,morphological_dilation,3,2
0X647CDD011149BFBB.avi,127,2739,2245,494,22.00445434298441,morphological_dilation,3,2
0X647CDD011149BFBB.avi,144,1628,1232,396,32.142857142857146,morphological_dilation,3,2
0X648EBE05D8EF7CFE.avi,104,1554,1186,368,31.02866779089376,morphological_dilation,3,2
0X648EBE05D8EF7CFE.avi,122,1252,904,348,38.49557522123894,morphological_dilation,3,2
0X64901E9D47895B5B.avi,107,1416,1073,343,31.966449207828518,morphological_dilation,3,2
0X64901E9D47895B5B.avi,123,990,694,296,42.65129682997118,morphological_dilation,3,2
0X6493CA2C0B218D5D.avi,106,3662,3070,592,19.283387622149835,morphological_dilation,3,2
0X6493CA2C0B218D5D.avi,133,2483,1978,505,25.530839231547013,morphological_dilation,3,2
0X64991BE928F68684.avi,125,1846,1458,388,26.611796982167352,morphological_dilation,3,2
0X64991BE928F68684.avi,146,1097,777,320,41.184041184041185,morphological_dilation,3,2
0X64A9B5E4315CE2EE.avi,114,2700,2236,464,20.75134168157424,morphological_dilation,3,2
0X64A9B5E4315CE2EE.avi,131,1770,1378,392,28.44702467343977,morphological_dilation,3,2
0X64AB025500AB6DBC.avi,139,1411,1059,352,33.23890462700661,morphological_dilation,3,2
0X64AB025500AB6DBC.avi,158,794,530,264,49.81132075471698,morphological_dilation,3,2
0X64ABDEF4276C88D0.avi,101,2928,2396,532,22.20367278797997,morphological_dilation,3,2
0X64ABDEF4276C88D0.avi,116,1548,1152,396,34.375,morphological_dilation,3,2
0X64AD5CE84D6CC19E.avi,47,2080,1684,396,23.51543942992874,morphological_dilation,3,2
0X64AD5CE84D6CC19E.avi,64,1353,1025,328,32.0,morphological_dilation,3,2
0X64B2B77B0C551FE4.avi,37,1488,1116,372,33.33333333333333,morphological_dilation,3,2
0X64B2B77B0C551FE4.avi,48,1131,799,332,41.55193992490614,morphological_dilation,3,2
0X64B3193E01E9E5BA.avi,89,1826,1426,400,28.050490883590463,morphological_dilation,3,2
0X64B3193E01E9E5BA.avi,106,1501,1122,379,33.7789661319073,morphological_dilation,3,2
0X64B7294110706DC5.avi,79,3170,2642,528,19.984859954579864,morphological_dilation,3,2
0X64B7294110706DC5.avi,94,1819,1415,404,28.551236749116608,morphological_dilation,3,2
0X64C7A83C1CB202F2.avi,88,1773,1393,380,27.27925340990668,morphological_dilation,3,2
0X64C7A83C1CB202F2.avi,105,1114,794,320,40.302267002518896,morphological_dilation,3,2
0X64C7EC2ED7DBD367.avi,39,3462,2953,509,17.236708432102947,morphological_dilation,3,2
0X64C7EC2ED7DBD367.avi,54,2223,1787,436,24.398433128147733,morphological_dilation,3,2
0X64C8728B8D1EC69B.avi,95,1530,1166,364,31.217838765008576,morphological_dilation,3,2
0X64C8728B8D1EC69B.avi,110,929,637,292,45.839874411302986,morphological_dilation,3,2
0X64CA842A0F36035.avi,44,4634,4002,632,15.792103948025987,morphological_dilation,3,2
0X64CA842A0F36035.avi,64,2546,2070,476,22.995169082125607,morphological_dilation,3,2
0X64CAD12B7716CD96.avi,36,1250,918,332,36.165577342047925,morphological_dilation,3,2
0X64CAD12B7716CD96.avi,52,792,512,280,54.6875,morphological_dilation,3,2
0X64CD34F0EAB6D008.avi,67,1869,1467,402,27.402862985685072,morphological_dilation,3,2
0X64CD34F0EAB6D008.avi,89,1130,790,340,43.037974683544306,morphological_dilation,3,2
0X64CD75A3087F44C.avi,111,1610,1214,396,32.61943986820428,morphological_dilation,3,2
0X64CD75A3087F44C.avi,135,1257,901,356,39.51165371809101,morphological_dilation,3,2
0X64CD8BFE328160BA.avi,4,1373,1045,328,31.38755980861244,morphological_dilation,3,2
0X64CD8BFE328160BA.avi,20,871,615,256,41.6260162601626,morphological_dilation,3,2
0X64D192FDC5030E7E.avi,104,1467,1111,356,32.04320432043205,morphological_dilation,3,2
0X64D192FDC5030E7E.avi,122,1032,732,300,40.98360655737705,morphological_dilation,3,2
0X64D1B760B0B33F99.avi,39,1991,1599,392,24.515322076297686,morphological_dilation,3,2
0X64D1B760B0B33F99.avi,52,1291,951,340,35.75184016824395,morphological_dilation,3,2
0X64D572D8F917F0FE.avi,43,1804,1432,372,25.977653631284912,morphological_dilation,3,2
0X64D572D8F917F0FE.avi,59,1341,1013,328,32.379072063178675,morphological_dilation,3,2
0X64D5C407FA568640.avi,95,2368,1908,460,24.10901467505241,morphological_dilation,3,2
0X64D5C407FA568640.avi,109,1363,988,375,37.955465587044536,morphological_dilation,3,2
0X64D5CA3CF6F65F27.avi,50,2119,1715,404,23.556851311953352,morphological_dilation,3,2
0X64D5CA3CF6F65F27.avi,68,1543,1191,352,29.554995801847188,morphological_dilation,3,2
0X64D81B504D7FF03C.avi,39,1896,1493,403,26.992632283991963,morphological_dilation,3,2
0X64D81B504D7FF03C.avi,56,1166,830,336,40.48192771084337,morphological_dilation,3,2
0X64DCDB6CC0B251FA.avi,52,1372,1040,332,31.92307692307692,morphological_dilation,3,2
0X64DCDB6CC0B251FA.avi,69,808,515,293,56.89320388349515,morphological_dilation,3,2
0X64E2FC6E99FAF669.avi,54,2103,1687,416,24.659158269116777,morphological_dilation,3,2
0X64E2FC6E99FAF669.avi,74,1481,1109,372,33.543733092876465,morphological_dilation,3,2
0X64E3F029012A62AA.avi,134,1985,1577,408,25.8719086873811,morphological_dilation,3,2
0X64E3F029012A62AA.avi,154,1449,1085,364,33.5483870967742,morphological_dilation,3,2
0X64E76A6139910CB9.avi,51,1001,713,288,40.39270687237027,morphological_dilation,3,2
0X64E76A6139910CB9.avi,67,682,401,281,70.07481296758104,morphological_dilation,3,2
0X64EE9FFA5DA69058.avi,68,1225,921,304,33.00760043431053,morphological_dilation,3,2
0X64EE9FFA5DA69058.avi,78,784,527,257,48.76660341555977,morphological_dilation,3,2
0X64FAE0A9E0740D03.avi,70,1579,1219,360,29.532403609515995,morphological_dilation,3,2
0X64FAE0A9E0740D03.avi,84,909,629,280,44.51510333863275,morphological_dilation,3,2
0X65072FB226CAD3B2.avi,53,1741,1353,388,28.6770140428677,morphological_dilation,3,2
0X65072FB226CAD3B2.avi,72,1094,761,333,43.75821287779238,morphological_dilation,3,2
0X6507E201943B22B1.avi,55,1881,1477,404,27.352742044685176,morphological_dilation,3,2
0X6507E201943B22B1.avi,72,1148,804,344,42.78606965174129,morphological_dilation,3,2
0X650881B7ADEF9668.avi,157,1636,1268,368,29.02208201892745,morphological_dilation,3,2
0X650881B7ADEF9668.avi,179,933,653,280,42.87901990811638,morphological_dilation,3,2
0X6508990DC3493349.avi,45,2080,1664,416,25.0,morphological_dilation,3,2
0X6508990DC3493349.avi,60,1269,921,348,37.785016286644954,morphological_dilation,3,2
0X650A05F9B5D9F425.avi,134,1747,1367,380,27.79809802487198,morphological_dilation,3,2
0X650A05F9B5D9F425.avi,147,1112,784,328,41.83673469387755,morphological_dilation,3,2
0X650C78FAA0312711.avi,1,1696,1332,364,27.32732732732733,morphological_dilation,3,2
0X650C78FAA0312711.avi,14,1062,758,304,40.105540897097626,morphological_dilation,3,2
0X65115C498B497C14.avi,96,1728,1344,384,28.57142857142857,morphological_dilation,3,2
0X65115C498B497C14.avi,118,1137,813,324,39.85239852398524,morphological_dilation,3,2
0X6517121A1CC175DC.avi,0,1694,1322,372,28.139183055975792,morphological_dilation,3,2
0X6517121A1CC175DC.avi,22,1070,758,312,41.16094986807388,morphological_dilation,3,2
0X6518D5BFE63259EF.avi,51,1613,1233,380,30.8191403081914,morphological_dilation,3,2
0X6518D5BFE63259EF.avi,71,963,667,296,44.377811094452774,morphological_dilation,3,2
0X65208512A67B9529.avi,48,1797,1405,392,27.900355871886124,morphological_dilation,3,2
0X65208512A67B9529.avi,64,1080,768,312,40.625,morphological_dilation,3,2
0X652153F7E83F458F.avi,46,1075,771,304,39.429312581063556,morphological_dilation,3,2
0X652153F7E83F458F.avi,60,730,482,248,51.45228215767634,morphological_dilation,3,2
0X6524AC0A6E1ABC5C.avi,86,1741,1365,376,27.545787545787547,morphological_dilation,3,2
0X6524AC0A6E1ABC5C.avi,103,1140,812,328,40.39408866995074,morphological_dilation,3,2
0X652774B9B23300A4.avi,40,2005,1585,420,26.498422712933756,morphological_dilation,3,2
0X652774B9B23300A4.avi,58,1170,793,377,47.540983606557376,morphological_dilation,3,2
0X6528D2CD71A27968.avi,37,1146,851,295,34.665099882491184,morphological_dilation,3,2
0X6528D2CD71A27968.avi,52,921,646,275,42.56965944272446,morphological_dilation,3,2
0X652B75C6FB4BE598.avi,29,1606,1262,344,27.258320126782888,morphological_dilation,3,2
0X652B75C6FB4BE598.avi,47,1338,1026,312,30.409356725146196,morphological_dilation,3,2
0X652C7A5FA55C5201.avi,148,1662,1290,372,28.837209302325583,morphological_dilation,3,2
0X652C7A5FA55C5201.avi,168,1109,793,316,39.84867591424969,morphological_dilation,3,2
0X652ECB6DE3326FE9.avi,133,2451,2025,426,21.037037037037038,morphological_dilation,3,2
0X652ECB6DE3326FE9.avi,151,1876,1496,380,25.40106951871658,morphological_dilation,3,2
0X65308E5E0624A6C1.avi,44,1617,1253,364,29.05027932960894,morphological_dilation,3,2
0X65308E5E0624A6C1.avi,60,1287,957,330,34.48275862068966,morphological_dilation,3,2
0X653188DF2B81C1F9.avi,43,2603,2114,489,23.13150425733207,morphological_dilation,3,2
0X653188DF2B81C1F9.avi,62,1891,1463,428,29.254955570745047,morphological_dilation,3,2
0X653267FDDD4EF0E7.avi,109,2736,2268,468,20.634920634920633,morphological_dilation,3,2
0X653267FDDD4EF0E7.avi,129,2296,1876,420,22.388059701492537,morphological_dilation,3,2
0X6532C54260D0231.avi,118,870,582,288,49.48453608247423,morphological_dilation,3,2
0X6532C54260D0231.avi,130,1254,926,328,35.42116630669546,morphological_dilation,3,2
0X6534AE7ED9A039EE.avi,0,1636,1264,372,29.430379746835445,morphological_dilation,3,2
0X6534AE7ED9A039EE.avi,18,1037,685,352,51.386861313868614,morphological_dilation,3,2
0X6535F819C7185C51.avi,1,1847,1449,398,27.4672187715666,morphological_dilation,3,2
0X6535F819C7185C51.avi,18,1183,852,331,38.84976525821596,morphological_dilation,3,2
0X653C793B3F2B3510.avi,47,2158,1738,420,24.165707710011507,morphological_dilation,3,2
0X653C793B3F2B3510.avi,67,1571,1192,379,31.79530201342282,morphological_dilation,3,2
0X653CC913017A8C19.avi,114,2080,1664,416,25.0,morphological_dilation,3,2
0X653CC913017A8C19.avi,134,1229,901,328,36.40399556048835,morphological_dilation,3,2
0X6541D7939DEF6989.avi,40,1216,908,308,33.92070484581498,morphological_dilation,3,2
0X6541D7939DEF6989.avi,58,884,616,268,43.506493506493506,morphological_dilation,3,2
0X6544ED8E3D660B88.avi,77,2077,1649,428,25.955124317768348,morphological_dilation,3,2
0X6544ED8E3D660B88.avi,96,1460,1100,360,32.72727272727273,morphological_dilation,3,2
0X6545D8FA38575CBF.avi,38,1907,1519,388,25.54312047399605,morphological_dilation,3,2
0X6545D8FA38575CBF.avi,53,1103,783,320,40.86845466155811,morphological_dilation,3,2
0X654B16581A5CE299.avi,46,1688,1288,400,31.05590062111801,morphological_dilation,3,2
0X654B16581A5CE299.avi,61,1049,729,320,43.895747599451305,morphological_dilation,3,2
0X654CBBC325689148.avi,55,1965,1553,412,26.52929813264649,morphological_dilation,3,2
0X654CBBC325689148.avi,71,1132,808,324,40.099009900990104,morphological_dilation,3,2
0X655147B40196C1D3.avi,71,1308,976,332,34.01639344262295,morphological_dilation,3,2
0X655147B40196C1D3.avi,95,863,578,285,49.30795847750865,morphological_dilation,3,2
0X65516451A2E52F44.avi,74,2067,1637,430,26.267562614538793,morphological_dilation,3,2
0X65516451A2E52F44.avi,88,1321,969,352,36.326109391124874,morphological_dilation,3,2
0X655399113DAA4ECC.avi,0,1790,1418,372,26.234132581100138,morphological_dilation,3,2
0X655399113DAA4ECC.avi,16,1895,1433,462,32.2400558269365,morphological_dilation,3,2
0X65552642DAE0A494.avi,41,1912,1528,384,25.13089005235602,morphological_dilation,3,2
0X65552642DAE0A494.avi,54,1366,1038,328,31.59922928709056,morphological_dilation,3,2
0X65566D21DE3607C0.avi,63,1639,1287,352,27.350427350427353,morphological_dilation,3,2
0X65566D21DE3607C0.avi,82,932,644,288,44.72049689440994,morphological_dilation,3,2
0X6560CC6E271F6D21.avi,51,3543,3007,536,17.825074825407384,morphological_dilation,3,2
0X6560CC6E271F6D21.avi,67,2136,1708,428,25.05854800936768,morphological_dilation,3,2
0X656705047098A5FC.avi,49,2844,2368,476,20.10135135135135,morphological_dilation,3,2
0X656705047098A5FC.avi,70,1596,1220,376,30.81967213114754,morphological_dilation,3,2
0X656969EB60FFF3D0.avi,35,1453,1077,376,34.91179201485608,morphological_dilation,3,2
0X656969EB60FFF3D0.avi,51,988,664,324,48.795180722891565,morphological_dilation,3,2
0X65701772634F735F.avi,53,3488,2976,512,17.20430107526882,morphological_dilation,3,2
0X65701772634F735F.avi,67,2743,2263,480,21.210782147591694,morphological_dilation,3,2
0X6570BEE903D51DFE.avi,40,1362,1022,340,33.268101761252446,morphological_dilation,3,2
0X6570BEE903D51DFE.avi,54,908,616,292,47.4025974025974,morphological_dilation,3,2
0X6570FEF9FC36D7C2.avi,110,1790,1414,376,26.591230551626595,morphological_dilation,3,2
0X6570FEF9FC36D7C2.avi,127,1043,739,304,41.13667117726658,morphological_dilation,3,2
0X657253CA562EF468.avi,91,1446,1072,374,34.88805970149254,morphological_dilation,3,2
0X657253CA562EF468.avi,108,1012,719,293,40.75104311543811,morphological_dilation,3,2
0X65753CA4ABFD5B4D.avi,90,1126,809,317,39.18417799752781,morphological_dilation,3,2
0X65753CA4ABFD5B4D.avi,107,683,419,264,63.0071599045346,morphological_dilation,3,2
0X6575ED8B607878CF.avi,99,3049,2553,496,19.428123775949864,morphological_dilation,3,2
0X6575ED8B607878CF.avi,117,2568,2093,475,22.694696607740088,morphological_dilation,3,2
0X6575EF6E0F584F4F.avi,105,2614,2154,460,21.35561745589601,morphological_dilation,3,2
0X6575EF6E0F584F4F.avi,122,2399,1959,440,22.460438999489536,morphological_dilation,3,2
0X657773E06E5DC8CF.avi,40,3012,2488,524,21.061093247588424,morphological_dilation,3,2
0X657773E06E5DC8CF.avi,57,1820,1400,420,30.0,morphological_dilation,3,2
0X657AF47EF22C6290.avi,82,1830,1454,376,25.859697386519947,morphological_dilation,3,2
0X657AF47EF22C6290.avi,100,1191,895,296,33.07262569832402,morphological_dilation,3,2
0X657F7B916C0A37BF.avi,92,1731,1323,408,30.839002267573694,morphological_dilation,3,2
0X657F7B916C0A37BF.avi,105,1103,738,365,49.457994579945805,morphological_dilation,3,2
0X65834A48C2AB3649.avi,100,2687,2207,480,21.74898051653829,morphological_dilation,3,2
0X65834A48C2AB3649.avi,118,1574,1186,388,32.715008431703204,morphological_dilation,3,2
0X6586C3F1D344FDFB.avi,39,1463,1119,344,30.741733690795353,morphological_dilation,3,2
0X6586C3F1D344FDFB.avi,57,1079,767,312,40.67796610169492,morphological_dilation,3,2
0X65880EF54397293E.avi,46,1841,1467,374,25.49420586230402,morphological_dilation,3,2
0X65880EF54397293E.avi,62,1333,1005,328,32.63681592039801,morphological_dilation,3,2
0X658AC1BA93532526.avi,100,2096,1692,404,23.87706855791962,morphological_dilation,3,2
0X658AC1BA93532526.avi,118,1231,911,320,35.12623490669594,morphological_dilation,3,2
0X658AEA4B6FB6C69C.avi,75,1933,1537,396,25.764476252439817,morphological_dilation,3,2
0X658AEA4B6FB6C69C.avi,93,1646,1286,360,27.993779160186627,morphological_dilation,3,2
0X658BF7B9A9C6B4DD.avi,49,1535,1183,352,29.754860524091292,morphological_dilation,3,2
0X658BF7B9A9C6B4DD.avi,64,983,695,288,41.43884892086331,morphological_dilation,3,2
0X65903F79E0D91D80.avi,64,1820,1416,404,28.53107344632768,morphological_dilation,3,2
0X65903F79E0D91D80.avi,79,1361,1013,348,34.35340572556762,morphological_dilation,3,2
0X659315B077CFCAE2.avi,33,2045,1626,419,25.768757687576876,morphological_dilation,3,2
0X659315B077CFCAE2.avi,47,1274,915,359,39.23497267759563,morphological_dilation,3,2
0X6595CCE63E8A9FB1.avi,132,1968,1564,404,25.831202046035806,morphological_dilation,3,2
0X6595CCE63E8A9FB1.avi,150,1191,879,312,35.49488054607509,morphological_dilation,3,2
0X6596000F8A23ADA8.avi,53,5634,4962,672,13.54292623941959,morphological_dilation,3,2
0X6596000F8A23ADA8.avi,73,4484,3852,632,16.40706126687435,morphological_dilation,3,2
0X6596D8BF8019271F.avi,47,2137,1706,431,25.263774912075025,morphological_dilation,3,2
0X6596D8BF8019271F.avi,62,1333,989,344,34.78260869565217,morphological_dilation,3,2
0X659B94C54FB2A424.avi,55,2123,1703,420,24.662360540223137,morphological_dilation,3,2
0X659B94C54FB2A424.avi,75,1145,814,331,40.663390663390665,morphological_dilation,3,2
0X659BBAF883211018.avi,99,1562,1166,396,33.9622641509434,morphological_dilation,3,2
0X659BBAF883211018.avi,113,874,590,284,48.13559322033898,morphological_dilation,3,2
0X659D7C2040A17F30.avi,99,2038,1646,392,23.815309842041312,morphological_dilation,3,2
0X659D7C2040A17F30.avi,121,1239,915,324,35.40983606557377,morphological_dilation,3,2
0X659F28A1D4054453.avi,38,1548,1204,344,28.57142857142857,morphological_dilation,3,2
0X659F28A1D4054453.avi,52,927,643,284,44.16796267496112,morphological_dilation,3,2
0X65A2ADCC7A35528F.avi,79,1413,1069,344,32.179607109448085,morphological_dilation,3,2
0X65A2ADCC7A35528F.avi,93,904,612,292,47.712418300653596,morphological_dilation,3,2
0X65A4CFF0CDED342B.avi,50,1482,1126,356,31.616341030195382,morphological_dilation,3,2
0X65A4CFF0CDED342B.avi,66,917,629,288,45.78696343402226,morphological_dilation,3,2
0X65A7AF6CE6C51FA4.avi,42,1624,1240,384,30.967741935483872,morphological_dilation,3,2
0X65A7AF6CE6C51FA4.avi,57,995,664,331,49.84939759036144,morphological_dilation,3,2
0X65A93402E4FD359D.avi,77,1396,1048,348,33.20610687022901,morphological_dilation,3,2
0X65A93402E4FD359D.avi,93,851,567,284,50.08818342151675,morphological_dilation,3,2
0X65A9AD514CAB60F6.avi,44,1553,1211,342,28.2411230388109,morphological_dilation,3,2
0X65A9AD514CAB60F6.avi,60,910,626,284,45.367412140575084,morphological_dilation,3,2
0X65AA294CD0269E6.avi,97,2327,1867,460,24.638457418318158,morphological_dilation,3,2
0X65AA294CD0269E6.avi,114,1380,1000,380,38.0,morphological_dilation,3,2
0X65ACA3F8B770AAD7.avi,130,1466,1130,336,29.734513274336283,morphological_dilation,3,2
0X65ACA3F8B770AAD7.avi,148,1065,773,292,37.77490297542044,morphological_dilation,3,2
0X65ACFF71F3288CEB.avi,97,2939,2459,480,19.520130134200894,morphological_dilation,3,2
0X65ACFF71F3288CEB.avi,105,1951,1543,408,26.441996111471163,morphological_dilation,3,2
0X65AFBE7F72F33F56.avi,114,1286,947,339,35.79725448785639,morphological_dilation,3,2
0X65AFBE7F72F33F56.avi,129,805,512,293,57.2265625,morphological_dilation,3,2
0X65B1A716EEA8A06F.avi,101,1804,1436,368,25.62674094707521,morphological_dilation,3,2
0X65B1A716EEA8A06F.avi,117,1077,777,300,38.61003861003861,morphological_dilation,3,2
0X65B23F659EFEE4B5.avi,128,2140,1716,424,24.708624708624708,morphological_dilation,3,2
0X65B23F659EFEE4B5.avi,143,1319,983,336,34.18107833163784,morphological_dilation,3,2
0X65B2EFC3B8EFD35D.avi,142,2262,1806,456,25.249169435215947,morphological_dilation,3,2
0X65B2EFC3B8EFD35D.avi,161,1311,955,356,37.27748691099477,morphological_dilation,3,2
0X65B33C7D1BA2303C.avi,54,1551,1163,388,33.36199484092863,morphological_dilation,3,2
0X65B33C7D1BA2303C.avi,69,960,663,297,44.79638009049774,morphological_dilation,3,2
0X65B6646A8864CFF2.avi,41,1585,1229,356,28.966639544344996,morphological_dilation,3,2
0X65B6646A8864CFF2.avi,59,1076,776,300,38.659793814432994,morphological_dilation,3,2
0X65B7FD443008A7FE.avi,148,1580,1216,364,29.93421052631579,morphological_dilation,3,2
0X65B7FD443008A7FE.avi,162,1108,800,308,38.5,morphological_dilation,3,2
0X65BAA5953F13E76F.avi,51,1199,883,316,35.78708946772367,morphological_dilation,3,2
0X65BAA5953F13E76F.avi,67,772,500,272,54.400000000000006,morphological_dilation,3,2
0X65BE4D7A748C3A2E.avi,81,1771,1383,388,28.054953000723064,morphological_dilation,3,2
0X65BE4D7A748C3A2E.avi,102,1199,879,320,36.40500568828214,morphological_dilation,3,2
0X65BFE57982B5CE91.avi,56,1473,1102,371,33.66606170598911,morphological_dilation,3,2
0X65BFE57982B5CE91.avi,72,966,658,308,46.808510638297875,morphological_dilation,3,2
0X65C05D708C373803.avi,75,1445,1117,328,29.364368845120858,morphological_dilation,3,2
0X65C05D708C373803.avi,86,843,599,244,40.73455759599332,morphological_dilation,3,2
0X65C0691EFC9931F6.avi,100,1831,1435,396,27.595818815331008,morphological_dilation,3,2
0X65C0691EFC9931F6.avi,121,1216,896,320,35.714285714285715,morphological_dilation,3,2
0X65C488B49774AE48.avi,103,1667,1291,376,29.124709527498066,morphological_dilation,3,2
0X65C488B49774AE48.avi,119,1023,723,300,41.49377593360996,morphological_dilation,3,2
0X65D15BBB6891406A.avi,40,1458,1065,393,36.901408450704224,morphological_dilation,3,2
0X65D15BBB6891406A.avi,54,888,524,364,69.46564885496184,morphological_dilation,3,2
0X65D85BE69D1D8F64.avi,75,1658,1262,396,31.378763866877975,morphological_dilation,3,2
0X65D85BE69D1D8F64.avi,90,1066,746,320,42.89544235924933,morphological_dilation,3,2
0X65E1A5AE0862B8B6.avi,54,1642,1251,391,31.254996003197444,morphological_dilation,3,2
0X65E1A5AE0862B8B6.avi,66,1047,711,336,47.257383966244724,morphological_dilation,3,2
0X65E2A0A6C4CDBC1.avi,47,1150,834,316,37.88968824940048,morphological_dilation,3,2
0X65E2A0A6C4CDBC1.avi,67,767,507,260,51.28205128205128,morphological_dilation,3,2
0X65E605F203321860.avi,32,2825,2085,740,35.4916067146283,morphological_dilation,3,2
0X65E605F203321860.avi,53,3814,2921,893,30.571722013009246,morphological_dilation,3,2
0X65E85D2F82BA872E.avi,107,1341,1001,340,33.96603396603396,morphological_dilation,3,2
0X65E85D2F82BA872E.avi,126,861,582,279,47.93814432989691,morphological_dilation,3,2
0X65E89AC890F1DC3F.avi,120,1638,1266,372,29.383886255924168,morphological_dilation,3,2
0X65E89AC890F1DC3F.avi,133,1040,724,316,43.646408839779006,morphological_dilation,3,2
0X65EDD2669C886790.avi,98,1806,1438,368,25.591098748261476,morphological_dilation,3,2
0X65EDD2669C886790.avi,115,1172,868,304,35.02304147465438,morphological_dilation,3,2
0X65EFA6DFA62351C9.avi,59,1848,1444,404,27.977839335180054,morphological_dilation,3,2
0X65EFA6DFA62351C9.avi,73,1002,702,300,42.73504273504273,morphological_dilation,3,2
0X65F1640C91221F37.avi,55,2070,1662,408,24.548736462093864,morphological_dilation,3,2
0X65F1640C91221F37.avi,74,1398,1042,356,34.16506717850288,morphological_dilation,3,2
0X65F84656B24B5511.avi,82,3216,2644,572,21.6338880484115,morphological_dilation,3,2
0X65F84656B24B5511.avi,96,2573,1972,601,30.476673427991884,morphological_dilation,3,2
0X65FAC9441FA92B93.avi,108,2156,1740,416,23.908045977011493,morphological_dilation,3,2
0X65FAC9441FA92B93.avi,127,1408,1056,352,33.33333333333333,morphological_dilation,3,2
0X65FB2AC7E0207522.avi,46,1396,1056,340,32.196969696969695,morphological_dilation,3,2
0X65FB2AC7E0207522.avi,58,875,591,284,48.05414551607445,morphological_dilation,3,2
0X65FCF0CE7A00FB1C.avi,35,1468,1124,344,30.604982206405694,morphological_dilation,3,2
0X65FCF0CE7A00FB1C.avi,48,982,690,292,42.31884057971014,morphological_dilation,3,2
0X65FE895469EFDA8B.avi,51,1857,1465,392,26.757679180887372,morphological_dilation,3,2
0X65FE895469EFDA8B.avi,70,1006,714,292,40.896358543417364,morphological_dilation,3,2
0X65FF0A025B2C71EA.avi,52,1561,1201,360,29.97502081598668,morphological_dilation,3,2
0X65FF0A025B2C71EA.avi,71,979,691,288,41.67872648335745,morphological_dilation,3,2
0X660104EE65A0D28E.avi,1,1141,792,349,44.06565656565656,morphological_dilation,3,2
0X660104EE65A0D28E.avi,17,742,466,276,59.227467811158796,morphological_dilation,3,2
0X66050153ED5E08EA.avi,81,1613,1257,356,28.32140015910899,morphological_dilation,3,2
0X66050153ED5E08EA.avi,94,981,689,292,42.380261248185775,morphological_dilation,3,2
0X660577E3B07A47CE.avi,116,2761,2277,484,21.256038647342994,morphological_dilation,3,2
0X660577E3B07A47CE.avi,133,1485,1101,384,34.87738419618528,morphological_dilation,3,2
0X66095387FB014661.avi,50,1436,1093,343,31.381518755718208,morphological_dilation,3,2
0X66095387FB014661.avi,68,924,620,304,49.03225806451613,morphological_dilation,3,2
0X660DF8CADE3493DB.avi,93,2111,1687,424,25.133372851215174,morphological_dilation,3,2
0X660DF8CADE3493DB.avi,109,1321,962,359,37.318087318087315,morphological_dilation,3,2
0X6610463AD711E147.avi,46,2632,2168,464,21.40221402214022,morphological_dilation,3,2
0X6610463AD711E147.avi,61,1566,1190,376,31.596638655462183,morphological_dilation,3,2
0X6610FEE0E4DB11B5.avi,46,2241,1797,444,24.707846410684475,morphological_dilation,3,2
0X6610FEE0E4DB11B5.avi,65,1301,949,352,37.09167544783983,morphological_dilation,3,2
0X661442FDB0CA1292.avi,50,2058,1650,408,24.727272727272727,morphological_dilation,3,2
0X661442FDB0CA1292.avi,68,1318,978,340,34.76482617586912,morphological_dilation,3,2
0X66150B1C51FE2973.avi,105,1574,1218,356,29.22824302134647,morphological_dilation,3,2
0X66150B1C51FE2973.avi,120,1043,743,300,40.376850605652756,morphological_dilation,3,2
0X661758A0D4DDE90B.avi,85,1642,1267,375,29.597474348855563,morphological_dilation,3,2
0X661758A0D4DDE90B.avi,102,977,677,300,44.313146233382575,morphological_dilation,3,2
0X661BF682DDCABEA3.avi,61,1474,1110,364,32.79279279279279,morphological_dilation,3,2
0X661BF682DDCABEA3.avi,77,904,606,298,49.17491749174918,morphological_dilation,3,2
0X6629C6225F411536.avi,43,1855,1451,404,27.842866988283944,morphological_dilation,3,2
0X6629C6225F411536.avi,68,1319,959,360,37.53910323253389,morphological_dilation,3,2
0X662EF84E75806C27.avi,48,2797,2329,468,20.09446114212108,morphological_dilation,3,2
0X662EF84E75806C27.avi,60,2288,1856,432,23.275862068965516,morphological_dilation,3,2
0X663231D707998E6.avi,130,2246,1802,444,24.639289678135405,morphological_dilation,3,2
0X663231D707998E6.avi,147,1375,1023,352,34.40860215053764,morphological_dilation,3,2
0X66323769FB7ECD5D.avi,31,1409,1085,324,29.861751152073733,morphological_dilation,3,2
0X66323769FB7ECD5D.avi,44,1158,854,304,35.597189695550355,morphological_dilation,3,2
0X6634179FD03E7894.avi,100,1535,1167,368,31.533847472150818,morphological_dilation,3,2
0X6634179FD03E7894.avi,112,974,670,304,45.37313432835821,morphological_dilation,3,2
0X663BC386B0224ABB.avi,1,2263,1815,448,24.683195592286502,morphological_dilation,3,2
0X663BC386B0224ABB.avi,20,1408,1040,368,35.38461538461539,morphological_dilation,3,2
0X663D82EB24009DF8.avi,97,3146,2650,496,18.71698113207547,morphological_dilation,3,2
0X663D82EB24009DF8.avi,118,1763,1375,388,28.21818181818182,morphological_dilation,3,2
0X663EF0126EB679DB.avi,98,1977,1554,423,27.220077220077222,morphological_dilation,3,2
0X663EF0126EB679DB.avi,115,1225,877,348,39.68072976054732,morphological_dilation,3,2
0X66485513B1CFC9AE.avi,53,1866,1470,396,26.93877551020408,morphological_dilation,3,2
0X66485513B1CFC9AE.avi,71,1159,835,324,38.80239520958084,morphological_dilation,3,2
0X66498ED03F00B58.avi,108,1141,833,308,36.97478991596639,morphological_dilation,3,2
0X66498ED03F00B58.avi,123,755,503,252,50.09940357852882,morphological_dilation,3,2
0X66513C273628711D.avi,55,2524,2056,468,22.762645914396888,morphological_dilation,3,2
0X66513C273628711D.avi,72,1485,1105,380,34.38914027149321,morphological_dilation,3,2
0X66589A55D172C35C.avi,45,1699,1331,368,27.64838467317806,morphological_dilation,3,2
0X66589A55D172C35C.avi,62,1318,978,340,34.76482617586912,morphological_dilation,3,2
0X665A80CE550ADFA.avi,62,2814,2326,488,20.980223559759242,morphological_dilation,3,2
0X665A80CE550ADFA.avi,86,1957,1529,428,27.992151733158927,morphological_dilation,3,2
0X665B15BB5ABDCCFF.avi,52,1730,1335,395,29.588014981273407,morphological_dilation,3,2
0X665B15BB5ABDCCFF.avi,70,1277,890,387,43.48314606741573,morphological_dilation,3,2
0X665E43AF6FE1563D.avi,39,1375,1027,348,33.88510223953262,morphological_dilation,3,2
0X665E43AF6FE1563D.avi,54,861,581,280,48.19277108433735,morphological_dilation,3,2
0X666344D2DD9224DE.avi,120,1807,1387,420,30.28118240807498,morphological_dilation,3,2
0X666344D2DD9224DE.avi,142,1177,845,332,39.289940828402365,morphological_dilation,3,2
0X666349AB95E1677.avi,70,1198,878,320,36.44646924829157,morphological_dilation,3,2
0X666349AB95E1677.avi,101,1009,721,288,39.94452149791955,morphological_dilation,3,2
0X6664870503647CFB.avi,42,2174,1766,408,23.103057757644393,morphological_dilation,3,2
0X6664870503647CFB.avi,59,1730,1370,360,26.277372262773724,morphological_dilation,3,2
0X666873505855894.avi,4,1817,1445,372,25.7439446366782,morphological_dilation,3,2
0X666873505855894.avi,19,1363,1035,328,31.69082125603865,morphological_dilation,3,2
0X6668ACFCA23901D4.avi,36,2456,2016,440,21.825396825396826,morphological_dilation,3,2
0X6668ACFCA23901D4.avi,47,2123,1707,416,24.370240187463384,morphological_dilation,3,2
0X66740E6F2A2F90A6.avi,68,1510,1154,356,30.849220103986134,morphological_dilation,3,2
0X66740E6F2A2F90A6.avi,82,1040,736,304,41.30434782608695,morphological_dilation,3,2
0X6675FE3D0AFC31BD.avi,41,1720,1324,396,29.909365558912388,morphological_dilation,3,2
0X6675FE3D0AFC31BD.avi,58,1147,811,336,41.43033292231812,morphological_dilation,3,2
0X66767284B72B3E78.avi,122,1251,927,324,34.95145631067961,morphological_dilation,3,2
0X66767284B72B3E78.avi,144,853,565,288,50.97345132743363,morphological_dilation,3,2
0X667955B6FC13C36.avi,24,1575,1208,367,30.38079470198676,morphological_dilation,3,2
0X667955B6FC13C36.avi,38,1033,725,308,42.48275862068965,morphological_dilation,3,2
0X667B0BEE8F4F8F2D.avi,116,1554,1198,356,29.716193656093488,morphological_dilation,3,2
0X667B0BEE8F4F8F2D.avi,131,1057,745,312,41.87919463087248,morphological_dilation,3,2
0X667B5B4810379555.avi,36,1685,1313,372,28.33206397562833,morphological_dilation,3,2
0X667B5B4810379555.avi,54,1297,965,332,34.4041450777202,morphological_dilation,3,2
0X667FD7179D55F5AF.avi,126,1430,1070,360,33.64485981308411,morphological_dilation,3,2
0X667FD7179D55F5AF.avi,145,868,582,286,49.140893470790374,morphological_dilation,3,2
0X66823EEDB9A8D930.avi,110,1431,1067,364,34.11433926897844,morphological_dilation,3,2
0X66823EEDB9A8D930.avi,122,1067,735,332,45.17006802721089,morphological_dilation,3,2
0X6684E4B16D37E14.avi,47,1578,1210,368,30.413223140495866,morphological_dilation,3,2
0X6684E4B16D37E14.avi,66,1022,714,308,43.13725490196079,morphological_dilation,3,2
0X668A7CAD095C1D4C.avi,61,1245,917,328,35.76881134133043,morphological_dilation,3,2
0X668A7CAD095C1D4C.avi,76,1005,709,296,41.74894217207334,morphological_dilation,3,2
0X668B799502EF644B.avi,32,1602,1222,380,31.09656301145663,morphological_dilation,3,2
0X668B799502EF644B.avi,44,1057,737,320,43.419267299864316,morphological_dilation,3,2
0X669090C0E856365E.avi,58,1266,932,334,35.836909871244636,morphological_dilation,3,2
0X669090C0E856365E.avi,74,769,502,267,53.18725099601593,morphological_dilation,3,2
0X6691FC17FF306EA5.avi,79,3441,2901,540,18.61427094105481,morphological_dilation,3,2
0X6691FC17FF306EA5.avi,94,2776,2267,509,22.452580502867225,morphological_dilation,3,2
0X6692B6CEE5DCCFC0.avi,0,2046,1586,460,29.00378310214376,morphological_dilation,3,2
0X6692B6CEE5DCCFC0.avi,17,1518,1146,372,32.460732984293195,morphological_dilation,3,2
0X66943CAFDC2AC478.avi,85,1833,1449,384,26.501035196687372,morphological_dilation,3,2
0X66943CAFDC2AC478.avi,100,1166,846,320,37.825059101654844,morphological_dilation,3,2
0X669833DEC464DE58.avi,151,3808,3244,564,17.385943279901355,morphological_dilation,3,2
0X669833DEC464DE58.avi,166,2186,1698,488,28.7396937573616,morphological_dilation,3,2
0X669B1F6BD601634.avi,43,2138,1674,464,27.718040621266425,morphological_dilation,3,2
0X669B1F6BD601634.avi,61,1320,956,364,38.07531380753138,morphological_dilation,3,2
0X669C85F4369B9F8F.avi,64,1729,1341,388,28.933631618195378,morphological_dilation,3,2
0X669C85F4369B9F8F.avi,82,1006,698,308,44.126074498567334,morphological_dilation,3,2
0X669DE1EFA9B175D9.avi,0,1601,1241,360,29.0088638195004,morphological_dilation,3,2
0X669DE1EFA9B175D9.avi,15,978,683,295,43.1918008784773,morphological_dilation,3,2
0X669DF94C3BCCDE7B.avi,46,1484,1144,340,29.72027972027972,morphological_dilation,3,2
0X669DF94C3BCCDE7B.avi,56,1014,722,292,40.443213296398895,morphological_dilation,3,2
0X669FE870F1ACFC73.avi,52,1331,975,356,36.51282051282052,morphological_dilation,3,2
0X669FE870F1ACFC73.avi,67,739,443,296,66.81715575620768,morphological_dilation,3,2
0X66A0A7C2D3B4B0A7.avi,135,1254,934,320,34.26124197002141,morphological_dilation,3,2
0X66A0A7C2D3B4B0A7.avi,142,791,507,284,56.01577909270217,morphological_dilation,3,2
0X66A167447E7F1770.avi,42,1368,1028,340,33.07392996108949,morphological_dilation,3,2
0X66A167447E7F1770.avi,58,1041,717,324,45.18828451882845,morphological_dilation,3,2
0X66AB95639ED874F.avi,74,2036,1644,392,23.844282238442823,morphological_dilation,3,2
0X66AB95639ED874F.avi,89,1631,1279,352,27.52150117279124,morphological_dilation,3,2
0X66AC005B83155AF3.avi,47,1643,1267,376,29.67640094711918,morphological_dilation,3,2
0X66AC005B83155AF3.avi,68,1026,719,307,42.698191933240615,morphological_dilation,3,2
0X66B7661D9ADBD284.avi,30,1484,1134,350,30.864197530864196,morphological_dilation,3,2
0X66B7661D9ADBD284.avi,37,1024,744,280,37.634408602150536,morphological_dilation,3,2
0X66B9870579E61D28.avi,56,1878,1474,404,27.408412483039346,morphological_dilation,3,2
0X66B9870579E61D28.avi,78,1062,734,328,44.6866485013624,morphological_dilation,3,2
0X66B9D0727965351A.avi,28,2219,1811,408,22.52898950855881,morphological_dilation,3,2
0X66B9D0727965351A.avi,40,1538,1190,348,29.2436974789916,morphological_dilation,3,2
0X66BA13935B0B974.avi,67,2102,1698,404,23.792697290930505,morphological_dilation,3,2
0X66BA13935B0B974.avi,80,1121,821,300,36.54080389768575,morphological_dilation,3,2
0X66C173C78E8F6EDF.avi,63,3072,2568,504,19.626168224299064,morphological_dilation,3,2
0X66C173C78E8F6EDF.avi,89,1749,1369,380,27.757487216946675,morphological_dilation,3,2
0X66C8E103FFEE45DF.avi,46,1660,1294,366,28.284389489953632,morphological_dilation,3,2
0X66C8E103FFEE45DF.avi,57,1117,800,317,39.625,morphological_dilation,3,2
0X66C8EAE88FFB77EE.avi,53,1657,1285,372,28.949416342412455,morphological_dilation,3,2
0X66C8EAE88FFB77EE.avi,76,1282,950,332,34.94736842105263,morphological_dilation,3,2
0X66CBBE76152663AE.avi,52,1887,1503,384,25.54890219560878,morphological_dilation,3,2
0X66CBBE76152663AE.avi,69,1137,837,300,35.842293906810035,morphological_dilation,3,2
0X66CD8A146E264C5C.avi,36,1685,1301,384,29.515757109915448,morphological_dilation,3,2
0X66CD8A146E264C5C.avi,53,1167,839,328,39.09415971394517,morphological_dilation,3,2
0X66CD95FB321BF102.avi,55,1856,1480,376,25.405405405405407,morphological_dilation,3,2
0X66CD95FB321BF102.avi,75,1299,987,312,31.61094224924012,morphological_dilation,3,2
0X66CE85713FABD830.avi,46,1504,1132,372,32.86219081272085,morphological_dilation,3,2
0X66CE85713FABD830.avi,57,945,590,355,60.16949152542372,morphological_dilation,3,2
0X66CF7DDCF1B8920D.avi,3,1859,1483,376,25.354012137559,morphological_dilation,3,2
0X66CF7DDCF1B8920D.avi,18,1622,1278,344,26.917057902973397,morphological_dilation,3,2
0X66D3177E10B63872.avi,40,1431,1083,348,32.13296398891966,morphological_dilation,3,2
0X66D3177E10B63872.avi,56,838,554,284,51.26353790613718,morphological_dilation,3,2
0X66D5B2636F084D50.avi,106,2741,2269,472,20.802115469369767,morphological_dilation,3,2
0X66D5B2636F084D50.avi,122,1771,1383,388,28.054953000723064,morphological_dilation,3,2
0X66D60CC6C281CAA7.avi,100,1155,851,304,35.72267920094007,morphological_dilation,3,2
0X66D60CC6C281CAA7.avi,121,836,568,268,47.183098591549296,morphological_dilation,3,2
0X66DAEF49CE746360.avi,37,4749,4153,596,14.351071514567781,morphological_dilation,3,2
0X66DAEF49CE746360.avi,52,4173,3609,564,15.627597672485452,morphological_dilation,3,2
0X66DC4A8DD37055CC.avi,50,2004,1612,392,24.317617866004962,morphological_dilation,3,2
0X66DC4A8DD37055CC.avi,66,1245,917,328,35.76881134133043,morphological_dilation,3,2
0X66E313EF5B96FD96.avi,59,1288,960,328,34.166666666666664,morphological_dilation,3,2
0X66E313EF5B96FD96.avi,72,853,569,284,49.91212653778559,morphological_dilation,3,2
0X66E92E721D27BF17.avi,33,977,701,276,39.37232524964337,morphological_dilation,3,2
0X66E92E721D27BF17.avi,53,710,458,252,55.021834061135365,morphological_dilation,3,2
0X66ECE3A29BB030DA.avi,49,2314,1870,444,23.74331550802139,morphological_dilation,3,2
0X66ECE3A29BB030DA.avi,67,1410,966,444,45.962732919254655,morphological_dilation,3,2
0X66F56796903B5D4F.avi,129,2596,2124,472,22.22222222222222,morphological_dilation,3,2
0X66F56796903B5D4F.avi,145,1542,1174,368,31.3458262350937,morphological_dilation,3,2
0X66F67400B4224304.avi,102,2308,1828,480,26.258205689277897,morphological_dilation,3,2
0X66F67400B4224304.avi,118,1610,1230,380,30.89430894308943,morphological_dilation,3,2
0X66F7B3D066CDBF3B.avi,49,1444,1092,352,32.234432234432234,morphological_dilation,3,2
0X66F7B3D066CDBF3B.avi,67,1114,794,320,40.302267002518896,morphological_dilation,3,2
0X66FA32EDB231FFC2.avi,93,1607,1259,348,27.640984908657668,morphological_dilation,3,2
0X66FA32EDB231FFC2.avi,106,1123,839,284,33.849821215733016,morphological_dilation,3,2
0X66FB64B67D109199.avi,60,1530,1158,372,32.12435233160622,morphological_dilation,3,2
0X66FB64B67D109199.avi,76,931,631,300,47.543581616481774,morphological_dilation,3,2
0X66FC5D40C9D897B1.avi,94,2429,1993,436,21.876567987957852,morphological_dilation,3,2
0X66FC5D40C9D897B1.avi,113,1671,1291,380,29.434546862896976,morphological_dilation,3,2
0X66FD6E92F7ABD0CE.avi,73,2254,1814,440,24.255788313120178,morphological_dilation,3,2
0X66FD6E92F7ABD0CE.avi,92,1550,1166,384,32.933104631217844,morphological_dilation,3,2
0X66FDF9218D696E41.avi,108,1278,954,324,33.9622641509434,morphological_dilation,3,2
0X66FDF9218D696E41.avi,127,797,537,260,48.4171322160149,morphological_dilation,3,2
0X6703FCFAD2E7CBCA.avi,46,2451,2027,424,20.917612234829797,morphological_dilation,3,2
0X6703FCFAD2E7CBCA.avi,66,1758,1374,384,27.947598253275107,morphological_dilation,3,2
0X67062227EF11E9B7.avi,49,1400,1048,352,33.587786259541986,morphological_dilation,3,2
0X67062227EF11E9B7.avi,67,950,634,316,49.8422712933754,morphological_dilation,3,2
0X670A0F9C14BDD4CE.avi,147,1469,1125,344,30.577777777777776,morphological_dilation,3,2
0X670A0F9C14BDD4CE.avi,162,1186,874,312,35.6979405034325,morphological_dilation,3,2
0X670CDE1D82BD7956.avi,63,1660,1300,360,27.692307692307693,morphological_dilation,3,2
0X670CDE1D82BD7956.avi,82,1201,889,312,35.09561304836895,morphological_dilation,3,2
0X6710BA6184204672.avi,90,1877,1489,388,26.05775688381464,morphological_dilation,3,2
0X6710BA6184204672.avi,109,1369,1029,340,33.04178814382896,morphological_dilation,3,2
0X6715D2C6A51FDC7C.avi,100,1699,1311,388,29.59572845156369,morphological_dilation,3,2
0X6715D2C6A51FDC7C.avi,113,1022,706,316,44.759206798866856,morphological_dilation,3,2
0X671A1682EAD51E03.avi,63,2899,2415,484,20.041407867494822,morphological_dilation,3,2
0X671A1682EAD51E03.avi,80,2022,1614,408,25.27881040892193,morphological_dilation,3,2
0X6720DAE21174550.avi,153,1742,1342,400,29.806259314456035,morphological_dilation,3,2
0X6720DAE21174550.avi,167,1015,699,316,45.20743919885551,morphological_dilation,3,2
0X6721138DB497FCB3.avi,50,2008,1592,416,26.13065326633166,morphological_dilation,3,2
0X6721138DB497FCB3.avi,66,1511,1139,372,32.660228270412645,morphological_dilation,3,2
0X67258AC1999CA388.avi,97,1445,1089,356,32.69054178145087,morphological_dilation,3,2
0X67258AC1999CA388.avi,111,916,624,292,46.794871794871796,morphological_dilation,3,2
0X6728170DD8443536.avi,41,1834,1458,376,25.788751714677637,morphological_dilation,3,2
0X6728170DD8443536.avi,59,1277,957,320,33.437826541274816,morphological_dilation,3,2
0X6728A3BFFD051355.avi,106,1333,997,336,33.70110330992979,morphological_dilation,3,2
0X6728A3BFFD051355.avi,122,993,693,300,43.290043290043286,morphological_dilation,3,2
0X672FD8B7D89552F6.avi,99,1012,696,316,45.40229885057471,morphological_dilation,3,2
0X672FD8B7D89552F6.avi,120,1636,1244,392,31.511254019292608,morphological_dilation,3,2
0X6732C1BF9A1903C.avi,85,1350,998,352,35.27054108216433,morphological_dilation,3,2
0X6732C1BF9A1903C.avi,98,818,534,284,53.18352059925093,morphological_dilation,3,2
0X6732D6F83932DACA.avi,51,1367,1047,320,30.563514804202484,morphological_dilation,3,2
0X6732D6F83932DACA.avi,66,1031,743,288,38.76177658142665,morphological_dilation,3,2
0X67335086CE434673.avi,80,2124,1696,428,25.235849056603776,morphological_dilation,3,2
0X67335086CE434673.avi,93,1566,1170,396,33.84615384615385,morphological_dilation,3,2
0X67345337DA0C55CA.avi,55,1539,1189,350,29.43650126156434,morphological_dilation,3,2
0X67345337DA0C55CA.avi,73,1057,744,313,42.06989247311828,morphological_dilation,3,2
0X673694C8A87D2876.avi,110,2148,1724,424,24.593967517401392,morphological_dilation,3,2
0X673694C8A87D2876.avi,125,1374,1022,352,34.44227005870842,morphological_dilation,3,2
0X673B5192D6B9C4EA.avi,88,2076,1658,418,25.211097708082026,morphological_dilation,3,2
0X673B5192D6B9C4EA.avi,104,1218,898,320,35.634743875278396,morphological_dilation,3,2
0X673D686D3E02F0D.avi,93,1533,1181,352,29.805249788314985,morphological_dilation,3,2
0X673D686D3E02F0D.avi,105,898,622,276,44.37299035369775,morphological_dilation,3,2
0X6743FE92AFBB3FE5.avi,30,2821,2349,472,20.09365687526607,morphological_dilation,3,2
0X6743FE92AFBB3FE5.avi,45,2284,1844,440,23.861171366594363,morphological_dilation,3,2
0X67445623181AB842.avi,0,1886,1486,400,26.917900403768506,morphological_dilation,3,2
0X67445623181AB842.avi,16,1054,742,312,42.04851752021563,morphological_dilation,3,2
0X6746F7566C8A2500.avi,52,1284,972,312,32.098765432098766,morphological_dilation,3,2
0X6746F7566C8A2500.avi,69,810,550,260,47.27272727272727,morphological_dilation,3,2
0X674BD01159859802.avi,6,905,626,279,44.56869009584665,morphological_dilation,3,2
0X674BD01159859802.avi,18,567,350,217,62.0,morphological_dilation,3,2
0X674C03AD23D41BB6.avi,91,1840,1464,376,25.683060109289617,morphological_dilation,3,2
0X674C03AD23D41BB6.avi,109,1144,836,308,36.84210526315789,morphological_dilation,3,2
0X674D11613887E038.avi,68,2541,2065,476,23.050847457627118,morphological_dilation,3,2
0X674D11613887E038.avi,84,1498,1126,372,33.03730017761989,morphological_dilation,3,2
0X674D61E41CAB000D.avi,109,1675,1323,352,26.606198034769463,morphological_dilation,3,2
0X674D61E41CAB000D.avi,125,1150,830,320,38.55421686746988,morphological_dilation,3,2
0X674EDFBC52AE7E3.avi,33,1715,1331,384,28.850488354620584,morphological_dilation,3,2
0X674EDFBC52AE7E3.avi,48,1109,793,316,39.84867591424969,morphological_dilation,3,2
0X6752E91D593ABCAE.avi,71,1243,879,364,41.41069397042093,morphological_dilation,3,2
0X6752E91D593ABCAE.avi,82,929,605,324,53.553719008264466,morphological_dilation,3,2
0X675972D5C0182669.avi,38,1506,1142,364,31.873905429071804,morphological_dilation,3,2
0X675972D5C0182669.avi,56,894,614,280,45.60260586319218,morphological_dilation,3,2
0X675B53AE93B14D06.avi,119,2507,2051,456,22.233057045343735,morphological_dilation,3,2
0X675B53AE93B14D06.avi,135,1856,1425,431,30.24561403508772,morphological_dilation,3,2
0X675C2C40899BE4C1.avi,83,1994,1598,396,24.780976220275345,morphological_dilation,3,2
0X675C2C40899BE4C1.avi,99,1102,798,304,38.095238095238095,morphological_dilation,3,2
0X675DD194648538EC.avi,42,1404,1056,348,32.95454545454545,morphological_dilation,3,2
0X675DD194648538EC.avi,58,961,661,300,45.38577912254161,morphological_dilation,3,2
0X675E10DDEFCB2A96.avi,2,2082,1678,404,24.076281287246722,morphological_dilation,3,2
0X675E10DDEFCB2A96.avi,17,1190,882,308,34.92063492063492,morphological_dilation,3,2
0X6767F4359E20EE24.avi,229,1749,1389,360,25.917926565874733,morphological_dilation,3,2
0X6767F4359E20EE24.avi,249,1523,1187,336,28.30665543386689,morphological_dilation,3,2
0X6769A9060D724375.avi,40,1397,1038,359,34.58574181117534,morphological_dilation,3,2
0X6769A9060D724375.avi,52,899,587,312,53.15161839863713,morphological_dilation,3,2
0X676EF9C13050917F.avi,45,1416,1080,336,31.11111111111111,morphological_dilation,3,2
0X676EF9C13050917F.avi,58,908,632,276,43.67088607594937,morphological_dilation,3,2
0X677366B12D63509A.avi,26,2753,2273,480,21.11746590409151,morphological_dilation,3,2
0X677366B12D63509A.avi,41,1826,1430,396,27.692307692307693,morphological_dilation,3,2
0X67753ECB554BC154.avi,83,3364,2784,580,20.833333333333336,morphological_dilation,3,2
0X67753ECB554BC154.avi,103,2185,1713,472,27.553998832457676,morphological_dilation,3,2
0X67868606606A2BBC.avi,85,1715,1339,376,28.0806572068708,morphological_dilation,3,2
0X67868606606A2BBC.avi,102,1080,760,320,42.10526315789473,morphological_dilation,3,2
0X678B0D95D2EF1F37.avi,59,2515,2051,464,22.623110677718188,morphological_dilation,3,2
0X678B0D95D2EF1F37.avi,73,2037,1606,431,26.83686176836862,morphological_dilation,3,2
0X679D34B4E61373F4.avi,51,2653,2181,472,21.641448876662082,morphological_dilation,3,2
0X679D34B4E61373F4.avi,67,1569,1175,394,33.53191489361702,morphological_dilation,3,2
0X67A1EB7C88B5A510.avi,55,2226,1810,416,22.983425414364643,morphological_dilation,3,2
0X67A1EB7C88B5A510.avi,65,2100,1704,396,23.239436619718308,morphological_dilation,3,2
0X67A4CC520BEE5551.avi,42,1421,1077,344,31.940575673166204,morphological_dilation,3,2
0X67A4CC520BEE5551.avi,58,892,620,272,43.87096774193549,morphological_dilation,3,2
0X67A7AEB12C2DA3E2.avi,94,1703,1339,364,27.184466019417474,morphological_dilation,3,2
0X67A7AEB12C2DA3E2.avi,112,1044,740,304,41.08108108108108,morphological_dilation,3,2
0X67AAE45F773658DC.avi,3,1707,1339,368,27.483196415235252,morphological_dilation,3,2
0X67AAE45F773658DC.avi,16,1164,856,308,35.981308411214954,morphological_dilation,3,2
0X67ABFBDF2329C556.avi,23,1389,1057,332,31.409649952696313,morphological_dilation,3,2
0X67ABFBDF2329C556.avi,35,952,659,293,44.46130500758726,morphological_dilation,3,2
0X67ADC1FAB1C29E0E.avi,5,1429,1057,372,35.193945127719964,morphological_dilation,3,2
0X67ADC1FAB1C29E0E.avi,15,903,611,292,47.79050736497545,morphological_dilation,3,2
0X67B63CC28517C0E.avi,102,1508,1144,364,31.818181818181817,morphological_dilation,3,2
0X67B63CC28517C0E.avi,120,884,596,288,48.322147651006716,morphological_dilation,3,2
0X67B69FA150D346F3.avi,84,2908,2428,480,19.769357495881383,morphological_dilation,3,2
0X67B69FA150D346F3.avi,99,2493,2061,432,20.96069868995633,morphological_dilation,3,2
0X67C04E297ECB4FD5.avi,90,2454,2002,452,22.577422577422578,morphological_dilation,3,2
0X67C04E297ECB4FD5.avi,103,1484,1100,384,34.909090909090914,morphological_dilation,3,2
0X67C09B651EC014B6.avi,95,1360,1036,324,31.27413127413127,morphological_dilation,3,2
0X67C09B651EC014B6.avi,108,897,617,280,45.38087520259319,morphological_dilation,3,2
0X67C1FB8BB638EEE0.avi,178,1920,1516,404,26.649076517150394,morphological_dilation,3,2
0X67C1FB8BB638EEE0.avi,196,1193,869,324,37.284234752589185,morphological_dilation,3,2
0X67C3B0621AC0639B.avi,57,2444,1996,448,22.44488977955912,morphological_dilation,3,2
0X67C3B0621AC0639B.avi,74,1432,1079,353,32.71547729379055,morphological_dilation,3,2
0X67C5071C6A5E16B9.avi,86,2744,2248,496,22.064056939501782,morphological_dilation,3,2
0X67C5071C6A5E16B9.avi,102,1638,1234,404,32.739059967585085,morphological_dilation,3,2
0X67C5B6E3D1D25595.avi,45,1513,1157,356,30.76923076923077,morphological_dilation,3,2
0X67C5B6E3D1D25595.avi,62,886,610,276,45.24590163934426,morphological_dilation,3,2
0X67C9BA2B3CDD74C.avi,3,1771,1383,388,28.054953000723064,morphological_dilation,3,2
0X67C9BA2B3CDD74C.avi,20,1092,768,324,42.1875,morphological_dilation,3,2
0X67CC398E12E56F6F.avi,79,2659,2187,472,21.582075903063558,morphological_dilation,3,2
0X67CC398E12E56F6F.avi,92,1650,1254,396,31.57894736842105,morphological_dilation,3,2
0X67CC83EFED2413B8.avi,41,2279,1827,452,24.740010946907496,morphological_dilation,3,2
0X67CC83EFED2413B8.avi,57,1379,1007,372,36.941410129096326,morphological_dilation,3,2
0X67CEAB9DD15BF8DA.avi,88,1539,1155,384,33.246753246753244,morphological_dilation,3,2
0X67CEAB9DD15BF8DA.avi,105,964,648,316,48.76543209876543,morphological_dilation,3,2
0X67D00C92919C56D0.avi,112,2510,2066,444,21.490803484995162,morphological_dilation,3,2
0X67D00C92919C56D0.avi,127,1554,1210,344,28.429752066115704,morphological_dilation,3,2
0X67D3775E2E66F543.avi,41,2137,1709,428,25.043885313048563,morphological_dilation,3,2
0X67D3775E2E66F543.avi,56,1296,940,356,37.87234042553192,morphological_dilation,3,2
0X67DA2B2AE959F381.avi,41,1618,1258,360,28.61685214626391,morphological_dilation,3,2
0X67DA2B2AE959F381.avi,52,1180,856,324,37.850467289719624,morphological_dilation,3,2
0X67E320B11E8421AB.avi,43,2738,2266,472,20.82965578111209,morphological_dilation,3,2
0X67E320B11E8421AB.avi,64,1782,1390,392,28.201438848920862,morphological_dilation,3,2
0X67E62FE7B3BA52B3.avi,0,2010,1555,455,29.260450160771708,morphological_dilation,3,2
0X67E62FE7B3BA52B3.avi,17,1097,769,328,42.65279583875163,morphological_dilation,3,2
0X67E6673AA2567482.avi,43,1930,1518,412,27.140974967061926,morphological_dilation,3,2
0X67E6673AA2567482.avi,55,1347,975,372,38.15384615384615,morphological_dilation,3,2
0X67E84A6AEB6EEF44.avi,81,3289,2769,520,18.779342723004692,morphological_dilation,3,2
0X67E84A6AEB6EEF44.avi,93,2689,2221,468,21.071589374155785,morphological_dilation,3,2
0X67E8F2D130F1A55.avi,20,2137,1584,553,34.91161616161616,morphological_dilation,3,2
0X67E8F2D130F1A55.avi,111,1578,1203,375,31.17206982543641,morphological_dilation,3,2
0X67ECED2F51637F45.avi,96,1251,939,312,33.22683706070288,morphological_dilation,3,2
0X67ECED2F51637F45.avi,111,832,568,264,46.478873239436616,morphological_dilation,3,2
0X67EEAB34427A2162.avi,48,1568,1216,352,28.947368421052634,morphological_dilation,3,2
0X67EEAB34427A2162.avi,67,1024,736,288,39.130434782608695,morphological_dilation,3,2
0X67F06708C04321F7.avi,68,2139,1711,428,25.014611338398595,morphological_dilation,3,2
0X67F06708C04321F7.avi,88,1299,939,360,38.33865814696485,morphological_dilation,3,2
0X67F0850A73E98169.avi,80,1514,1142,372,32.57443082311734,morphological_dilation,3,2
0X67F0850A73E98169.avi,96,878,579,299,51.64075993091537,morphological_dilation,3,2
0X67F16F4E4A17E54E.avi,47,1704,1336,368,27.54491017964072,morphological_dilation,3,2
0X67F16F4E4A17E54E.avi,65,995,711,284,39.943741209563996,morphological_dilation,3,2
0X67F418EFEAF112A.avi,80,2217,1801,416,23.098278734036644,morphological_dilation,3,2
0X67F418EFEAF112A.avi,94,1278,946,332,35.095137420718814,morphological_dilation,3,2
0X67F8AC58B0BAA98.avi,162,1767,1371,396,28.88402625820569,morphological_dilation,3,2
0X67F8AC58B0BAA98.avi,198,2293,1795,498,27.74373259052925,morphological_dilation,3,2
0X67FA43200406EB5.avi,96,3347,2811,536,19.06794734969762,morphological_dilation,3,2
0X67FA43200406EB5.avi,110,1754,1318,436,33.0804248861912,morphological_dilation,3,2
0X67FC799EC72F1852.avi,84,1624,1244,380,30.54662379421222,morphological_dilation,3,2
0X67FC799EC72F1852.avi,98,989,685,304,44.37956204379562,morphological_dilation,3,2
0X6802C4DD3536B4A.avi,54,3113,2609,504,19.31774626293599,morphological_dilation,3,2
0X6802C4DD3536B4A.avi,73,2668,2200,468,21.272727272727273,morphological_dilation,3,2
0X68064ABC9AB952B0.avi,105,1502,1146,356,31.064572425828967,morphological_dilation,3,2
0X68064ABC9AB952B0.avi,116,934,645,289,44.8062015503876,morphological_dilation,3,2
0X6806B6025888CBBA.avi,36,915,639,276,43.1924882629108,morphological_dilation,3,2
0X6806B6025888CBBA.avi,48,593,361,232,64.26592797783933,morphological_dilation,3,2
0X6809AF862A2FD6B7.avi,52,1819,1427,392,27.470217238962856,morphological_dilation,3,2
0X6809AF862A2FD6B7.avi,69,1334,978,356,36.400817995910025,morphological_dilation,3,2
0X680C3DA23D0A91D8.avi,4,2510,2038,472,23.159960745829245,morphological_dilation,3,2
0X680C3DA23D0A91D8.avi,16,1522,1142,380,33.274956217162874,morphological_dilation,3,2
0X680FD0769EB255A7.avi,32,915,631,284,45.00792393026941,morphological_dilation,3,2
0X680FD0769EB255A7.avi,48,632,332,300,90.36144578313254,morphological_dilation,3,2
0X681422525BDCBDAD.avi,79,1781,1397,384,27.487473156764498,morphological_dilation,3,2
0X681422525BDCBDAD.avi,99,1090,782,308,39.38618925831202,morphological_dilation,3,2
0X68162D95EAB2AB4E.avi,82,2360,1936,424,21.90082644628099,morphological_dilation,3,2
0X68162D95EAB2AB4E.avi,99,1442,1094,348,31.809872029250457,morphological_dilation,3,2
0X681A95D85C2D17EC.avi,17,1465,1129,336,29.760850310008856,morphological_dilation,3,2
0X681A95D85C2D17EC.avi,34,1231,923,308,33.3694474539545,morphological_dilation,3,2
0X681C4622AD93D1E5.avi,109,2510,2034,476,23.402163225172075,morphological_dilation,3,2
0X681C4622AD93D1E5.avi,124,1881,1449,432,29.81366459627329,morphological_dilation,3,2
0X681D192A1055B8C6.avi,38,1328,1000,328,32.800000000000004,morphological_dilation,3,2
0X681D192A1055B8C6.avi,54,895,616,279,45.2922077922078,morphological_dilation,3,2
0X6823E5601B50BC19.avi,37,2517,2069,448,21.65297245045916,morphological_dilation,3,2
0X6823E5601B50BC19.avi,50,1506,1138,368,32.33743409490334,morphological_dilation,3,2
0X6828C199A8035B7B.avi,0,1757,1381,376,27.226647356987687,morphological_dilation,3,2
0X6828C199A8035B7B.avi,18,1186,862,324,37.58700696055685,morphological_dilation,3,2
0X682B20D1C224EFAA.avi,109,1831,1447,384,26.53766413268832,morphological_dilation,3,2
0X682B20D1C224EFAA.avi,126,1116,804,312,38.80597014925373,morphological_dilation,3,2
0X683199EBCD0E7143.avi,120,1228,892,336,37.66816143497758,morphological_dilation,3,2
0X683199EBCD0E7143.avi,136,823,547,276,50.45703839122486,morphological_dilation,3,2
0X6833A5F6D0FB940B.avi,108,1547,1195,352,29.456066945606697,morphological_dilation,3,2
0X6833A5F6D0FB940B.avi,127,1007,719,288,40.055632823365784,morphological_dilation,3,2
0X6834D917DCB267D3.avi,1,1308,982,326,33.19755600814664,morphological_dilation,3,2
0X6834D917DCB267D3.avi,16,862,578,284,49.13494809688581,morphological_dilation,3,2
0X6836F617166B7CC6.avi,2,1666,1302,364,27.956989247311824,morphological_dilation,3,2
0X6836F617166B7CC6.avi,18,1037,741,296,39.94601889338731,morphological_dilation,3,2
0X683BC0A201466229.avi,1,1593,1237,356,28.77930476960388,morphological_dilation,3,2
0X683BC0A201466229.avi,15,1158,838,320,38.18615751789976,morphological_dilation,3,2
0X683BF75E16371700.avi,58,1703,1335,368,27.56554307116105,morphological_dilation,3,2
0X683BF75E16371700.avi,82,1279,955,324,33.92670157068063,morphological_dilation,3,2
0X6846DD85241D2AD9.avi,62,1233,905,328,36.24309392265193,morphological_dilation,3,2
0X6846DD85241D2AD9.avi,74,826,554,272,49.09747292418773,morphological_dilation,3,2
0X684A3BC616D3740C.avi,49,1981,1597,384,24.04508453350031,morphological_dilation,3,2
0X684A3BC616D3740C.avi,65,1768,1314,454,34.55098934550989,morphological_dilation,3,2
0X684A5A0EACA29BD.avi,90,1542,1174,368,31.3458262350937,morphological_dilation,3,2
0X684A5A0EACA29BD.avi,107,1004,700,304,43.42857142857143,morphological_dilation,3,2
0X684B82C1CFEDE76C.avi,92,2343,1907,436,22.863135815416886,morphological_dilation,3,2
0X684B82C1CFEDE76C.avi,107,1497,1137,360,31.6622691292876,morphological_dilation,3,2
0X68521E9A7A5E6C26.avi,175,3664,3112,552,17.737789203084834,morphological_dilation,3,2
0X68521E9A7A5E6C26.avi,194,2223,1767,456,25.806451612903224,morphological_dilation,3,2
0X68524510445EEC8A.avi,160,1578,1210,368,30.413223140495866,morphological_dilation,3,2
0X68524510445EEC8A.avi,177,1030,712,318,44.662921348314605,morphological_dilation,3,2
0X6852980082149389.avi,84,1773,1369,404,29.510591672753833,morphological_dilation,3,2
0X6852980082149389.avi,116,960,656,304,46.34146341463415,morphological_dilation,3,2
0X6854B1C76DCE575.avi,52,3679,3139,540,17.202930869703728,morphological_dilation,3,2
0X6854B1C76DCE575.avi,64,1980,1544,436,28.238341968911918,morphological_dilation,3,2
0X6855BBCBB720BD0D.avi,85,1978,1586,392,24.71626733921816,morphological_dilation,3,2
0X6855BBCBB720BD0D.avi,103,1248,924,324,35.064935064935064,morphological_dilation,3,2
0X6857D30D7DE3D2E9.avi,112,1469,1113,356,31.98562443845463,morphological_dilation,3,2
0X6857D30D7DE3D2E9.avi,131,960,661,299,45.23449319213313,morphological_dilation,3,2
0X6857E329D98B9E04.avi,55,2181,1754,427,24.34435575826682,morphological_dilation,3,2
0X6857E329D98B9E04.avi,69,1334,994,340,34.205231388329985,morphological_dilation,3,2
0X68590910C6F222F6.avi,43,2282,1874,408,21.77161152614728,morphological_dilation,3,2
0X68590910C6F222F6.avi,58,1482,1148,334,29.094076655052266,morphological_dilation,3,2
0X685A4B045C95B72A.avi,21,1602,1230,372,30.24390243902439,morphological_dilation,3,2
0X685A4B045C95B72A.avi,28,1091,775,316,40.774193548387096,morphological_dilation,3,2
0X685D2596D38E77FF.avi,55,2832,2360,472,20.0,morphological_dilation,3,2
0X685D2596D38E77FF.avi,70,1498,1146,352,30.715532286212916,morphological_dilation,3,2
0X685D625A49A9C1F6.avi,132,2027,1627,400,24.585125998770742,morphological_dilation,3,2
0X685D625A49A9C1F6.avi,146,1531,1178,353,29.9660441426146,morphological_dilation,3,2
0X685D65855E946377.avi,49,1919,1499,420,28.018679119412944,morphological_dilation,3,2
0X685D65855E946377.avi,65,1138,806,332,41.19106699751861,morphological_dilation,3,2
0X685F062E752D3638.avi,1,1298,968,330,34.090909090909086,morphological_dilation,3,2
0X685F062E752D3638.avi,16,910,616,294,47.72727272727273,morphological_dilation,3,2
0X68625A7A16D72E46.avi,49,1724,1328,396,29.819277108433734,morphological_dilation,3,2
0X68625A7A16D72E46.avi,70,1207,789,418,52.97845373891001,morphological_dilation,3,2
0X6866809B28E76AF6.avi,54,1528,1148,380,33.10104529616725,morphological_dilation,3,2
0X6866809B28E76AF6.avi,69,1100,768,332,43.22916666666667,morphological_dilation,3,2
0X6866C629747A847B.avi,167,1724,1368,356,26.023391812865498,morphological_dilation,3,2
0X6866C629747A847B.avi,187,1031,730,301,41.23287671232877,morphological_dilation,3,2
0X6867156FCD59C7DD.avi,5,929,658,271,41.18541033434651,morphological_dilation,3,2
0X6867156FCD59C7DD.avi,20,555,339,216,63.716814159292035,morphological_dilation,3,2
0X686AA246EEAF841F.avi,3,1681,1276,405,31.739811912225708,morphological_dilation,3,2
0X686AA246EEAF841F.avi,12,994,638,356,55.79937304075236,morphological_dilation,3,2
0X686BDE41B6806D07.avi,42,1426,1082,344,31.79297597042514,morphological_dilation,3,2
0X686BDE41B6806D07.avi,57,870,594,276,46.464646464646464,morphological_dilation,3,2
0X686D8CAEF6113D71.avi,55,1863,1439,424,29.46490618485059,morphological_dilation,3,2
0X686D8CAEF6113D71.avi,67,1207,835,372,44.550898203592816,morphological_dilation,3,2
0X686DE99DF17681C8.avi,63,1569,1201,368,30.641132389675267,morphological_dilation,3,2
0X686DE99DF17681C8.avi,79,982,670,312,46.56716417910447,morphological_dilation,3,2
0X686E9F8A8AA1DE4B.avi,62,1408,1072,336,31.343283582089555,morphological_dilation,3,2
0X686E9F8A8AA1DE4B.avi,78,792,520,272,52.307692307692314,morphological_dilation,3,2
0X686F756A1F380DAC.avi,44,2375,1927,448,23.24857291126103,morphological_dilation,3,2
0X686F756A1F380DAC.avi,57,1368,1024,344,33.59375,morphological_dilation,3,2
0X68702D6B20ACB987.avi,112,1863,1479,384,25.963488843813387,morphological_dilation,3,2
0X68702D6B20ACB987.avi,125,1262,934,328,35.11777301927195,morphological_dilation,3,2
0X687155395446BA2B.avi,71,1687,1323,364,27.513227513227513,morphological_dilation,3,2
0X687155395446BA2B.avi,89,1144,831,313,37.66546329723225,morphological_dilation,3,2
0X6871AA112FB25F00.avi,53,2161,1745,416,23.839541547277936,morphological_dilation,3,2
0X6871AA112FB25F00.avi,71,1409,1056,353,33.428030303030305,morphological_dilation,3,2
0X6878753F91B0C449.avi,54,1462,1122,340,30.303030303030305,morphological_dilation,3,2
0X6878753F91B0C449.avi,71,892,624,268,42.94871794871795,morphological_dilation,3,2
0X6879E81713CC3748.avi,129,1466,1110,356,32.072072072072075,morphological_dilation,3,2
0X6879E81713CC3748.avi,147,960,660,300,45.45454545454545,morphological_dilation,3,2
0X687A5BC36E15FA4F.avi,113,1210,878,332,37.81321184510251,morphological_dilation,3,2
0X687A5BC36E15FA4F.avi,132,701,420,281,66.9047619047619,morphological_dilation,3,2
0X687F32820865345D.avi,54,2109,1685,424,25.163204747774483,morphological_dilation,3,2
0X687F32820865345D.avi,68,1240,900,340,37.77777777777778,morphological_dilation,3,2
0X6887B19B44DD3AE3.avi,51,2159,1711,448,26.183518410286382,morphological_dilation,3,2
0X6887B19B44DD3AE3.avi,66,1373,1005,368,36.61691542288557,morphological_dilation,3,2
0X6888101946612E3.avi,54,1601,1237,364,29.426030719482622,morphological_dilation,3,2
0X6888101946612E3.avi,72,1038,734,304,41.41689373297003,morphological_dilation,3,2
0X688C57361B02B07A.avi,89,1931,1539,392,25.471085120207924,morphological_dilation,3,2
0X688C57361B02B07A.avi,99,1630,1266,364,28.751974723538705,morphological_dilation,3,2
0X688E31C0473B80BD.avi,146,1765,1377,388,28.177196804647785,morphological_dilation,3,2
0X688E31C0473B80BD.avi,161,1178,850,328,38.588235294117645,morphological_dilation,3,2
0X688F3ADAB94010A0.avi,85,1108,816,292,35.78431372549019,morphological_dilation,3,2
0X688F3ADAB94010A0.avi,101,733,485,248,51.1340206185567,morphological_dilation,3,2
0X68908A2FFC0B7496.avi,77,1916,1528,388,25.392670157068064,morphological_dilation,3,2
0X68908A2FFC0B7496.avi,94,1185,869,316,36.36363636363637,morphological_dilation,3,2
0X68930B35122898F9.avi,72,1818,1434,384,26.778242677824267,morphological_dilation,3,2
0X68930B35122898F9.avi,96,1153,841,312,37.098692033293695,morphological_dilation,3,2
0X6896FB3693FB3A72.avi,54,1318,966,352,36.43892339544513,morphological_dilation,3,2
0X6896FB3693FB3A72.avi,72,839,531,308,58.00376647834275,morphological_dilation,3,2
0X689FC77F82B906D3.avi,37,1834,1422,412,28.973277074542896,morphological_dilation,3,2
0X689FC77F82B906D3.avi,54,1301,946,355,37.52642706131078,morphological_dilation,3,2
0X689FFAC34F9C025A.avi,38,1094,794,300,37.78337531486146,morphological_dilation,3,2
0X689FFAC34F9C025A.avi,59,728,472,256,54.23728813559322,morphological_dilation,3,2
0X68A1CAF48D768778.avi,53,1337,1003,334,33.300099700897306,morphological_dilation,3,2
0X68A1CAF48D768778.avi,67,865,597,268,44.89112227805695,morphological_dilation,3,2
0X68A375AA5675630D.avi,36,1084,792,292,36.868686868686865,morphological_dilation,3,2
0X68A375AA5675630D.avi,52,750,506,244,48.22134387351779,morphological_dilation,3,2
0X68A39C8B92F679D6.avi,34,1770,1394,376,26.97274031563845,morphological_dilation,3,2
0X68A39C8B92F679D6.avi,49,1534,1178,356,30.220713073005097,morphological_dilation,3,2
0X68A7270BE67D7400.avi,52,1576,1200,376,31.333333333333336,morphological_dilation,3,2
0X68A7270BE67D7400.avi,71,1011,691,320,46.30969609261939,morphological_dilation,3,2
0X68AA4D586D32621A.avi,40,1291,959,332,34.61939520333681,morphological_dilation,3,2
0X68AA4D586D32621A.avi,54,799,535,264,49.34579439252336,morphological_dilation,3,2
0X68ACB079A9BDE1EF.avi,109,2010,1586,424,26.733921815889026,morphological_dilation,3,2
0X68ACB079A9BDE1EF.avi,125,1326,978,348,35.58282208588957,morphological_dilation,3,2
0X68B18CF20C51DCB2.avi,86,1722,1350,372,27.555555555555557,morphological_dilation,3,2
0X68B18CF20C51DCB2.avi,100,1115,807,308,38.166047087980175,morphological_dilation,3,2
0X68B3B1926A16337D.avi,38,1279,951,328,34.49001051524711,morphological_dilation,3,2
0X68B3B1926A16337D.avi,51,804,540,264,48.888888888888886,morphological_dilation,3,2
0X68B8020411063DB8.avi,48,3656,3096,560,18.087855297157624,morphological_dilation,3,2
0X68B8020411063DB8.avi,65,2178,1746,432,24.742268041237114,morphological_dilation,3,2
0X68BD8FCCB1FAEE60.avi,80,1837,1445,392,27.1280276816609,morphological_dilation,3,2
0X68BD8FCCB1FAEE60.avi,100,1258,906,352,38.852097130242825,morphological_dilation,3,2
0X68C1CD733690A87A.avi,57,1352,1024,328,32.03125,morphological_dilation,3,2
0X68C1CD733690A87A.avi,80,844,577,267,46.2738301559792,morphological_dilation,3,2
0X68C23E699437AB64.avi,64,2588,2112,476,22.53787878787879,morphological_dilation,3,2
0X68C23E699437AB64.avi,88,1710,1298,412,31.741140215716484,morphological_dilation,3,2
0X68C605D0E6D11A08.avi,41,1857,1481,376,25.38825118163403,morphological_dilation,3,2
0X68C605D0E6D11A08.avi,59,1201,878,323,36.78815489749431,morphological_dilation,3,2
0X68C77109B94D74B9.avi,110,2359,1883,476,25.27881040892193,morphological_dilation,3,2
0X68C77109B94D74B9.avi,127,1544,1152,392,34.02777777777778,morphological_dilation,3,2
0X68C940A6A6F5838D.avi,39,2399,1959,440,22.460438999489536,morphological_dilation,3,2
0X68C940A6A6F5838D.avi,51,1609,1199,410,34.195162635529606,morphological_dilation,3,2
0X68D189149E39665.avi,49,2201,1777,424,23.860438942037142,morphological_dilation,3,2
0X68D189149E39665.avi,71,1808,1420,388,27.323943661971832,morphological_dilation,3,2
0X68D627A09628F237.avi,54,2079,1639,440,26.845637583892618,morphological_dilation,3,2
0X68D627A09628F237.avi,72,1325,953,372,39.03462749213011,morphological_dilation,3,2
0X68D6DF1106C643F8.avi,35,3126,2626,500,19.04036557501904,morphological_dilation,3,2
0X68D6DF1106C643F8.avi,52,2539,2087,452,21.65788212745568,morphological_dilation,3,2
0X68D721D9EEC218.avi,66,2467,1999,468,23.411705852926463,morphological_dilation,3,2
0X68D721D9EEC218.avi,93,1533,1157,376,32.49783923941227,morphological_dilation,3,2
0X68D9AB58E435F878.avi,172,3358,2830,528,18.657243816254418,morphological_dilation,3,2
0X68D9AB58E435F878.avi,198,1853,1457,396,27.179135209334248,morphological_dilation,3,2
0X68E3DA63806EEFBD.avi,78,3045,2541,504,19.834710743801654,morphological_dilation,3,2
0X68E3DA63806EEFBD.avi,90,1913,1497,416,27.788911155644623,morphological_dilation,3,2
0X68E8A6D619571049.avi,79,2217,1781,436,24.480628860190905,morphological_dilation,3,2
0X68E8A6D619571049.avi,93,1770,1370,400,29.1970802919708,morphological_dilation,3,2
0X68EBF6C87CD14F34.avi,75,1156,856,300,35.046728971962615,morphological_dilation,3,2
0X68EBF6C87CD14F34.avi,88,767,503,264,52.48508946322068,morphological_dilation,3,2
0X68ECE2BAF6D0D2FF.avi,66,2037,1633,404,24.73974280465401,morphological_dilation,3,2
0X68ECE2BAF6D0D2FF.avi,83,1198,894,304,34.00447427293065,morphological_dilation,3,2
0X68EFD6182F99DA56.avi,87,1290,978,312,31.901840490797547,morphological_dilation,3,2
0X68EFD6182F99DA56.avi,105,810,554,256,46.20938628158845,morphological_dilation,3,2
0X68F1A70EFE9D108C.avi,76,2319,1859,460,24.744486282947822,morphological_dilation,3,2
0X68F1A70EFE9D108C.avi,101,1381,1005,376,37.41293532338308,morphological_dilation,3,2
0X68F1C08A47F51B60.avi,64,1741,1361,380,27.920646583394564,morphological_dilation,3,2
0X68F1C08A47F51B60.avi,81,1282,938,344,36.67377398720683,morphological_dilation,3,2
0X68F5FD987AB1DE31.avi,0,1263,947,316,33.36853220696938,morphological_dilation,3,2
0X68F5FD987AB1DE31.avi,21,1066,762,304,39.89501312335958,morphological_dilation,3,2
0X68F95430838173EB.avi,48,1435,1099,336,30.573248407643312,morphological_dilation,3,2
0X68F95430838173EB.avi,65,923,643,280,43.54587869362364,morphological_dilation,3,2
0X68FAB5062A53ED22.avi,55,1648,1282,366,28.549141965678626,morphological_dilation,3,2
0X68FAB5062A53ED22.avi,73,1050,746,304,40.75067024128686,morphological_dilation,3,2
0X68FABC85AAFEF0C8.avi,75,1861,1473,388,26.3408010862186,morphological_dilation,3,2
0X68FABC85AAFEF0C8.avi,90,1208,888,320,36.03603603603604,morphological_dilation,3,2
0X68FEAD20679D9B7A.avi,53,2037,1629,408,25.04604051565378,morphological_dilation,3,2
0X68FEAD20679D9B7A.avi,69,1234,910,324,35.604395604395606,morphological_dilation,3,2
0X68FF6C389EA38EA1.avi,37,2396,1924,472,24.532224532224532,morphological_dilation,3,2
0X68FF6C389EA38EA1.avi,55,1499,1098,401,36.520947176684885,morphological_dilation,3,2
0X690905881CA73619.avi,50,1282,899,383,42.60289210233593,morphological_dilation,3,2
0X690905881CA73619.avi,71,799,475,324,68.21052631578948,morphological_dilation,3,2
0X690985555ADCB775.avi,38,1588,1232,356,28.8961038961039,morphological_dilation,3,2
0X690985555ADCB775.avi,56,1036,718,318,44.28969359331476,morphological_dilation,3,2
0X690BF65CCE72593E.avi,61,2133,1706,427,25.029308323563892,morphological_dilation,3,2
0X690BF65CCE72593E.avi,86,1368,978,390,39.87730061349693,morphological_dilation,3,2
0X690C466520DCF9E3.avi,53,1077,781,296,37.900128040973115,morphological_dilation,3,2
0X690C466520DCF9E3.avi,67,653,413,240,58.111380145278446,morphological_dilation,3,2
0X690D382720F5BF93.avi,118,1820,1424,396,27.808988764044944,morphological_dilation,3,2
0X690D382720F5BF93.avi,131,1108,788,320,40.609137055837564,morphological_dilation,3,2
0X690EEA7ED4067209.avi,48,1868,1488,380,25.537634408602152,morphological_dilation,3,2
0X690EEA7ED4067209.avi,64,1121,817,304,37.2093023255814,morphological_dilation,3,2
0X6911215576ED756B.avi,0,1703,1319,384,29.112964366944656,morphological_dilation,3,2
0X6911215576ED756B.avi,17,1364,1020,344,33.72549019607843,morphological_dilation,3,2
0X6918A5797070503.avi,109,1373,1041,332,31.892411143131604,morphological_dilation,3,2
0X6918A5797070503.avi,122,788,537,251,46.74115456238361,morphological_dilation,3,2
0X691EEC9060E26058.avi,155,1826,1438,388,26.981919332406118,morphological_dilation,3,2
0X691EEC9060E26058.avi,174,1114,814,300,36.85503685503686,morphological_dilation,3,2
0X691F6E99AB190410.avi,84,2902,2386,516,21.62615255658005,morphological_dilation,3,2
0X691F6E99AB190410.avi,100,1832,1428,404,28.291316526610643,morphological_dilation,3,2
0X6921A7FAA46C25A7.avi,63,1764,1372,392,28.57142857142857,morphological_dilation,3,2
0X6921A7FAA46C25A7.avi,80,1021,697,324,46.48493543758967,morphological_dilation,3,2
0X6924181AE32F84A6.avi,50,3350,2822,528,18.71013465627215,morphological_dilation,3,2
0X6924181AE32F84A6.avi,65,1877,1481,396,26.73869007427414,morphological_dilation,3,2
0X6924FEFBEF2EA847.avi,40,2743,2283,460,20.148926850635128,morphological_dilation,3,2
0X6924FEFBEF2EA847.avi,58,2386,1966,420,21.363173957273652,morphological_dilation,3,2
0X69297859FF626047.avi,78,2372,1904,468,24.579831932773107,morphological_dilation,3,2
0X69297859FF626047.avi,90,1506,1138,368,32.33743409490334,morphological_dilation,3,2
0X6929D94A7E4C62B7.avi,91,1522,1166,356,30.53173241852487,morphological_dilation,3,2
0X6929D94A7E4C62B7.avi,108,1097,801,296,36.95380774032459,morphological_dilation,3,2
0X692F41B4E9E0CCAB.avi,100,2238,1818,420,23.1023102310231,morphological_dilation,3,2
0X692F41B4E9E0CCAB.avi,119,1457,1105,352,31.8552036199095,morphological_dilation,3,2
0X6930EF64D363CAD9.avi,64,1997,1601,396,24.734540911930043,morphological_dilation,3,2
0X6930EF64D363CAD9.avi,78,1802,1426,376,26.367461430575034,morphological_dilation,3,2
0X6934668EAB32560.avi,131,1756,1380,376,27.246376811594203,morphological_dilation,3,2
0X6934668EAB32560.avi,145,1054,750,304,40.53333333333333,morphological_dilation,3,2
0X694033179511A13E.avi,4,1554,1194,360,30.15075376884422,morphological_dilation,3,2
0X694033179511A13E.avi,16,1073,769,304,39.531859557867364,morphological_dilation,3,2
0X69413D44827B96C1.avi,0,1673,1309,364,27.807486631016044,morphological_dilation,3,2
0X69413D44827B96C1.avi,17,1019,713,306,42.91725105189341,morphological_dilation,3,2
0X69447E46FEDD2A3F.avi,15,2260,1836,424,23.093681917211327,morphological_dilation,3,2
0X69447E46FEDD2A3F.avi,19,1405,1061,344,32.42224316682375,morphological_dilation,3,2
0X694801E47434307F.avi,38,896,616,280,45.45454545454545,morphological_dilation,3,2
0X694801E47434307F.avi,51,551,335,216,64.4776119402985,morphological_dilation,3,2
0X694A48FBAD032A23.avi,83,2153,1737,416,23.949337938975248,morphological_dilation,3,2
0X694A48FBAD032A23.avi,98,1261,941,320,34.00637619553667,morphological_dilation,3,2
0X694C6FDAA8B7D96E.avi,166,2402,1950,452,23.17948717948718,morphological_dilation,3,2
0X694C6FDAA8B7D96E.avi,183,1578,1198,380,31.719532554257096,morphological_dilation,3,2
0X694CBB67193485BD.avi,45,2847,2343,504,21.51088348271447,morphological_dilation,3,2
0X694CBB67193485BD.avi,67,2106,1622,484,29.839704069050555,morphological_dilation,3,2
0X694D5E1CBC38D44E.avi,82,1936,1540,396,25.71428571428571,morphological_dilation,3,2
0X694D5E1CBC38D44E.avi,101,1158,838,320,38.18615751789976,morphological_dilation,3,2
0X694EE681A4D5697C.avi,46,1337,1005,332,33.03482587064677,morphological_dilation,3,2
0X694EE681A4D5697C.avi,59,839,547,292,53.38208409506399,morphological_dilation,3,2
0X69549AA1CA32AE28.avi,94,1671,1295,376,29.034749034749037,morphological_dilation,3,2
0X69549AA1CA32AE28.avi,107,967,663,304,45.85218702865762,morphological_dilation,3,2
0X6955FFE50B579D53.avi,48,1423,1103,320,29.011786038077968,morphological_dilation,3,2
0X6955FFE50B579D53.avi,62,1007,735,272,37.006802721088434,morphological_dilation,3,2
0X6956919815606827.avi,46,876,612,264,43.13725490196079,morphological_dilation,3,2
0X6956919815606827.avi,60,563,339,224,66.07669616519173,morphological_dilation,3,2
0X69572A530D2CC5E4.avi,3,2274,1858,416,22.38966630785791,morphological_dilation,3,2
0X69572A530D2CC5E4.avi,18,1582,1234,348,28.200972447325768,morphological_dilation,3,2
0X695821AC12CAAFD2.avi,97,2560,2084,476,22.84069097888676,morphological_dilation,3,2
0X695821AC12CAAFD2.avi,112,1656,1257,399,31.742243436754176,morphological_dilation,3,2
0X695AD46166A86635.avi,67,2930,2446,484,19.787408013082583,morphological_dilation,3,2
0X695AD46166A86635.avi,82,1558,1170,388,33.16239316239316,morphological_dilation,3,2
0X695AF94E37EA61C5.avi,53,1412,1072,340,31.716417910447763,morphological_dilation,3,2
0X695AF94E37EA61C5.avi,66,1005,713,292,40.95371669004207,morphological_dilation,3,2
0X695E8125B90E542F.avi,70,1370,1030,340,33.00970873786408,morphological_dilation,3,2
0X695E8125B90E542F.avi,87,1009,705,304,43.12056737588652,morphological_dilation,3,2
0X69635DF0D0C9AE26.avi,46,1443,1107,336,30.35230352303523,morphological_dilation,3,2
0X69635DF0D0C9AE26.avi,63,894,622,272,43.729903536977496,morphological_dilation,3,2
0X6963A8CAD6154CFB.avi,31,1825,1445,380,26.297577854671278,morphological_dilation,3,2
0X6963A8CAD6154CFB.avi,43,1405,1065,340,31.92488262910798,morphological_dilation,3,2
0X6965979E40FD1758.avi,78,2047,1639,408,24.893227577791336,morphological_dilation,3,2
0X6965979E40FD1758.avi,94,1490,1142,348,30.472854640980735,morphological_dilation,3,2
0X696599CDFA651DB8.avi,47,2412,1945,467,24.010282776349616,morphological_dilation,3,2
0X696599CDFA651DB8.avi,63,1469,1097,372,33.910665451230635,morphological_dilation,3,2
0X6965A9076612C2A4.avi,51,1742,1366,376,27.52562225475842,morphological_dilation,3,2
0X6965A9076612C2A4.avi,70,1043,739,304,41.13667117726658,morphological_dilation,3,2
0X6966D02D954A8BAD.avi,111,1596,1232,364,29.545454545454547,morphological_dilation,3,2
0X6966D02D954A8BAD.avi,124,1079,773,306,39.58602846054334,morphological_dilation,3,2
0X696A6FF8D9099FD8.avi,108,2165,1721,444,25.79895409645555,morphological_dilation,3,2
0X696A6FF8D9099FD8.avi,124,1593,1201,392,32.63946711074105,morphological_dilation,3,2
0X697A7501D6027B4B.avi,109,1723,1363,360,26.41232575201761,morphological_dilation,3,2
0X697A7501D6027B4B.avi,119,1110,814,296,36.36363636363637,morphological_dilation,3,2
0X6984F621BB01FA4F.avi,88,1956,1564,392,25.063938618925828,morphological_dilation,3,2
0X6984F621BB01FA4F.avi,106,1468,1136,332,29.225352112676056,morphological_dilation,3,2
0X6985788FAE5F8039.avi,69,1568,1216,352,28.947368421052634,morphological_dilation,3,2
0X6985788FAE5F8039.avi,81,997,677,320,47.26735598227474,morphological_dilation,3,2
0X6986F2D866C7AF73.avi,46,1795,1388,407,29.322766570605186,morphological_dilation,3,2
0X6986F2D866C7AF73.avi,60,1104,779,325,41.7201540436457,morphological_dilation,3,2
0X6988345BE72D9814.avi,56,1764,1368,396,28.947368421052634,morphological_dilation,3,2
0X6988345BE72D9814.avi,72,1098,762,336,44.09448818897638,morphological_dilation,3,2
0X698851733B8DB622.avi,28,1249,929,320,34.445640473627556,morphological_dilation,3,2
0X698851733B8DB622.avi,43,930,662,268,40.483383685800604,morphological_dilation,3,2
0X698CD6F727626E9.avi,38,2338,1910,428,22.408376963350783,morphological_dilation,3,2
0X698CD6F727626E9.avi,52,1609,1241,368,29.653505237711524,morphological_dilation,3,2
0X698EF3292D6654DF.avi,84,1567,1207,360,29.82601491300746,morphological_dilation,3,2
0X698EF3292D6654DF.avi,102,1026,718,308,42.89693593314763,morphological_dilation,3,2
0X6992115DA901A8A0.avi,62,1798,1414,384,27.157001414427157,morphological_dilation,3,2
0X6992115DA901A8A0.avi,79,1471,1111,360,32.4032403240324,morphological_dilation,3,2
0X699258A27B9C763D.avi,105,1125,817,308,37.69889840881273,morphological_dilation,3,2
0X699258A27B9C763D.avi,116,750,478,272,56.903765690376574,morphological_dilation,3,2
0X699E3846EC61235F.avi,43,2195,1771,424,23.941276115189158,morphological_dilation,3,2
0X699E3846EC61235F.avi,57,1328,976,352,36.0655737704918,morphological_dilation,3,2
0X699F48578122088.avi,62,1335,991,344,34.71241170534813,morphological_dilation,3,2
0X699F48578122088.avi,76,844,576,268,46.52777777777778,morphological_dilation,3,2
0X69A32C8856DC6879.avi,107,1419,1063,356,33.49012229539041,morphological_dilation,3,2
0X69A32C8856DC6879.avi,122,936,628,308,49.044585987261144,morphological_dilation,3,2
0X69A37D716D3C1EE2.avi,37,1172,848,324,38.20754716981132,morphological_dilation,3,2
0X69A37D716D3C1EE2.avi,53,794,514,280,54.474708171206224,morphological_dilation,3,2
0X69A6D0FAEBA50027.avi,112,1390,1050,340,32.38095238095238,morphological_dilation,3,2
0X69A6D0FAEBA50027.avi,131,952,664,288,43.373493975903614,morphological_dilation,3,2
0X69A75DB4A1B8CA28.avi,32,1380,1019,361,35.426889106967614,morphological_dilation,3,2
0X69A75DB4A1B8CA28.avi,43,1113,769,344,44.733420026007806,morphological_dilation,3,2
0X69AAEA04AAA0FB9D.avi,106,1640,1257,383,30.46937151949085,morphological_dilation,3,2
0X69AAEA04AAA0FB9D.avi,122,1086,746,340,45.57640750670242,morphological_dilation,3,2
0X69AC0873700811D2.avi,78,1647,1283,364,28.37100545596259,morphological_dilation,3,2
0X69AC0873700811D2.avi,94,1040,736,304,41.30434782608695,morphological_dilation,3,2
0X69AE1D1111FCFA43.avi,203,2199,1756,443,25.22779043280182,morphological_dilation,3,2
0X69AE1D1111FCFA43.avi,220,1743,1336,407,30.464071856287422,morphological_dilation,3,2
0X69B0AC9B48CD793E.avi,55,1584,1240,344,27.741935483870968,morphological_dilation,3,2
0X69B0AC9B48CD793E.avi,73,988,700,288,41.14285714285714,morphological_dilation,3,2
0X69B260632B8BF48A.avi,48,1971,1571,400,25.46148949713558,morphological_dilation,3,2
0X69B260632B8BF48A.avi,65,1252,936,316,33.76068376068376,morphological_dilation,3,2
0X69B8866270E7BC77.avi,38,1670,1294,376,29.057187017001546,morphological_dilation,3,2
0X69B8866270E7BC77.avi,51,1129,803,326,40.59775840597759,morphological_dilation,3,2
0X69B8DBAA13F1442B.avi,38,1932,1536,396,25.78125,morphological_dilation,3,2
0X69B8DBAA13F1442B.avi,54,1449,1105,344,31.131221719457013,morphological_dilation,3,2
0X69C0A8E401963AD7.avi,141,1635,1255,380,30.278884462151396,morphological_dilation,3,2
0X69C0A8E401963AD7.avi,156,972,668,304,45.50898203592814,morphological_dilation,3,2
0X69C213A7E1B58743.avi,94,2927,2415,512,21.200828157349896,morphological_dilation,3,2
0X69C213A7E1B58743.avi,112,1676,1265,411,32.4901185770751,morphological_dilation,3,2
0X69C3D72C750DC976.avi,41,1722,1330,392,29.47368421052631,morphological_dilation,3,2
0X69C3D72C750DC976.avi,58,908,624,284,45.51282051282051,morphological_dilation,3,2
0X69C480D704708196.avi,6,1258,934,324,34.68950749464668,morphological_dilation,3,2
0X69C480D704708196.avi,13,1032,732,300,40.98360655737705,morphological_dilation,3,2
0X69C62909E64A686D.avi,0,2408,1945,463,23.804627249357328,morphological_dilation,3,2
0X69C62909E64A686D.avi,18,1330,972,358,36.831275720164605,morphological_dilation,3,2
0X69C718B691DF9F1.avi,0,1345,979,366,37.38508682328907,morphological_dilation,3,2
0X69C718B691DF9F1.avi,15,976,664,312,46.98795180722892,morphological_dilation,3,2
0X69C8AC872A3C32AC.avi,0,1387,1047,340,32.473734479465136,morphological_dilation,3,2
0X69C8AC872A3C32AC.avi,15,932,650,282,43.38461538461538,morphological_dilation,3,2
0X69CAB2A980A78FCB.avi,84,2258,1818,440,24.202420242024203,morphological_dilation,3,2
0X69CAB2A980A78FCB.avi,100,1583,1179,404,34.26632739609839,morphological_dilation,3,2
0X69D4523966BC4AA8.avi,3,2767,2303,464,20.147633521493706,morphological_dilation,3,2
0X69D4523966BC4AA8.avi,18,2328,1892,436,23.044397463002113,morphological_dilation,3,2
0X69D93F969C2F74F8.avi,118,2663,2183,480,21.988089784699955,morphological_dilation,3,2
0X69D93F969C2F74F8.avi,139,2296,1856,440,23.70689655172414,morphological_dilation,3,2
0X69D9E8315AEF4578.avi,32,2371,1935,436,22.532299741602067,morphological_dilation,3,2
0X69D9E8315AEF4578.avi,51,1794,1402,392,27.960057061340944,morphological_dilation,3,2
0X69DB3D6458D62410.avi,59,1988,1592,396,24.87437185929648,morphological_dilation,3,2
0X69DB3D6458D62410.avi,72,1120,804,316,39.30348258706468,morphological_dilation,3,2
0X69DBE98550479217.avi,0,2518,2070,448,21.642512077294686,morphological_dilation,3,2
0X69DBE98550479217.avi,18,1539,1171,368,31.42613151152861,morphological_dilation,3,2
0X69E3C8EB6D834974.avi,50,2120,1708,412,24.121779859484775,morphological_dilation,3,2
0X69E3C8EB6D834974.avi,66,1247,927,320,34.51995685005394,morphological_dilation,3,2
0X69E429AEBAAEC0BD.avi,122,1290,942,348,36.94267515923567,morphological_dilation,3,2
0X69E429AEBAAEC0BD.avi,137,997,701,296,42.22539229671897,morphological_dilation,3,2
0X69E48066CC72C3A1.avi,46,2069,1669,400,23.96644697423607,morphological_dilation,3,2
0X69E48066CC72C3A1.avi,64,1195,883,312,35.334088335220834,morphological_dilation,3,2
0X69EA4A8D900C9F7.avi,59,1519,1167,352,30.162810625535563,morphological_dilation,3,2
0X69EA4A8D900C9F7.avi,77,941,657,284,43.22678843226788,morphological_dilation,3,2
0X69EC4C1F3A5C6786.avi,77,1321,993,328,33.03121852970796,morphological_dilation,3,2
0X69EC4C1F3A5C6786.avi,91,882,606,276,45.54455445544555,morphological_dilation,3,2
0X69F29FDEF96252D8.avi,52,1990,1571,419,26.670910248249523,morphological_dilation,3,2
0X69F29FDEF96252D8.avi,67,1265,908,357,39.31718061674009,morphological_dilation,3,2
0X69F2D313767C34A9.avi,49,1973,1569,404,25.748884639898023,morphological_dilation,3,2
0X69F2D313767C34A9.avi,64,1227,903,324,35.880398671096344,morphological_dilation,3,2
0X69F424E89D494967.avi,154,2009,1590,419,26.352201257861633,morphological_dilation,3,2
0X69F424E89D494967.avi,175,1180,852,328,38.497652582159624,morphological_dilation,3,2
0X69F7556A5A45A5EE.avi,39,1244,888,356,40.090090090090094,morphological_dilation,3,2
0X69F7556A5A45A5EE.avi,46,734,446,288,64.57399103139014,morphological_dilation,3,2
0X69F8CA8E52A2E4E7.avi,32,1890,1502,388,25.832223701731028,morphological_dilation,3,2
0X69F8CA8E52A2E4E7.avi,52,1143,839,304,36.23361144219309,morphological_dilation,3,2
0X69F9014343EC83B3.avi,37,1610,1246,364,29.213483146067414,morphological_dilation,3,2
0X69F9014343EC83B3.avi,59,1184,864,320,37.03703703703704,morphological_dilation,3,2
0X69FC87BF17A55F65.avi,93,1765,1385,380,27.436823104693143,morphological_dilation,3,2
0X69FC87BF17A55F65.avi,106,996,692,304,43.93063583815029,morphological_dilation,3,2
0X69FD55350C07087B.avi,79,1355,999,356,35.63563563563564,morphological_dilation,3,2
0X69FD55350C07087B.avi,98,905,599,306,51.08514190317195,morphological_dilation,3,2
0X69FF17A94F18585A.avi,124,2225,1793,432,24.093697713329615,morphological_dilation,3,2
0X69FF17A94F18585A.avi,134,1543,1159,384,33.13201035375323,morphological_dilation,3,2
0X69FF2B134E1DF1B1.avi,47,2470,2034,436,21.43559488692232,morphological_dilation,3,2
0X69FF2B134E1DF1B1.avi,59,3896,3128,768,24.55242966751918,morphological_dilation,3,2
0X69FFCA63BE0569EF.avi,153,1959,1555,404,25.980707395498392,morphological_dilation,3,2
0X69FFCA63BE0569EF.avi,173,1264,932,332,35.622317596566525,morphological_dilation,3,2
0X6A028337AD76ADD0.avi,103,1709,1321,388,29.371688115064345,morphological_dilation,3,2
0X6A028337AD76ADD0.avi,118,1009,697,312,44.76327116212339,morphological_dilation,3,2
0X6A048AD1DAAA1AB0.avi,64,1740,1354,386,28.508124076809455,morphological_dilation,3,2
0X6A048AD1DAAA1AB0.avi,82,1069,753,316,41.96547144754316,morphological_dilation,3,2
0X6A057FCAB5C853DE.avi,30,1381,968,413,42.66528925619835,morphological_dilation,3,2
0X6A057FCAB5C853DE.avi,42,718,367,351,95.64032697547684,morphological_dilation,3,2
0X6A0657D211ADDAFA.avi,47,2173,1749,424,24.242424242424242,morphological_dilation,3,2
0X6A0657D211ADDAFA.avi,65,1397,1045,352,33.68421052631579,morphological_dilation,3,2
0X6A0C365DCBCF2BC0.avi,41,1815,1399,416,29.735525375268047,morphological_dilation,3,2
0X6A0C365DCBCF2BC0.avi,59,1142,790,352,44.55696202531645,morphological_dilation,3,2
0X6A0E0C2096A56020.avi,69,1718,1342,376,28.017883755588674,morphological_dilation,3,2
0X6A0E0C2096A56020.avi,83,1074,758,316,41.68865435356201,morphological_dilation,3,2
0X6A11E31F14ADFDEE.avi,89,2306,1874,432,23.05229455709712,morphological_dilation,3,2
0X6A11E31F14ADFDEE.avi,104,1581,1213,368,30.33800494641385,morphological_dilation,3,2
0X6A13F71998AA06CA.avi,30,1408,1068,340,31.835205992509362,morphological_dilation,3,2
0X6A13F71998AA06CA.avi,52,870,594,276,46.464646464646464,morphological_dilation,3,2
0X6A1761B3A21AF4F2.avi,57,2298,1830,468,25.573770491803277,morphological_dilation,3,2
0X6A1761B3A21AF4F2.avi,72,1363,983,380,38.657171922685656,morphological_dilation,3,2
0X6A17807E5BD87FA9.avi,78,1843,1447,396,27.36696613683483,morphological_dilation,3,2
0X6A17807E5BD87FA9.avi,99,1199,871,328,37.65786452353617,morphological_dilation,3,2
0X6A1AA81E9712AAFF.avi,72,1322,1006,316,31.411530815109344,morphological_dilation,3,2
0X6A1AA81E9712AAFF.avi,84,877,613,264,43.066884176182704,morphological_dilation,3,2
0X6A1B56577EBFA488.avi,140,1858,1466,392,26.73942701227831,morphological_dilation,3,2
0X6A1B56577EBFA488.avi,155,1160,828,332,40.09661835748793,morphological_dilation,3,2
0X6A272C995486CF4B.avi,111,1704,1348,356,26.409495548961427,morphological_dilation,3,2
0X6A272C995486CF4B.avi,134,1011,739,272,36.80649526387009,morphological_dilation,3,2
0X6A2B51F5E42AAFF1.avi,2,1352,1032,320,31.007751937984494,morphological_dilation,3,2
0X6A2B51F5E42AAFF1.avi,18,867,611,256,41.89852700490999,morphological_dilation,3,2
0X6A306DFCAE00CABC.avi,77,1692,1308,384,29.357798165137616,morphological_dilation,3,2
0X6A306DFCAE00CABC.avi,87,1022,710,312,43.94366197183099,morphological_dilation,3,2
0X6A312BF878BA093F.avi,56,2429,1961,468,23.865374808771037,morphological_dilation,3,2
0X6A312BF878BA093F.avi,70,1480,1084,396,36.53136531365313,morphological_dilation,3,2
0X6A345FD250E04AE0.avi,30,1880,1468,412,28.065395095367844,morphological_dilation,3,2
0X6A345FD250E04AE0.avi,45,1497,1125,372,33.06666666666666,morphological_dilation,3,2
0X6A359AD1490E6F4.avi,69,1210,898,312,34.74387527839644,morphological_dilation,3,2
0X6A359AD1490E6F4.avi,83,819,550,269,48.90909090909091,morphological_dilation,3,2
0X6A38F525525AABEF.avi,50,1680,1305,375,28.735632183908045,morphological_dilation,3,2
0X6A38F525525AABEF.avi,66,1063,743,320,43.06864064602961,morphological_dilation,3,2
0X6A3EE162DF19062F.avi,36,2200,1780,420,23.595505617977526,morphological_dilation,3,2
0X6A3EE162DF19062F.avi,53,1402,1050,352,33.523809523809526,morphological_dilation,3,2
0X6A403037B3DF0127.avi,74,1748,1392,356,25.57471264367816,morphological_dilation,3,2
0X6A403037B3DF0127.avi,92,1029,753,276,36.65338645418327,morphological_dilation,3,2
0X6A40752EF8FB5AB2.avi,78,1525,1165,360,30.90128755364807,morphological_dilation,3,2
0X6A40752EF8FB5AB2.avi,97,932,648,284,43.82716049382716,morphological_dilation,3,2
0X6A45FBB2F8991E0E.avi,77,2253,1829,424,23.18206670311646,morphological_dilation,3,2
0X6A45FBB2F8991E0E.avi,96,1622,1250,372,29.759999999999998,morphological_dilation,3,2
0X6A46321A41C98FC7.avi,0,1641,1277,364,28.50430696945967,morphological_dilation,3,2
0X6A46321A41C98FC7.avi,9,1331,1003,328,32.701894317048854,morphological_dilation,3,2
0X6A517CFB3CC37E24.avi,61,1265,941,324,34.431455897980875,morphological_dilation,3,2
0X6A517CFB3CC37E24.avi,71,771,512,259,50.5859375,morphological_dilation,3,2
0X6A5374D97C7E9202.avi,102,1295,959,336,35.03649635036496,morphological_dilation,3,2
0X6A5374D97C7E9202.avi,115,821,545,276,50.64220183486239,morphological_dilation,3,2
0X6A56B3B7CF5AC64E.avi,37,2265,1837,428,23.298856831790964,morphological_dilation,3,2
0X6A56B3B7CF5AC64E.avi,52,1825,1441,384,26.648160999306036,morphological_dilation,3,2
0X6A57513F8621F814.avi,34,2131,1703,428,25.132119788608335,morphological_dilation,3,2
0X6A57513F8621F814.avi,49,1233,901,332,36.847946725860155,morphological_dilation,3,2
0X6A59ABB6D7C8F0BA.avi,112,1776,1325,451,34.0377358490566,morphological_dilation,3,2
0X6A59ABB6D7C8F0BA.avi,135,1285,879,406,46.188850967007966,morphological_dilation,3,2
0X6A5AA7CA64C74AC1.avi,101,3396,2856,540,18.907563025210084,morphological_dilation,3,2
0X6A5AA7CA64C74AC1.avi,121,2171,1707,464,27.182190978324545,morphological_dilation,3,2
0X6A6422046F7969F2.avi,150,1804,1412,392,27.762039660056658,morphological_dilation,3,2
0X6A6422046F7969F2.avi,170,1266,932,334,35.836909871244636,morphological_dilation,3,2
0X6A66AAE9B2D3C42C.avi,47,1757,1353,404,29.859571322985957,morphological_dilation,3,2
0X6A66AAE9B2D3C42C.avi,62,1097,769,328,42.65279583875163,morphological_dilation,3,2
0X6A672DABBE9F8660.avi,73,1685,1309,376,28.72421695951108,morphological_dilation,3,2
0X6A672DABBE9F8660.avi,90,1038,714,324,45.378151260504204,morphological_dilation,3,2
0X6A815B26E4D6AFC3.avi,2,1596,1238,358,28.91760904684976,morphological_dilation,3,2
0X6A815B26E4D6AFC3.avi,19,981,691,290,41.96816208393632,morphological_dilation,3,2
0X6A86E26CF3DBBB34.avi,126,2139,1711,428,25.014611338398595,morphological_dilation,3,2
0X6A86E26CF3DBBB34.avi,144,1614,1242,372,29.951690821256037,morphological_dilation,3,2
0X6A878BE2BE37679E.avi,96,1295,955,340,35.602094240837694,morphological_dilation,3,2
0X6A878BE2BE37679E.avi,114,807,529,278,52.55198487712666,morphological_dilation,3,2
0X6A8AA36725720569.avi,2,1794,1418,376,26.516220028208743,morphological_dilation,3,2
0X6A8AA36725720569.avi,11,1296,960,336,35.0,morphological_dilation,3,2
0X6A9103398B308FE3.avi,55,2169,1746,423,24.22680412371134,morphological_dilation,3,2
0X6A9103398B308FE3.avi,73,1471,1113,358,32.16531895777179,morphological_dilation,3,2
0X6A91B83DDA5ED01.avi,35,1339,1015,324,31.92118226600985,morphological_dilation,3,2
0X6A91B83DDA5ED01.avi,47,819,551,268,48.63883847549909,morphological_dilation,3,2
0X6A95031DBF74CF5E.avi,33,1958,1566,392,25.03192848020434,morphological_dilation,3,2
0X6A95031DBF74CF5E.avi,46,1170,846,324,38.297872340425535,morphological_dilation,3,2
0X6A99F933F0F63900.avi,38,2328,1852,476,25.70194384449244,morphological_dilation,3,2
0X6A99F933F0F63900.avi,54,1332,960,372,38.75,morphological_dilation,3,2
0X6AA21353DB219B2E.avi,83,2531,2059,472,22.92374939290918,morphological_dilation,3,2
0X6AA21353DB219B2E.avi,100,1550,1158,392,33.85146804835924,morphological_dilation,3,2
0X6AA45821A706A75B.avi,3,1384,1044,340,32.56704980842912,morphological_dilation,3,2
0X6AA45821A706A75B.avi,19,860,588,272,46.25850340136054,morphological_dilation,3,2
0X6AA4D34DB3D5F6CA.avi,78,2991,2499,492,19.687875150060023,morphological_dilation,3,2
0X6AA4D34DB3D5F6CA.avi,87,1995,1563,432,27.63915547024952,morphological_dilation,3,2
0X6AA5302902FB3B83.avi,35,1718,1334,384,28.7856071964018,morphological_dilation,3,2
0X6AA5302902FB3B83.avi,53,1385,1049,336,32.030505243088655,morphological_dilation,3,2
0X6AAE22F1E3985AD6.avi,120,1264,952,312,32.773109243697476,morphological_dilation,3,2
0X6AAE22F1E3985AD6.avi,137,1073,781,292,37.38796414852753,morphological_dilation,3,2
0X6AAF124C7AD3E7E4.avi,57,2368,1936,432,22.31404958677686,morphological_dilation,3,2
0X6AAF124C7AD3E7E4.avi,77,1693,1289,404,31.342125678820793,morphological_dilation,3,2
0X6AB2016D376D7783.avi,57,2348,1880,468,24.893617021276597,morphological_dilation,3,2
0X6AB2016D376D7783.avi,77,1408,1013,395,38.99308983218164,morphological_dilation,3,2
0X6AB214EB6B92DC02.avi,48,2207,1751,456,26.0422615648201,morphological_dilation,3,2
0X6AB214EB6B92DC02.avi,64,1433,1053,380,36.08736942070275,morphological_dilation,3,2
0X6AB2CF56234A13CC.avi,3,2447,2015,432,21.439205955334987,morphological_dilation,3,2
0X6AB2CF56234A13CC.avi,25,1550,1206,344,28.524046434494192,morphological_dilation,3,2
0X6ABAD097CBF31D41.avi,55,1280,956,324,33.89121338912134,morphological_dilation,3,2
0X6ABAD097CBF31D41.avi,77,853,565,288,50.97345132743363,morphological_dilation,3,2
0X6ABB8932C0471F4A.avi,95,2345,1905,440,23.097112860892388,morphological_dilation,3,2
0X6ABB8932C0471F4A.avi,110,1451,1095,356,32.51141552511416,morphological_dilation,3,2
0X6AC075B8CAE1D6EF.avi,55,1939,1543,396,25.664290343486712,morphological_dilation,3,2
0X6AC075B8CAE1D6EF.avi,76,1154,838,316,37.70883054892602,morphological_dilation,3,2
0X6AC11E656F4E93A3.avi,95,1905,1533,372,24.26614481409002,morphological_dilation,3,2
0X6AC11E656F4E93A3.avi,109,1326,990,336,33.939393939393945,morphological_dilation,3,2
0X6AC5A4C46C17EDC0.avi,44,1515,1165,350,30.042918454935624,morphological_dilation,3,2
0X6AC5A4C46C17EDC0.avi,64,897,621,276,44.44444444444444,morphological_dilation,3,2
0X6AC5DBD72B2B9C21.avi,68,1541,1189,352,29.60470984020185,morphological_dilation,3,2
0X6AC5DBD72B2B9C21.avi,84,940,664,276,41.566265060240966,morphological_dilation,3,2
0X6ACAC4D295EF82BF.avi,51,2404,1956,448,22.903885480572598,morphological_dilation,3,2
0X6ACAC4D295EF82BF.avi,79,1981,1565,416,26.5814696485623,morphological_dilation,3,2
0X6ACCE729AC05AB06.avi,98,2209,1805,404,22.382271468144044,morphological_dilation,3,2
0X6ACCE729AC05AB06.avi,117,1504,1152,352,30.555555555555557,morphological_dilation,3,2
0X6AD2C1663EF05305.avi,44,1606,1246,360,28.892455858747994,morphological_dilation,3,2
0X6AD2C1663EF05305.avi,64,1077,773,304,39.32729624838293,morphological_dilation,3,2
0X6AD577606BAF71F0.avi,0,1539,1195,344,28.78661087866109,morphological_dilation,3,2
0X6AD577606BAF71F0.avi,16,1251,943,308,32.66171792152704,morphological_dilation,3,2
0X6AD714938AE64D1B.avi,68,1662,1298,364,28.043143297380585,morphological_dilation,3,2
0X6AD714938AE64D1B.avi,89,1182,854,328,38.40749414519906,morphological_dilation,3,2
0X6ADA9C1585183871.avi,81,2139,1731,408,23.570190641247834,morphological_dilation,3,2
0X6ADA9C1585183871.avi,101,1303,979,324,33.09499489274771,morphological_dilation,3,2
0X6ADC5D0D968E9E34.avi,4,1549,1189,360,30.27754415475189,morphological_dilation,3,2
0X6ADC5D0D968E9E34.avi,18,993,677,316,46.67651403249631,morphological_dilation,3,2
0X6AE2A159097AC945.avi,59,1816,1448,368,25.41436464088398,morphological_dilation,3,2
0X6AE2A159097AC945.avi,86,1428,1096,332,30.29197080291971,morphological_dilation,3,2
0X6AE3A2071303CF5.avi,50,1811,1431,380,26.554856743535986,morphological_dilation,3,2
0X6AE3A2071303CF5.avi,69,1205,893,312,34.93840985442329,morphological_dilation,3,2
0X6AE44761D3CEF95D.avi,46,1527,1179,348,29.51653944020356,morphological_dilation,3,2
0X6AE44761D3CEF95D.avi,64,995,699,296,42.34620886981402,morphological_dilation,3,2
0X6AECECDB65A32BF.avi,89,2348,1932,416,21.532091097308488,morphological_dilation,3,2
0X6AECECDB65A32BF.avi,104,1967,1587,380,23.944549464398236,morphological_dilation,3,2
0X6AEDF24703853E45.avi,46,1662,1294,368,28.438948995363216,morphological_dilation,3,2
0X6AEDF24703853E45.avi,65,1088,788,300,38.07106598984771,morphological_dilation,3,2
0X6AEE34060EAF4A09.avi,41,1699,1327,372,28.03315749811605,morphological_dilation,3,2
0X6AEE34060EAF4A09.avi,60,1026,734,292,39.782016348773844,morphological_dilation,3,2
0X6AF3B88FF98DE62F.avi,46,2037,1637,400,24.434941967012826,morphological_dilation,3,2
0X6AF3B88FF98DE62F.avi,62,1344,1016,328,32.28346456692913,morphological_dilation,3,2
0X6AF702536B894D22.avi,40,2434,1970,464,23.553299492385786,morphological_dilation,3,2
0X6AF702536B894D22.avi,56,1870,1447,423,29.23289564616448,morphological_dilation,3,2
0X6AF72AAF6B829695.avi,125,2486,2026,460,22.704837117472852,morphological_dilation,3,2
0X6AF72AAF6B829695.avi,138,1435,1047,388,37.058261700095514,morphological_dilation,3,2
0X6AF8B5ACB5A3A683.avi,49,1462,1107,355,32.068654019873534,morphological_dilation,3,2
0X6AF8B5ACB5A3A683.avi,65,845,561,284,50.623885918003566,morphological_dilation,3,2
0X6AFAD37CC4FF9AD9.avi,3,2490,2042,448,21.939275220372185,morphological_dilation,3,2
0X6AFAD37CC4FF9AD9.avi,19,1603,1219,384,31.501230516817063,morphological_dilation,3,2
0X6AFD6474F2A92942.avi,83,1802,1406,396,28.165007112375534,morphological_dilation,3,2
0X6AFD6474F2A92942.avi,90,1161,839,322,38.37902264600715,morphological_dilation,3,2
0X6B0A6A101C2DA474.avi,47,2318,1894,424,22.38648363252376,morphological_dilation,3,2
0X6B0A6A101C2DA474.avi,66,1697,1325,372,28.07547169811321,morphological_dilation,3,2
0X6B0DFC83DD945692.avi,62,1695,1315,380,28.89733840304182,morphological_dilation,3,2
0X6B0DFC83DD945692.avi,81,1109,793,316,39.84867591424969,morphological_dilation,3,2
0X6B11525181625135.avi,3,1437,1079,358,33.178869323447636,morphological_dilation,3,2
0X6B11525181625135.avi,14,901,613,288,46.98205546492659,morphological_dilation,3,2
0X6B11CABFF1156096.avi,114,1889,1495,394,26.354515050167226,morphological_dilation,3,2
0X6B11CABFF1156096.avi,132,1309,979,330,33.70786516853933,morphological_dilation,3,2
0X6B1DB923FB0B3D34.avi,45,1523,1162,361,31.0671256454389,morphological_dilation,3,2
0X6B1DB923FB0B3D34.avi,62,844,572,272,47.55244755244755,morphological_dilation,3,2
0X6B1E22AC8DA7DC1B.avi,39,2708,2224,484,21.762589928057555,morphological_dilation,3,2
0X6B1E22AC8DA7DC1B.avi,53,1639,1245,394,31.64658634538153,morphological_dilation,3,2
0X6B1F4CDE430CF543.avi,108,3357,2776,581,20.929394812680115,morphological_dilation,3,2
0X6B1F4CDE430CF543.avi,122,2721,2142,579,27.030812324929972,morphological_dilation,3,2
0X6B23E32A7A8721AE.avi,77,1419,1087,332,30.542778288868444,morphological_dilation,3,2
0X6B23E32A7A8721AE.avi,94,925,645,280,43.41085271317829,morphological_dilation,3,2
0X6B27953A008A7289.avi,36,849,593,256,43.17032040472175,morphological_dilation,3,2
0X6B27953A008A7289.avi,50,619,395,224,56.708860759493675,morphological_dilation,3,2
0X6B2D065F4C186816.avi,41,1384,1032,352,34.10852713178294,morphological_dilation,3,2
0X6B2D065F4C186816.avi,57,813,532,281,52.819548872180455,morphological_dilation,3,2
0X6B2DF895741FC467.avi,62,2694,2222,472,21.242124212421242,morphological_dilation,3,2
0X6B2DF895741FC467.avi,79,1908,1504,404,26.861702127659576,morphological_dilation,3,2
0X6B2EFC4E87D3174B.avi,76,2499,2059,440,21.369596891694997,morphological_dilation,3,2
0X6B2EFC4E87D3174B.avi,92,1589,1209,380,31.430934656741112,morphological_dilation,3,2
0X6B2FE7C32EE5CCFF.avi,72,2704,2220,484,21.8018018018018,morphological_dilation,3,2
0X6B2FE7C32EE5CCFF.avi,89,1780,1376,404,29.360465116279073,morphological_dilation,3,2
0X6B339B82A5BC31E3.avi,66,2079,1667,412,24.715056988602278,morphological_dilation,3,2
0X6B339B82A5BC31E3.avi,80,1351,1023,328,32.06256109481916,morphological_dilation,3,2
0X6B38A2D99D5A9A86.avi,53,1324,996,328,32.93172690763052,morphological_dilation,3,2
0X6B38A2D99D5A9A86.avi,66,821,535,286,53.45794392523364,morphological_dilation,3,2
0X6B3A89FD473A9830.avi,53,2423,1967,456,23.182511438739198,morphological_dilation,3,2
0X6B3A89FD473A9830.avi,74,1778,1382,396,28.65412445730825,morphological_dilation,3,2
0X6B3B9DBE3492A37A.avi,82,971,691,280,40.520984081041966,morphological_dilation,3,2
0X6B3B9DBE3492A37A.avi,98,640,404,236,58.415841584158414,morphological_dilation,3,2
0X6B40061914A0E9A2.avi,190,1231,923,308,33.3694474539545,morphological_dilation,3,2
0X6B40061914A0E9A2.avi,209,859,591,268,45.346869712351946,morphological_dilation,3,2
0X6B462232B332BB81.avi,100,1875,1483,392,26.43290627107215,morphological_dilation,3,2
0X6B462232B332BB81.avi,120,1073,769,304,39.531859557867364,morphological_dilation,3,2
0X6B4A75FD6BC165AC.avi,53,2545,2085,460,22.062350119904075,morphological_dilation,3,2
0X6B4A75FD6BC165AC.avi,76,1751,1377,374,27.160493827160494,morphological_dilation,3,2
0X6B4C80EEEEE6191D.avi,5,1493,1137,356,31.310466138962177,morphological_dilation,3,2
0X6B4C80EEEEE6191D.avi,17,1041,745,296,39.73154362416108,morphological_dilation,3,2
0X6B4CCBC68946C0C9.avi,79,1697,1322,375,28.3661119515885,morphological_dilation,3,2
0X6B4CCBC68946C0C9.avi,99,1203,883,320,36.2400906002265,morphological_dilation,3,2
0X6B4FFBA68707FA0E.avi,110,1898,1486,412,27.725437415881558,morphological_dilation,3,2
0X6B4FFBA68707FA0E.avi,122,1125,809,316,39.060568603213845,morphological_dilation,3,2
0X6B5A0E853A0A1C2F.avi,132,1528,1152,376,32.63888888888889,morphological_dilation,3,2
0X6B5A0E853A0A1C2F.avi,163,2263,1833,430,23.458810692853245,morphological_dilation,3,2
0X6B5BCB03E1D68359.avi,51,2343,1919,424,22.094841063053675,morphological_dilation,3,2
0X6B5BCB03E1D68359.avi,70,1433,1081,352,32.56244218316374,morphological_dilation,3,2
0X6B61269F34260EB7.avi,39,1570,1210,360,29.75206611570248,morphological_dilation,3,2
0X6B61269F34260EB7.avi,53,946,662,284,42.90030211480362,morphological_dilation,3,2
0X6B65849509F23240.avi,163,2646,2143,503,23.471768548763418,morphological_dilation,3,2
0X6B65849509F23240.avi,183,1854,1410,444,31.48936170212766,morphological_dilation,3,2
0X6B6CE145549C8D00.avi,35,2975,2475,500,20.2020202020202,morphological_dilation,3,2
0X6B6CE145549C8D00.avi,48,2083,1631,452,27.71305947271612,morphological_dilation,3,2
0X6B6F3EC5EF795B2.avi,60,1297,977,320,32.75332650972365,morphological_dilation,3,2
0X6B6F3EC5EF795B2.avi,82,828,556,272,48.92086330935252,morphological_dilation,3,2
0X6B7033724FFD6F8F.avi,71,1801,1417,384,27.09950599858857,morphological_dilation,3,2
0X6B7033724FFD6F8F.avi,91,1215,887,328,36.97857948139797,morphological_dilation,3,2
0X6B795206FC9812.avi,52,2029,1601,428,26.733291692692067,morphological_dilation,3,2
0X6B795206FC9812.avi,70,1332,980,352,35.91836734693877,morphological_dilation,3,2
0X6B79A0A18B813FF2.avi,53,1675,1282,393,30.655226209048365,morphological_dilation,3,2
0X6B79A0A18B813FF2.avi,74,960,660,300,45.45454545454545,morphological_dilation,3,2
0X6B847242732C2FD4.avi,91,3243,2719,524,19.271791099669,morphological_dilation,3,2
0X6B847242732C2FD4.avi,118,2149,1721,428,24.869262056943636,morphological_dilation,3,2
0X6B84D4354376CA3F.avi,30,1353,1009,344,34.093161546085234,morphological_dilation,3,2
0X6B84D4354376CA3F.avi,41,871,591,280,47.377326565143825,morphological_dilation,3,2
0X6B852E31BFC8D585.avi,43,3132,2636,496,18.81638846737481,morphological_dilation,3,2
0X6B852E31BFC8D585.avi,59,2725,2265,460,20.309050772626932,morphological_dilation,3,2
0X6B8CAD148A81CBB1.avi,67,1748,1376,372,27.03488372093023,morphological_dilation,3,2
0X6B8CAD148A81CBB1.avi,79,1111,811,300,36.99136868064119,morphological_dilation,3,2
0X6B944AB275F93DEF.avi,93,2060,1624,436,26.84729064039409,morphological_dilation,3,2
0X6B944AB275F93DEF.avi,111,1628,1256,372,29.617834394904456,morphological_dilation,3,2
0X6B9AC2C41A07C9AD.avi,85,1614,1234,380,30.79416531604538,morphological_dilation,3,2
0X6B9AC2C41A07C9AD.avi,97,1066,730,336,46.02739726027397,morphological_dilation,3,2
0X6B9AD5750DEB23A6.avi,57,2277,1849,428,23.14764737696052,morphological_dilation,3,2
0X6B9AD5750DEB23A6.avi,68,1242,910,332,36.48351648351648,morphological_dilation,3,2
0X6B9BD7183EE0233C.avi,43,1640,1240,400,32.25806451612903,morphological_dilation,3,2
0X6B9BD7183EE0233C.avi,59,896,604,292,48.34437086092716,morphological_dilation,3,2
0X6BA0C1F6396FBEA1.avi,60,1773,1393,380,27.27925340990668,morphological_dilation,3,2
0X6BA0C1F6396FBEA1.avi,80,1107,791,316,39.94943109987358,morphological_dilation,3,2
0X6BA126FDC669D53C.avi,1,2154,1730,424,24.508670520231213,morphological_dilation,3,2
0X6BA126FDC669D53C.avi,20,1804,1396,408,29.22636103151863,morphological_dilation,3,2
0X6BA1F9C41B2F3F5D.avi,73,1706,1334,372,27.886056971514243,morphological_dilation,3,2
0X6BA1F9C41B2F3F5D.avi,87,999,699,300,42.91845493562232,morphological_dilation,3,2
0X6BA7CB2E44532208.avi,1,1730,1350,380,28.14814814814815,morphological_dilation,3,2
0X6BA7CB2E44532208.avi,19,1106,798,308,38.59649122807017,morphological_dilation,3,2
0X6BAE140DBD757831.avi,26,2542,2026,516,25.468904244817374,morphological_dilation,3,2
0X6BAE140DBD757831.avi,38,2050,1553,497,32.00257566001288,morphological_dilation,3,2
0X6BAE7A563B2DD386.avi,51,1087,779,308,39.53786906290115,morphological_dilation,3,2
0X6BAE7A563B2DD386.avi,66,712,452,260,57.52212389380531,morphological_dilation,3,2
0X6BAEE8E7A0B91927.avi,103,1580,1220,360,29.508196721311474,morphological_dilation,3,2
0X6BAEE8E7A0B91927.avi,118,1315,979,336,34.32073544433095,morphological_dilation,3,2
0X6BB43007F6D02580.avi,49,1200,892,308,34.52914798206278,morphological_dilation,3,2
0X6BB43007F6D02580.avi,64,791,527,264,50.094876660341555,morphological_dilation,3,2
0X6BB45EC1521D9905.avi,3,1029,745,284,38.12080536912752,morphological_dilation,3,2
0X6BB45EC1521D9905.avi,11,633,391,242,61.892583120204606,morphological_dilation,3,2
0X6BB6FA41CE7DAC0A.avi,51,1528,1148,380,33.10104529616725,morphological_dilation,3,2
0X6BB6FA41CE7DAC0A.avi,68,1044,744,300,40.32258064516129,morphological_dilation,3,2
0X6BB792FB95F3E857.avi,50,1046,714,332,46.49859943977591,morphological_dilation,3,2
0X6BB792FB95F3E857.avi,66,661,368,293,79.61956521739131,morphological_dilation,3,2
0X6BB8FC06EB041453.avi,36,1611,1247,364,29.190056134723335,morphological_dilation,3,2
0X6BB8FC06EB041453.avi,48,886,614,272,44.299674267100976,morphological_dilation,3,2
0X6BBADD595AFAC303.avi,50,1759,1395,364,26.093189964157702,morphological_dilation,3,2
0X6BBADD595AFAC303.avi,70,1037,729,308,42.249657064471876,morphological_dilation,3,2
0X6BBC4723F3165464.avi,120,1880,1476,404,27.371273712737125,morphological_dilation,3,2
0X6BBC4723F3165464.avi,138,1188,868,320,36.86635944700461,morphological_dilation,3,2
0X6BBD548654D21A11.avi,54,1809,1433,376,26.238660153524073,morphological_dilation,3,2
0X6BBD548654D21A11.avi,69,1029,744,285,38.306451612903224,morphological_dilation,3,2
0X6BC02B386AAEC4CF.avi,79,1544,1176,368,31.292517006802722,morphological_dilation,3,2
0X6BC02B386AAEC4CF.avi,90,1010,710,300,42.25352112676056,morphological_dilation,3,2
0X6BC0B15E4B0FA423.avi,45,1900,1484,416,28.03234501347709,morphological_dilation,3,2
0X6BC0B15E4B0FA423.avi,62,1165,811,354,43.6498150431566,morphological_dilation,3,2
0X6BCB3492D214A026.avi,38,1121,813,308,37.88437884378843,morphological_dilation,3,2
0X6BCB3492D214A026.avi,54,813,545,268,49.174311926605505,morphological_dilation,3,2
0X6BCD517148A647B3.avi,34,2282,1834,448,24.427480916030532,morphological_dilation,3,2
0X6BCD517148A647B3.avi,52,1301,957,344,35.94566353187043,morphological_dilation,3,2
0X6BCFA12367018AA4.avi,138,2345,1913,432,22.582331416623106,morphological_dilation,3,2
0X6BCFA12367018AA4.avi,158,1828,1448,380,26.243093922651934,morphological_dilation,3,2
0X6BD2B2D475E661ED.avi,39,1562,1190,372,31.26050420168067,morphological_dilation,3,2
0X6BD2B2D475E661ED.avi,57,1007,695,312,44.89208633093525,morphological_dilation,3,2
0X6BD400324E98B517.avi,118,1561,1217,344,28.26622843056697,morphological_dilation,3,2
0X6BD400324E98B517.avi,128,969,685,284,41.45985401459854,morphological_dilation,3,2
0X6BD647AB22EFCD94.avi,40,1594,1242,352,28.34138486312399,morphological_dilation,3,2
0X6BD647AB22EFCD94.avi,58,926,634,292,46.05678233438486,morphological_dilation,3,2
0X6BDA434694AF0673.avi,107,1992,1580,412,26.075949367088608,morphological_dilation,3,2
0X6BDA434694AF0673.avi,121,1221,882,339,38.435374149659864,morphological_dilation,3,2
0X6BE01E7D45855CA0.avi,36,2049,1661,388,23.359422034918722,morphological_dilation,3,2
0X6BE01E7D45855CA0.avi,56,1560,1216,344,28.289473684210524,morphological_dilation,3,2
0X6BE1E54E59745D35.avi,130,2239,1815,424,23.360881542699723,morphological_dilation,3,2
0X6BE1E54E59745D35.avi,148,1424,1068,356,33.33333333333333,morphological_dilation,3,2
0X6BE62DA9E887AC67.avi,58,2216,1784,432,24.2152466367713,morphological_dilation,3,2
0X6BE62DA9E887AC67.avi,76,1557,1185,372,31.39240506329114,morphological_dilation,3,2
0X6BE91CF2978A1FEC.avi,78,1386,1058,328,31.001890359168243,morphological_dilation,3,2
0X6BE91CF2978A1FEC.avi,100,949,669,280,41.85351270553064,morphological_dilation,3,2
0X6BEA2DC58CE6450E.avi,85,4218,3650,568,15.561643835616437,morphological_dilation,3,2
0X6BEA2DC58CE6450E.avi,98,3616,3084,532,17.250324254215304,morphological_dilation,3,2
0X6BEA70A342F82F3A.avi,123,2456,2028,428,21.104536489151872,morphological_dilation,3,2
0X6BEA70A342F82F3A.avi,137,1647,1275,372,29.176470588235293,morphological_dilation,3,2
0X6BEF1A4315F47874.avi,45,2446,1990,456,22.91457286432161,morphological_dilation,3,2
0X6BEF1A4315F47874.avi,63,1625,1245,380,30.522088353413658,morphological_dilation,3,2
0X6BF29A819EEFB22E.avi,38,1404,1064,340,31.954887218045116,morphological_dilation,3,2
0X6BF29A819EEFB22E.avi,56,817,557,260,46.678635547576306,morphological_dilation,3,2
0X6BF32F3C69A2D30F.avi,38,1938,1514,424,28.005284015852048,morphological_dilation,3,2
0X6BF32F3C69A2D30F.avi,51,1145,821,324,39.46406820950061,morphological_dilation,3,2
0X6BF4AAB4262F8FB.avi,35,1273,953,320,33.57817418677859,morphological_dilation,3,2
0X6BF4AAB4262F8FB.avi,47,1061,765,296,38.692810457516345,morphological_dilation,3,2
0X6BF648EA45DB6EC2.avi,63,1338,1010,328,32.475247524752476,morphological_dilation,3,2
0X6BF648EA45DB6EC2.avi,81,868,604,264,43.70860927152318,morphological_dilation,3,2
0X6BFB095DFDB65B76.avi,55,2021,1598,423,26.47058823529412,morphological_dilation,3,2
0X6BFB095DFDB65B76.avi,76,1715,1319,396,30.022744503411676,morphological_dilation,3,2
0X6C0DE6F4A3F8EFA2.avi,44,1542,1186,356,30.016863406408095,morphological_dilation,3,2
0X6C0DE6F4A3F8EFA2.avi,60,1008,724,284,39.226519337016576,morphological_dilation,3,2
0X6C124671AA84BFE1.avi,90,913,625,288,46.08,morphological_dilation,3,2
0X6C124671AA84BFE1.avi,112,1321,956,365,38.17991631799163,morphological_dilation,3,2
0X6C16E130ABB2C0E0.avi,31,1165,845,320,37.8698224852071,morphological_dilation,3,2
0X6C16E130ABB2C0E0.avi,46,720,460,260,56.52173913043478,morphological_dilation,3,2
0X6C1D818071AF7631.avi,38,1460,1104,356,32.2463768115942,morphological_dilation,3,2
0X6C1D818071AF7631.avi,54,1051,751,300,39.94673768308921,morphological_dilation,3,2
0X6C2063707735D95A.avi,83,1268,921,347,37.67643865363735,morphological_dilation,3,2
0X6C2063707735D95A.avi,103,840,539,301,55.84415584415584,morphological_dilation,3,2
0X6C27151F964430AB.avi,104,1921,1525,396,25.967213114754102,morphological_dilation,3,2
0X6C27151F964430AB.avi,121,1509,1153,356,30.875975715524717,morphological_dilation,3,2
0X6C27302CA6B46DDD.avi,79,2247,1803,444,24.625623960066555,morphological_dilation,3,2
0X6C27302CA6B46DDD.avi,96,1333,977,356,36.438075742067554,morphological_dilation,3,2
0X6C324F34DB86F19F.avi,104,1526,1178,348,29.541595925297116,morphological_dilation,3,2
0X6C324F34DB86F19F.avi,120,861,593,268,45.193929173693085,morphological_dilation,3,2
0X6C355568312FC87.avi,81,2352,1904,448,23.52941176470588,morphological_dilation,3,2
0X6C355568312FC87.avi,95,1507,1151,356,30.929626411815814,morphological_dilation,3,2
0X6C3C503CF8149861.avi,44,2413,1941,472,24.31736218444101,morphological_dilation,3,2
0X6C3C503CF8149861.avi,65,1558,1164,394,33.84879725085911,morphological_dilation,3,2
0X6C3D4D23B03718DD.avi,85,1430,1086,344,31.675874769797424,morphological_dilation,3,2
0X6C3D4D23B03718DD.avi,99,926,642,284,44.23676012461059,morphological_dilation,3,2
0X6C3F001BAD38760.avi,57,3173,2677,496,18.528203212551364,morphological_dilation,3,2
0X6C3F001BAD38760.avi,77,1935,1526,409,26.802096985583223,morphological_dilation,3,2
0X6C44C62622B476DC.avi,82,2105,1693,412,24.335499113998818,morphological_dilation,3,2
0X6C44C62622B476DC.avi,105,1622,1260,362,28.730158730158728,morphological_dilation,3,2
0X6C47FA29EAF6395.avi,44,1437,1105,332,30.04524886877828,morphological_dilation,3,2
0X6C47FA29EAF6395.avi,60,977,693,284,40.98124098124098,morphological_dilation,3,2
0X6C4C18C40E312836.avi,40,1395,1027,368,35.83252190847128,morphological_dilation,3,2
0X6C4C18C40E312836.avi,53,829,545,284,52.11009174311927,morphological_dilation,3,2
0X6C4EE7DD884416AD.avi,73,1982,1578,404,25.602027883396705,morphological_dilation,3,2
0X6C4EE7DD884416AD.avi,85,1300,952,348,36.554621848739494,morphological_dilation,3,2
0X6C5335E45E2F052C.avi,88,816,540,276,51.11111111111111,morphological_dilation,3,2
0X6C5335E45E2F052C.avi,100,510,285,225,78.94736842105263,morphological_dilation,3,2
0X6C547E1353778F5C.avi,49,1767,1395,372,26.666666666666668,morphological_dilation,3,2
0X6C547E1353778F5C.avi,70,1124,828,296,35.748792270531396,morphological_dilation,3,2
0X6C56FD0ECEF3C539.avi,57,2675,2195,480,21.867881548974943,morphological_dilation,3,2
0X6C56FD0ECEF3C539.avi,78,1762,1366,396,28.989751098096633,morphological_dilation,3,2
0X6C5861D9F2B5EFF5.avi,55,2195,1743,452,25.93230063109581,morphological_dilation,3,2
0X6C5861D9F2B5EFF5.avi,72,1361,993,368,37.05941591137966,morphological_dilation,3,2
0X6C5E836554770576.avi,28,2485,2029,456,22.47412518482011,morphological_dilation,3,2
0X6C5E836554770576.avi,53,1865,1437,428,29.784272790535837,morphological_dilation,3,2
0X6C626BE4E38EF658.avi,52,1973,1573,400,25.429116338207248,morphological_dilation,3,2
0X6C626BE4E38EF658.avi,70,1289,965,324,33.575129533678755,morphological_dilation,3,2
0X6C64E0A64888EDBD.avi,61,1994,1594,400,25.094102885821833,morphological_dilation,3,2
0X6C64E0A64888EDBD.avi,76,1082,762,320,41.99475065616798,morphological_dilation,3,2
0X6C64F98CFB71222C.avi,67,1632,1276,356,27.89968652037618,morphological_dilation,3,2
0X6C64F98CFB71222C.avi,85,1038,734,304,41.41689373297003,morphological_dilation,3,2
0X6C6533842D5D2E66.avi,69,1619,1267,352,27.782162588792424,morphological_dilation,3,2
0X6C6533842D5D2E66.avi,91,1415,1067,348,32.61480787253983,morphological_dilation,3,2
0X6C68456E30B1AE43.avi,73,2613,2133,480,22.50351617440225,morphological_dilation,3,2
0X6C68456E30B1AE43.avi,90,1547,1183,364,30.76923076923077,morphological_dilation,3,2
0X6C6C283053A8DC92.avi,110,2296,1860,436,23.440860215053764,morphological_dilation,3,2
0X6C6C283053A8DC92.avi,133,1533,1169,364,31.137724550898206,morphological_dilation,3,2
0X6C6C7F4259045DFA.avi,46,1136,820,316,38.53658536585366,morphological_dilation,3,2
0X6C6C7F4259045DFA.avi,68,725,473,252,53.276955602537,morphological_dilation,3,2
0X6C6ED89AB6CF2534.avi,39,2638,2166,472,21.791320406278857,morphological_dilation,3,2
0X6C6ED89AB6CF2534.avi,53,1993,1573,420,26.70057215511761,morphological_dilation,3,2
0X6C6FE0CFFBEAD9C0.avi,83,1935,1540,395,25.649350649350648,morphological_dilation,3,2
0X6C6FE0CFFBEAD9C0.avi,102,1312,988,324,32.79352226720648,morphological_dilation,3,2
0X6C7593CD60599D1B.avi,57,1311,995,316,31.758793969849247,morphological_dilation,3,2
0X6C7593CD60599D1B.avi,72,807,551,256,46.46098003629764,morphological_dilation,3,2
0X6C78731607FD7813.avi,31,1810,1438,372,25.869262865090402,morphological_dilation,3,2
0X6C78731607FD7813.avi,46,1270,958,312,32.5678496868476,morphological_dilation,3,2
0X6C7CDB2B104302C.avi,46,2020,1612,408,25.31017369727047,morphological_dilation,3,2
0X6C7CDB2B104302C.avi,64,1271,935,336,35.93582887700535,morphological_dilation,3,2
0X6C7E27C5175E011D.avi,2,2398,1926,472,24.5067497403946,morphological_dilation,3,2
0X6C7E27C5175E011D.avi,16,1390,998,392,39.278557114228455,morphological_dilation,3,2
0X6C7E4F3AAF2573E4.avi,48,1501,1149,352,30.63533507397737,morphological_dilation,3,2
0X6C7E4F3AAF2573E4.avi,66,1209,881,328,37.230419977298524,morphological_dilation,3,2
0X6C81D8D4564D664D.avi,43,1932,1544,388,25.129533678756477,morphological_dilation,3,2
0X6C81D8D4564D664D.avi,60,1713,1345,368,27.360594795539033,morphological_dilation,3,2
0X6C8252A775A3B208.avi,79,1364,1036,328,31.66023166023166,morphological_dilation,3,2
0X6C8252A775A3B208.avi,93,858,582,276,47.42268041237113,morphological_dilation,3,2
0X6C845B75CC6E143C.avi,78,1846,1439,407,28.28353022932592,morphological_dilation,3,2
0X6C845B75CC6E143C.avi,114,2312,1856,456,24.568965517241377,morphological_dilation,3,2
0X6C8542DC18BC5C98.avi,56,1693,1285,408,31.75097276264591,morphological_dilation,3,2
0X6C8542DC18BC5C98.avi,73,1403,1028,375,36.47859922178988,morphological_dilation,3,2
0X6C85931BDC207466.avi,2,1660,1300,360,27.692307692307693,morphological_dilation,3,2
0X6C85931BDC207466.avi,14,1021,733,288,39.2905866302865,morphological_dilation,3,2
0X6C86F862C0C2228F.avi,0,1796,1432,364,25.41899441340782,morphological_dilation,3,2
0X6C86F862C0C2228F.avi,13,1500,1172,328,27.986348122866893,morphological_dilation,3,2
0X6C8C6BC50274E94B.avi,37,1824,1440,384,26.666666666666668,morphological_dilation,3,2
0X6C8C6BC50274E94B.avi,51,1007,711,296,41.63150492264416,morphological_dilation,3,2
0X6C8CB4F82AF7B5A8.avi,45,1172,856,316,36.915887850467286,morphological_dilation,3,2
0X6C8CB4F82AF7B5A8.avi,59,829,565,264,46.72566371681416,morphological_dilation,3,2
0X6C8F08AB5C918755.avi,1,3027,2507,520,20.741922616673314,morphological_dilation,3,2
0X6C8F08AB5C918755.avi,17,1797,1366,431,31.551976573938507,morphological_dilation,3,2
0X6C8F8AAA4F2DE9D2.avi,48,2833,2345,488,20.810234541577824,morphological_dilation,3,2
0X6C8F8AAA4F2DE9D2.avi,65,2305,1853,452,24.392876416621696,morphological_dilation,3,2
0X6C8FB4DE38C55D2D.avi,35,1101,801,300,37.453183520599254,morphological_dilation,3,2
0X6C8FB4DE38C55D2D.avi,51,732,480,252,52.5,morphological_dilation,3,2
0X6C9061C7323ED87F.avi,48,1230,898,332,36.97104677060133,morphological_dilation,3,2
0X6C9061C7323ED87F.avi,68,778,506,272,53.75494071146245,morphological_dilation,3,2
0X6C907D7A293A0CA9.avi,61,1674,1314,360,27.397260273972602,morphological_dilation,3,2
0X6C907D7A293A0CA9.avi,75,1513,1173,340,28.985507246376812,morphological_dilation,3,2
0X6C932939993E9192.avi,70,1726,1362,364,26.725403817914835,morphological_dilation,3,2
0X6C932939993E9192.avi,92,1060,760,300,39.473684210526315,morphological_dilation,3,2
0X6C94E0DE1DEA337F.avi,146,2567,2067,500,24.189646831156264,morphological_dilation,3,2
0X6C94E0DE1DEA337F.avi,163,1821,1393,428,30.725053840631727,morphological_dilation,3,2
0X6C96589B41EBA3C5.avi,124,1722,1342,380,28.315946348733235,morphological_dilation,3,2
0X6C96589B41EBA3C5.avi,144,1341,993,348,35.04531722054381,morphological_dilation,3,2
0X6C96E0DD4D10C326.avi,38,1727,1359,368,27.078734363502576,morphological_dilation,3,2
0X6C96E0DD4D10C326.avi,56,968,672,296,44.047619047619044,morphological_dilation,3,2
0X6C99385E5A518B19.avi,75,1648,1264,384,30.37974683544304,morphological_dilation,3,2
0X6C99385E5A518B19.avi,91,967,667,300,44.97751124437781,morphological_dilation,3,2
0X6CA28B9E9EEFF603.avi,38,2813,2337,476,20.367993153615746,morphological_dilation,3,2
0X6CA28B9E9EEFF603.avi,57,2379,1935,444,22.945736434108525,morphological_dilation,3,2
0X6CA2B6C0070FF76.avi,91,1565,1197,368,30.743525480367584,morphological_dilation,3,2
0X6CA2B6C0070FF76.avi,112,1027,707,320,45.26166902404526,morphological_dilation,3,2
0X6CA4C778D83B252F.avi,48,1690,1322,368,27.83661119515885,morphological_dilation,3,2
0X6CA4C778D83B252F.avi,61,1209,897,312,34.78260869565217,morphological_dilation,3,2
0X6CA712DE9D936CB3.avi,72,2638,2146,492,22.92637465051258,morphological_dilation,3,2
0X6CA712DE9D936CB3.avi,88,1864,1448,416,28.7292817679558,morphological_dilation,3,2
0X6CA7BA30601E7B44.avi,142,2327,1876,451,24.040511727078894,morphological_dilation,3,2
0X6CA7BA30601E7B44.avi,158,1437,1069,368,34.42469597754911,morphological_dilation,3,2
0X6CABFFD99D718350.avi,85,1256,928,328,35.3448275862069,morphological_dilation,3,2
0X6CABFFD99D718350.avi,99,841,569,272,47.803163444639715,morphological_dilation,3,2
0X6CAC8D1727509CDC.avi,158,1715,1343,372,27.699180938198065,morphological_dilation,3,2
0X6CAC8D1727509CDC.avi,175,1249,933,316,33.86923901393355,morphological_dilation,3,2
0X6CAFD90BF9854990.avi,91,1472,1116,356,31.899641577060933,morphological_dilation,3,2
0X6CAFD90BF9854990.avi,103,824,552,272,49.275362318840585,morphological_dilation,3,2
0X6CB652160FFC36B7.avi,137,2028,1632,396,24.264705882352942,morphological_dilation,3,2
0X6CB652160FFC36B7.avi,152,1477,1129,348,30.823737821080606,morphological_dilation,3,2
0X6CB6C78C1078D1A2.avi,39,3194,2682,512,19.09023117076808,morphological_dilation,3,2
0X6CB6C78C1078D1A2.avi,59,1965,1549,416,26.85603615235636,morphological_dilation,3,2
0X6CB8A5B0526602.avi,46,1586,1230,356,28.943089430894307,morphological_dilation,3,2
0X6CB8A5B0526602.avi,63,1035,743,292,39.300134589502015,morphological_dilation,3,2
0X6CBEFE70A7A9BBF9.avi,4,2654,2178,476,21.85491276400367,morphological_dilation,3,2
0X6CBEFE70A7A9BBF9.avi,13,2091,1671,420,25.134649910233392,morphological_dilation,3,2
0X6CC0AFACCC801E35.avi,87,3288,2833,455,16.06071302506177,morphological_dilation,3,2
0X6CC0AFACCC801E35.avi,104,2999,2567,432,16.82898324892871,morphological_dilation,3,2
0X6CC0DF8BF6E553D8.avi,36,2568,2112,456,21.59090909090909,morphological_dilation,3,2
0X6CC0DF8BF6E553D8.avi,51,1597,1209,388,32.09263854425144,morphological_dilation,3,2
0X6CC547A27A1CBE03.avi,39,1650,1260,390,30.952380952380953,morphological_dilation,3,2
0X6CC547A27A1CBE03.avi,53,910,609,301,49.42528735632184,morphological_dilation,3,2
0X6CC8195E8ADDBFE1.avi,95,1616,1252,364,29.073482428115017,morphological_dilation,3,2
0X6CC8195E8ADDBFE1.avi,110,1031,735,296,40.27210884353741,morphological_dilation,3,2
0X6CCA2353460A1836.avi,46,1695,1313,382,29.09367859862909,morphological_dilation,3,2
0X6CCA2353460A1836.avi,69,1133,817,316,38.6780905752754,morphological_dilation,3,2
0X6CCFED529BAD08F8.avi,44,1543,1191,352,29.554995801847188,morphological_dilation,3,2
0X6CCFED529BAD08F8.avi,58,982,694,288,41.4985590778098,morphological_dilation,3,2
0X6CD095A9ED1F1D82.avi,54,1499,1135,364,32.0704845814978,morphological_dilation,3,2
0X6CD095A9ED1F1D82.avi,64,987,659,328,49.77238239757208,morphological_dilation,3,2
0X6CD225131815C9B3.avi,87,1896,1492,404,27.07774798927614,morphological_dilation,3,2
0X6CD225131815C9B3.avi,106,1291,971,320,32.9557157569516,morphological_dilation,3,2
0X6CD440699E013143.avi,70,3317,2797,520,18.591347872720775,morphological_dilation,3,2
0X6CD440699E013143.avi,86,2271,1819,452,24.848818031885653,morphological_dilation,3,2
0X6CDF31281C0E6994.avi,118,1550,1194,356,29.81574539363484,morphological_dilation,3,2
0X6CDF31281C0E6994.avi,130,1184,856,328,38.31775700934579,morphological_dilation,3,2
0X6CE3898CCC0AAC59.avi,82,2455,2019,436,21.594848935116396,morphological_dilation,3,2
0X6CE3898CCC0AAC59.avi,100,1542,1202,340,28.286189683860236,morphological_dilation,3,2
0X6CE8ED382B1D0373.avi,44,2024,1620,404,24.938271604938272,morphological_dilation,3,2
0X6CE8ED382B1D0373.avi,58,1117,817,300,36.71970624235006,morphological_dilation,3,2
0X6CEBD0FFB29FC4FF.avi,87,1783,1395,388,27.813620071684586,morphological_dilation,3,2
0X6CEBD0FFB29FC4FF.avi,108,1059,714,345,48.319327731092436,morphological_dilation,3,2
0X6CECFF524B3C750F.avi,2,3418,2898,520,17.943409247757074,morphological_dilation,3,2
0X6CECFF524B3C750F.avi,19,2431,1991,440,22.099447513812155,morphological_dilation,3,2
0X6CEF1BA255C5E6F3.avi,49,2186,1742,444,25.487944890929963,morphological_dilation,3,2
0X6CEF1BA255C5E6F3.avi,65,1415,1039,376,36.18864292589028,morphological_dilation,3,2
0X6CF243481B013517.avi,87,2614,2174,440,20.239190432382706,morphological_dilation,3,2
0X6CF243481B013517.avi,102,2194,1786,408,22.84434490481523,morphological_dilation,3,2
0X6CF68B1A2BD187CC.avi,117,2381,1949,432,22.165212929707543,morphological_dilation,3,2
0X6CF68B1A2BD187CC.avi,131,1284,968,316,32.64462809917356,morphological_dilation,3,2
0X6CF8F05F9BED6F35.avi,58,1887,1499,388,25.883922615076717,morphological_dilation,3,2
0X6CF8F05F9BED6F35.avi,80,1256,924,332,35.93073593073593,morphological_dilation,3,2
0X6CFA2353220A32C3.avi,52,1607,1239,368,29.701372074253428,morphological_dilation,3,2
0X6CFA2353220A32C3.avi,68,1038,730,308,42.19178082191781,morphological_dilation,3,2
0X6D0315D05748849F.avi,160,1686,1330,356,26.766917293233085,morphological_dilation,3,2
0X6D0315D05748849F.avi,177,1101,805,296,36.77018633540373,morphological_dilation,3,2
0X6D06CFF7DED256F.avi,48,2122,1686,436,25.86002372479241,morphological_dilation,3,2
0X6D06CFF7DED256F.avi,67,1825,1429,396,27.711686494051786,morphological_dilation,3,2
0X6D07CDCEA188473E.avi,36,2350,1886,464,24.60233297985154,morphological_dilation,3,2
0X6D07CDCEA188473E.avi,50,1573,1181,392,33.1922099915326,morphological_dilation,3,2
0X6D0CFFC3949FBFD4.avi,3,1317,949,368,38.77766069546891,morphological_dilation,3,2
0X6D0CFFC3949FBFD4.avi,17,895,579,316,54.57685664939551,morphological_dilation,3,2
0X6D0D293319783A87.avi,140,1695,1299,396,30.484988452655887,morphological_dilation,3,2
0X6D0D293319783A87.avi,152,1012,688,324,47.093023255813954,morphological_dilation,3,2
0X6D1D0BE838BFC520.avi,30,1809,1429,380,26.592022393282015,morphological_dilation,3,2
0X6D1D0BE838BFC520.avi,42,1081,797,284,35.633626097867,morphological_dilation,3,2
0X6D1D29802905D6E0.avi,55,2362,1942,420,21.627188465499486,morphological_dilation,3,2
0X6D1D29802905D6E0.avi,71,1696,1328,368,27.710843373493976,morphological_dilation,3,2
0X6D218D2DC031979F.avi,120,3126,2618,508,19.404125286478227,morphological_dilation,3,2
0X6D218D2DC031979F.avi,153,1874,1462,412,28.18057455540356,morphological_dilation,3,2
0X6D239F747F460F.avi,45,3589,3073,516,16.79140904653433,morphological_dilation,3,2
0X6D239F747F460F.avi,65,3077,2605,472,18.119001919385795,morphological_dilation,3,2
0X6D3A000B61658ABB.avi,52,2574,2082,492,23.631123919308358,morphological_dilation,3,2
0X6D3A000B61658ABB.avi,68,1471,1091,380,34.83043079743355,morphological_dilation,3,2
0X6D3B3F63E5A98B19.avi,28,3060,2560,500,19.53125,morphological_dilation,3,2
0X6D3B3F63E5A98B19.avi,44,2769,2293,476,20.758831225468818,morphological_dilation,3,2
0X6D3D61BF45F96B11.avi,62,1226,902,324,35.92017738359202,morphological_dilation,3,2
0X6D3D61BF45F96B11.avi,80,866,561,305,54.367201426024955,morphological_dilation,3,2
0X6D3DA909443B39FF.avi,2,1817,1429,388,27.1518544436669,morphological_dilation,3,2
0X6D3DA909443B39FF.avi,17,1148,828,320,38.64734299516908,morphological_dilation,3,2
0X6D48137E0CF883E3.avi,42,2685,2217,468,21.10960757780785,morphological_dilation,3,2
0X6D48137E0CF883E3.avi,57,2312,1884,428,22.717622080679405,morphological_dilation,3,2
0X6D48C70F773FD316.avi,2,2367,1923,444,23.08892355694228,morphological_dilation,3,2
0X6D48C70F773FD316.avi,22,1734,1330,404,30.37593984962406,morphological_dilation,3,2
0X6D49B9C90A557BF2.avi,58,2973,2469,504,20.413122721749698,morphological_dilation,3,2
0X6D49B9C90A557BF2.avi,80,2170,1730,440,25.43352601156069,morphological_dilation,3,2
0X6D4A0B79F875979F.avi,68,1244,910,334,36.7032967032967,morphological_dilation,3,2
0X6D4A0B79F875979F.avi,87,769,446,323,72.42152466367713,morphological_dilation,3,2
0X6D4A77DC8CD88E9A.avi,83,1721,1357,364,26.823876197494474,morphological_dilation,3,2
0X6D4A77DC8CD88E9A.avi,100,1424,1096,328,29.927007299270077,morphological_dilation,3,2
0X6D4AB086ADFF664B.avi,92,1845,1441,404,28.036086051353227,morphological_dilation,3,2
0X6D4AB086ADFF664B.avi,114,1321,960,361,37.604166666666664,morphological_dilation,3,2
0X6D4AE6195D85472B.avi,40,2424,1984,440,22.177419354838708,morphological_dilation,3,2
0X6D4AE6195D85472B.avi,54,1936,1536,400,26.041666666666668,morphological_dilation,3,2
0X6D4E2F9ACA8A1563.avi,46,1669,1269,400,31.520882584712375,morphological_dilation,3,2
0X6D4E2F9ACA8A1563.avi,59,1047,727,320,44.01650618982118,morphological_dilation,3,2
0X6D53A880A0B92B8D.avi,114,1597,1245,352,28.273092369477908,morphological_dilation,3,2
0X6D53A880A0B92B8D.avi,131,889,617,272,44.08427876823339,morphological_dilation,3,2
0X6D53B5EAD55FAE88.avi,34,1593,1229,364,29.617575264442635,morphological_dilation,3,2
0X6D53B5EAD55FAE88.avi,47,1060,748,312,41.711229946524064,morphological_dilation,3,2
0X6D53E8439BFC46D9.avi,68,1328,1004,324,32.27091633466135,morphological_dilation,3,2
0X6D53E8439BFC46D9.avi,83,869,593,276,46.54300168634064,morphological_dilation,3,2
0X6D55B39BC5165D15.avi,103,2218,1794,424,23.634336677814936,morphological_dilation,3,2
0X6D55B39BC5165D15.avi,125,1304,972,332,34.15637860082305,morphological_dilation,3,2
0X6D55F9F3E6A2707A.avi,58,1442,1086,356,32.78084714548803,morphological_dilation,3,2
0X6D55F9F3E6A2707A.avi,77,926,622,304,48.87459807073955,morphological_dilation,3,2
0X6D5701FED374216.avi,33,995,613,382,62.31647634584013,morphological_dilation,3,2
0X6D5701FED374216.avi,47,640,309,331,107.11974110032362,morphological_dilation,3,2
0X6D58693714718A15.avi,78,1552,1196,356,29.76588628762542,morphological_dilation,3,2
0X6D58693714718A15.avi,94,1184,860,324,37.67441860465116,morphological_dilation,3,2
0X6D600D764AD2D7A9.avi,48,2078,1682,396,23.543400713436384,morphological_dilation,3,2
0X6D600D764AD2D7A9.avi,68,1612,1256,356,28.343949044585987,morphological_dilation,3,2
0X6D606F9D4AEC7257.avi,58,1783,1403,380,27.084818246614397,morphological_dilation,3,2
0X6D606F9D4AEC7257.avi,73,1174,870,304,34.94252873563218,morphological_dilation,3,2
0X6D6388FC639CDA09.avi,82,2211,1799,412,22.901612006670373,morphological_dilation,3,2
0X6D6388FC639CDA09.avi,96,1362,1026,336,32.748538011695906,morphological_dilation,3,2
0X6D63B455802BB05F.avi,92,1783,1375,408,29.672727272727272,morphological_dilation,3,2
0X6D63B455802BB05F.avi,112,1236,892,344,38.56502242152467,morphological_dilation,3,2
0X6D643C5F5E40EF68.avi,38,1235,927,308,33.22545846817692,morphological_dilation,3,2
0X6D643C5F5E40EF68.avi,49,957,681,276,40.52863436123348,morphological_dilation,3,2
0X6D65F149D5EB3913.avi,81,1434,1086,348,32.04419889502763,morphological_dilation,3,2
0X6D65F149D5EB3913.avi,98,928,649,279,42.98921417565486,morphological_dilation,3,2
0X6D691277EEE275F2.avi,89,1533,1181,352,29.805249788314985,morphological_dilation,3,2
0X6D691277EEE275F2.avi,103,1021,717,304,42.398884239888424,morphological_dilation,3,2
0X6D6B651AC1031C7.avi,36,2141,1718,423,24.621653084982537,morphological_dilation,3,2
0X6D6B651AC1031C7.avi,49,1872,1480,392,26.486486486486488,morphological_dilation,3,2
0X6D6BF76192EEFF36.avi,40,1620,1232,388,31.493506493506494,morphological_dilation,3,2
0X6D6BF76192EEFF36.avi,60,1124,792,332,41.91919191919192,morphological_dilation,3,2
0X6D6FFE8C3D708E08.avi,47,1827,1435,392,27.31707317073171,morphological_dilation,3,2
0X6D6FFE8C3D708E08.avi,63,1063,754,309,40.9814323607427,morphological_dilation,3,2
0X6D71DFFA4EE9C227.avi,4,2506,2038,468,22.963689892051033,morphological_dilation,3,2
0X6D71DFFA4EE9C227.avi,22,1620,1217,403,33.11421528348398,morphological_dilation,3,2
0X6D72498C03D60D6B.avi,114,1854,1426,428,30.014025245441793,morphological_dilation,3,2
0X6D72498C03D60D6B.avi,130,1230,862,368,42.69141531322506,morphological_dilation,3,2
0X6D726D55FBF7CACD.avi,100,3516,2948,568,19.26729986431479,morphological_dilation,3,2
0X6D726D55FBF7CACD.avi,118,1952,1450,502,34.62068965517241,morphological_dilation,3,2
0X6D72FA2CA90F4C15.avi,59,1823,1411,412,29.199149539333806,morphological_dilation,3,2
0X6D72FA2CA90F4C15.avi,76,1131,779,352,45.186136071887034,morphological_dilation,3,2
0X6D74371D1009C455.avi,33,1637,1273,364,28.59387274155538,morphological_dilation,3,2
0X6D74371D1009C455.avi,48,1301,949,352,37.09167544783983,morphological_dilation,3,2
0X6D7766F51CCDE3D7.avi,53,2141,1729,412,23.828802776171198,morphological_dilation,3,2
0X6D7766F51CCDE3D7.avi,72,1329,1001,328,32.76723276723277,morphological_dilation,3,2
0X6D7889E5615FCFD4.avi,98,1400,1064,336,31.57894736842105,morphological_dilation,3,2
0X6D7889E5615FCFD4.avi,111,851,571,280,49.036777583187394,morphological_dilation,3,2
0X6D78CCCD9680F137.avi,67,2443,1975,468,23.696202531645568,morphological_dilation,3,2
0X6D78CCCD9680F137.avi,85,1378,1022,356,34.833659491193735,morphological_dilation,3,2
0X6D7DDE6E9744DAC6.avi,85,1349,1005,344,34.22885572139304,morphological_dilation,3,2
0X6D7DDE6E9744DAC6.avi,105,809,525,284,54.095238095238095,morphological_dilation,3,2
0X6D81C99AA35EEE47.avi,135,1825,1437,388,27.00069589422408,morphological_dilation,3,2
0X6D81C99AA35EEE47.avi,151,1161,845,316,37.39644970414201,morphological_dilation,3,2
0X6D821F822F67B02A.avi,102,2150,1718,432,25.145518044237487,morphological_dilation,3,2
0X6D821F822F67B02A.avi,118,1270,926,344,37.14902807775378,morphological_dilation,3,2
0X6D872CF7C744613E.avi,54,1404,1084,320,29.520295202952028,morphological_dilation,3,2
0X6D872CF7C744613E.avi,76,1180,888,292,32.88288288288289,morphological_dilation,3,2
0X6D8C2E4FF14F1B01.avi,59,1049,735,314,42.72108843537415,morphological_dilation,3,2
0X6D8C2E4FF14F1B01.avi,69,750,487,263,54.00410677618069,morphological_dilation,3,2
0X6D8D7994A2AC5FCE.avi,120,1365,1017,348,34.21828908554572,morphological_dilation,3,2
0X6D8D7994A2AC5FCE.avi,133,807,535,272,50.8411214953271,morphological_dilation,3,2
0X6D90906933A86358.avi,86,2355,1907,448,23.49239643418983,morphological_dilation,3,2
0X6D90906933A86358.avi,99,1348,996,352,35.34136546184739,morphological_dilation,3,2
0X6D90FEC0CDD49DC4.avi,43,2231,1811,420,23.191606847045833,morphological_dilation,3,2
0X6D90FEC0CDD49DC4.avi,59,1563,1223,340,27.800490596892885,morphological_dilation,3,2
0X6D917AB5FBFE3EDE.avi,54,1826,1426,400,28.050490883590463,morphological_dilation,3,2
0X6D917AB5FBFE3EDE.avi,65,1068,740,328,44.32432432432433,morphological_dilation,3,2
0X6D92F22E42697C65.avi,118,3284,2756,528,19.15820029027576,morphological_dilation,3,2
0X6D92F22E42697C65.avi,137,3328,2463,865,35.11977263499797,morphological_dilation,3,2
0X6D95CD13FD8931F2.avi,43,2634,2150,484,22.511627906976745,morphological_dilation,3,2
0X6D95CD13FD8931F2.avi,58,1606,1218,388,31.85550082101806,morphological_dilation,3,2
0X6D9723FC15CFEE85.avi,153,1629,1249,380,30.424339471577262,morphological_dilation,3,2
0X6D9723FC15CFEE85.avi,167,1390,1017,373,36.67649950835792,morphological_dilation,3,2
0X6D9E057CAE4BC5E0.avi,44,1466,1110,356,32.072072072072075,morphological_dilation,3,2
0X6D9E057CAE4BC5E0.avi,57,947,651,296,45.46850998463901,morphological_dilation,3,2
0X6D9E5AB91D96CCE1.avi,3,3229,2673,556,20.800598578376356,morphological_dilation,3,2
0X6D9E5AB91D96CCE1.avi,18,1877,1421,456,32.09007741027445,morphological_dilation,3,2
0X6DA50442706CA23D.avi,53,1878,1482,396,26.720647773279353,morphological_dilation,3,2
0X6DA50442706CA23D.avi,70,1511,1147,364,31.734960767218833,morphological_dilation,3,2
0X6DA6BCE4A78DB2FE.avi,100,1682,1306,376,28.79019908116386,morphological_dilation,3,2
0X6DA6BCE4A78DB2FE.avi,118,1489,1145,344,30.043668122270745,morphological_dilation,3,2
0X6DA6FDFFA83994BB.avi,143,1487,1151,336,29.192006950477843,morphological_dilation,3,2
0X6DA6FDFFA83994BB.avi,163,956,676,280,41.42011834319527,morphological_dilation,3,2
0X6DA7A894DA307F59.avi,97,2038,1618,420,25.95797280593325,morphological_dilation,3,2
0X6DA7A894DA307F59.avi,122,1230,878,352,40.091116173120724,morphological_dilation,3,2
0X6DB14C93EAECA9A7.avi,46,1414,1074,340,31.65735567970205,morphological_dilation,3,2
0X6DB14C93EAECA9A7.avi,64,813,531,282,53.10734463276836,morphological_dilation,3,2
0X6DB22253FD5BBF94.avi,34,1005,705,300,42.5531914893617,morphological_dilation,3,2
0X6DB22253FD5BBF94.avi,50,655,385,270,70.12987012987013,morphological_dilation,3,2
0X6DB3B5B497DB6EA0.avi,113,2583,2103,480,22.82453637660485,morphological_dilation,3,2
0X6DB3B5B497DB6EA0.avi,129,1501,1129,372,32.94951284322409,morphological_dilation,3,2
0X6DB4F287069B038D.avi,50,2303,1867,436,23.352972683449384,morphological_dilation,3,2
0X6DB4F287069B038D.avi,70,1846,1450,396,27.310344827586206,morphological_dilation,3,2
0X6DB563A9A177BD82.avi,76,1311,983,328,33.36724313326551,morphological_dilation,3,2
0X6DB563A9A177BD82.avi,98,935,643,292,45.41213063763608,morphological_dilation,3,2
0X6DB58A74F7F0CBDB.avi,110,1955,1547,408,26.373626373626376,morphological_dilation,3,2
0X6DB58A74F7F0CBDB.avi,130,1235,883,352,39.86409966024915,morphological_dilation,3,2
0X6DB5BC6BF960267F.avi,191,1415,1043,372,35.66634707574305,morphological_dilation,3,2
0X6DB5BC6BF960267F.avi,203,947,623,324,52.00642054574639,morphological_dilation,3,2
0X6DB94B6B809039C7.avi,105,2615,2143,472,22.025198320111993,morphological_dilation,3,2
0X6DB94B6B809039C7.avi,118,1629,1245,384,30.843373493975907,morphological_dilation,3,2
0X6DBC9C8C7CCBE6E2.avi,100,2765,2289,476,20.795107033639145,morphological_dilation,3,2
0X6DBC9C8C7CCBE6E2.avi,120,2234,1806,428,23.69878183831672,morphological_dilation,3,2
0X6DC13ED618770C6B.avi,2,1564,1216,348,28.618421052631575,morphological_dilation,3,2
0X6DC13ED618770C6B.avi,19,1010,710,300,42.25352112676056,morphological_dilation,3,2
0X6DC399F2BCE4AB7D.avi,39,1536,1164,372,31.958762886597935,morphological_dilation,3,2
0X6DC399F2BCE4AB7D.avi,57,994,698,296,42.40687679083094,morphological_dilation,3,2
0X6DC4325C689CEEDD.avi,22,1271,927,344,37.108953613807984,morphological_dilation,3,2
0X6DC4325C689CEEDD.avi,42,2099,1667,432,25.91481703659268,morphological_dilation,3,2
0X6DC4D4E665CE25B2.avi,86,793,549,244,44.44444444444444,morphological_dilation,3,2
0X6DC4D4E665CE25B2.avi,99,585,369,216,58.536585365853654,morphological_dilation,3,2
0X6DC72E2A34A6DFE8.avi,122,2495,2027,468,23.088307844104587,morphological_dilation,3,2
0X6DC72E2A34A6DFE8.avi,141,1400,1032,368,35.65891472868217,morphological_dilation,3,2
0X6DCAB3CD5A485D45.avi,37,1965,1542,423,27.431906614785994,morphological_dilation,3,2
0X6DCAB3CD5A485D45.avi,54,1353,934,419,44.860813704496785,morphological_dilation,3,2
0X6DD554CE5A1AE1B0.avi,101,2141,1713,428,24.985405720957385,morphological_dilation,3,2
0X6DD554CE5A1AE1B0.avi,121,1495,1123,372,33.12555654496883,morphological_dilation,3,2
0X6DD62111845E1B9.avi,39,1613,1241,372,29.975825946817082,morphological_dilation,3,2
0X6DD62111845E1B9.avi,57,1049,745,304,40.80536912751678,morphological_dilation,3,2
0X6DDC0986DF75DB0C.avi,90,1291,967,324,33.50568769389866,morphological_dilation,3,2
0X6DDC0986DF75DB0C.avi,110,899,611,288,47.13584288052373,morphological_dilation,3,2
0X6DDD5B0B4132C787.avi,50,2788,2308,480,20.797227036395146,morphological_dilation,3,2
0X6DDD5B0B4132C787.avi,68,1893,1497,396,26.452905811623246,morphological_dilation,3,2
0X6DE38BD6E3584D03.avi,44,1519,1175,344,29.27659574468085,morphological_dilation,3,2
0X6DE38BD6E3584D03.avi,57,1015,727,288,39.61485557083906,morphological_dilation,3,2
0X6DE5DB58AD2E5577.avi,106,1951,1523,428,28.10242941562705,morphological_dilation,3,2
0X6DE5DB58AD2E5577.avi,125,1258,906,352,38.852097130242825,morphological_dilation,3,2
0X6DE7AC1795267BA3.avi,42,1817,1425,392,27.50877192982456,morphological_dilation,3,2
0X6DE7AC1795267BA3.avi,60,1288,940,348,37.02127659574468,morphological_dilation,3,2
0X6DEB4032EBB054D9.avi,75,2883,2375,508,21.38947368421053,morphological_dilation,3,2
0X6DEB4032EBB054D9.avi,96,2060,1621,439,27.082048118445407,morphological_dilation,3,2
0X6DED7FDA8466BE6E.avi,94,1349,1013,336,33.16880552813426,morphological_dilation,3,2
0X6DED7FDA8466BE6E.avi,110,891,615,276,44.87804878048781,morphological_dilation,3,2
0X6DEDE4AA3CB872F1.avi,3,2141,1701,440,25.86713697824809,morphological_dilation,3,2
0X6DEDE4AA3CB872F1.avi,20,1415,1039,376,36.18864292589028,morphological_dilation,3,2
0X6DF0EE20A24FEF6A.avi,2,1164,856,308,35.981308411214954,morphological_dilation,3,2
0X6DF0EE20A24FEF6A.avi,19,907,643,264,41.05754276827372,morphological_dilation,3,2
0X6DF39A52E4048FF2.avi,85,1757,1377,380,27.596223674655047,morphological_dilation,3,2
0X6DF39A52E4048FF2.avi,96,1153,833,320,38.41536614645859,morphological_dilation,3,2
0X6DF8E050FC840A8.avi,89,1646,1242,404,32.52818035426731,morphological_dilation,3,2
0X6DF8E050FC840A8.avi,106,1183,835,348,41.67664670658683,morphological_dilation,3,2
0X6DFE8F195ACC3BA4.avi,100,2159,1743,416,23.866896156052782,morphological_dilation,3,2
0X6DFE8F195ACC3BA4.avi,118,1747,1371,376,27.425237053245805,morphological_dilation,3,2
0X6E00BE74552DB3BA.avi,173,1349,1001,348,34.765234765234766,morphological_dilation,3,2
0X6E00BE74552DB3BA.avi,193,888,604,284,47.019867549668874,morphological_dilation,3,2
0X6E00FB047E13A652.avi,139,1638,1266,372,29.383886255924168,morphological_dilation,3,2
0X6E00FB047E13A652.avi,159,975,667,308,46.17691154422789,morphological_dilation,3,2
0X6E02E0F24F63EFD7.avi,64,632,381,251,65.87926509186352,morphological_dilation,3,2
0X6E02E0F24F63EFD7.avi,121,1230,842,388,46.080760095011875,morphological_dilation,3,2
0X6E0708618C053CB8.avi,43,1111,803,308,38.35616438356164,morphological_dilation,3,2
0X6E0708618C053CB8.avi,60,675,431,244,56.61252900232019,morphological_dilation,3,2
0X6E0E4A558108BADA.avi,83,1686,1299,387,29.79214780600462,morphological_dilation,3,2
0X6E0E4A558108BADA.avi,96,1030,710,320,45.07042253521127,morphological_dilation,3,2
0X6E100C2D4D73F059.avi,38,3698,3166,532,16.803537586860394,morphological_dilation,3,2
0X6E100C2D4D73F059.avi,50,2355,1919,436,22.720166753517457,morphological_dilation,3,2
0X6E1145D1BA43B81F.avi,43,1852,1469,383,26.07215793056501,morphological_dilation,3,2
0X6E1145D1BA43B81F.avi,59,1178,858,320,37.2960372960373,morphological_dilation,3,2
0X6E12C7DFC47BCD1E.avi,42,1544,1204,340,28.23920265780731,morphological_dilation,3,2
0X6E12C7DFC47BCD1E.avi,54,928,656,272,41.46341463414634,morphological_dilation,3,2
0X6E1AB156B897F2B0.avi,101,1434,1102,332,30.127041742286753,morphological_dilation,3,2
0X6E1AB156B897F2B0.avi,117,954,670,284,42.38805970149254,morphological_dilation,3,2
0X6E1C89A39A9DA038.avi,101,1118,810,308,38.02469135802469,morphological_dilation,3,2
0X6E1C89A39A9DA038.avi,116,731,475,256,53.89473684210526,morphological_dilation,3,2
0X6E1F0B0B5831B801.avi,43,2310,1854,456,24.59546925566343,morphological_dilation,3,2
0X6E1F0B0B5831B801.avi,60,1599,1211,388,32.03963666391412,morphological_dilation,3,2
0X6E1F571E0D834439.avi,41,2021,1609,412,25.605966438781852,morphological_dilation,3,2
0X6E1F571E0D834439.avi,59,1302,940,362,38.51063829787234,morphological_dilation,3,2
0X6E1FF3606FD2148A.avi,110,2180,1748,432,24.71395881006865,morphological_dilation,3,2
0X6E1FF3606FD2148A.avi,128,1221,897,324,36.12040133779264,morphological_dilation,3,2
0X6E212B8A73CA04DD.avi,41,1444,1088,356,32.720588235294116,morphological_dilation,3,2
0X6E212B8A73CA04DD.avi,52,966,646,320,49.53560371517028,morphological_dilation,3,2
0X6E22CC57F5A62028.avi,142,1456,1118,338,30.23255813953488,morphological_dilation,3,2
0X6E22CC57F5A62028.avi,151,952,668,284,42.51497005988024,morphological_dilation,3,2
0X6E26C6F3CA75C699.avi,0,2399,1955,444,22.710997442455245,morphological_dilation,3,2
0X6E26C6F3CA75C699.avi,11,1627,1239,388,31.315577078288943,morphological_dilation,3,2
0X6E27B3EF3A104896.avi,45,2391,1947,444,22.80431432973806,morphological_dilation,3,2
0X6E27B3EF3A104896.avi,63,1781,1395,386,27.670250896057347,morphological_dilation,3,2
0X6E2E069FDC35F8FA.avi,60,2063,1631,432,26.486817903126912,morphological_dilation,3,2
0X6E2E069FDC35F8FA.avi,79,1205,865,340,39.30635838150289,morphological_dilation,3,2
0X6E2E13E4D12ADBC5.avi,45,1585,1201,384,31.973355537052456,morphological_dilation,3,2
0X6E2E13E4D12ADBC5.avi,63,979,664,315,47.43975903614458,morphological_dilation,3,2
0X6E309D9AB2B43C7E.avi,34,2102,1690,412,24.378698224852073,morphological_dilation,3,2
0X6E309D9AB2B43C7E.avi,51,1692,1320,372,28.18181818181818,morphological_dilation,3,2
0X6E372FE5021EB443.avi,89,1723,1331,392,29.451540195341845,morphological_dilation,3,2
0X6E372FE5021EB443.avi,101,1019,703,316,44.950213371266,morphological_dilation,3,2
0X6E379A4025B0D43C.avi,45,1852,1432,420,29.329608938547487,morphological_dilation,3,2
0X6E379A4025B0D43C.avi,57,1122,766,356,46.47519582245431,morphological_dilation,3,2
0X6E3FBD73AE2685F.avi,94,1555,1207,348,28.83181441590721,morphological_dilation,3,2
0X6E3FBD73AE2685F.avi,105,1047,755,292,38.675496688741724,morphological_dilation,3,2
0X6E4159BB40A86E64.avi,113,1191,855,336,39.29824561403509,morphological_dilation,3,2
0X6E4159BB40A86E64.avi,126,744,464,280,60.3448275862069,morphological_dilation,3,2
0X6E443F7042370B42.avi,33,1864,1480,384,25.945945945945947,morphological_dilation,3,2
0X6E443F7042370B42.avi,46,1173,849,324,38.16254416961131,morphological_dilation,3,2
0X6E46A32DFF7E9E62.avi,42,5361,4681,680,14.526810510574665,morphological_dilation,3,2
0X6E46A32DFF7E9E62.avi,57,2881,2330,551,23.6480686695279,morphological_dilation,3,2
0X6E48AED3DA25731A.avi,88,1429,1089,340,31.22130394857668,morphological_dilation,3,2
0X6E48AED3DA25731A.avi,104,897,611,286,46.808510638297875,morphological_dilation,3,2
0X6E4B03FAE5E345CA.avi,86,2347,1887,460,24.377318494965554,morphological_dilation,3,2
0X6E4B03FAE5E345CA.avi,111,1464,1088,376,34.55882352941176,morphological_dilation,3,2
0X6E4CCA9792ADED75.avi,67,1849,1457,392,26.90459849004804,morphological_dilation,3,2
0X6E4CCA9792ADED75.avi,79,1171,855,316,36.95906432748538,morphological_dilation,3,2
0X6E4EB029042DD9D9.avi,163,2757,2228,529,23.74326750448833,morphological_dilation,3,2
0X6E4EB029042DD9D9.avi,187,1858,1416,442,31.21468926553672,morphological_dilation,3,2
0X6E54EDA664E18F4A.avi,36,1409,1069,340,31.805425631431245,morphological_dilation,3,2
0X6E54EDA664E18F4A.avi,53,851,579,272,46.97754749568221,morphological_dilation,3,2
0X6E57B3FDE0D9C92.avi,73,1762,1358,404,29.749631811487482,morphological_dilation,3,2
0X6E57B3FDE0D9C92.avi,91,1402,1050,352,33.523809523809526,morphological_dilation,3,2
0X6E5824E76BEB3ECA.avi,16,1380,1028,352,34.24124513618677,morphological_dilation,3,2
0X6E5824E76BEB3ECA.avi,78,2149,1607,542,33.727442439327945,morphological_dilation,3,2
0X6E58C38FE9BC5E5E.avi,76,1393,1061,332,31.291234684260132,morphological_dilation,3,2
0X6E58C38FE9BC5E5E.avi,88,977,697,280,40.17216642754663,morphological_dilation,3,2
0X6E59D3D82A2E3357.avi,44,1657,1277,380,29.757243539545808,morphological_dilation,3,2
0X6E59D3D82A2E3357.avi,61,1111,775,336,43.354838709677416,morphological_dilation,3,2
0X6E5C224987C8E830.avi,51,2024,1616,408,25.247524752475247,morphological_dilation,3,2
0X6E5C224987C8E830.avi,67,1229,901,328,36.40399556048835,morphological_dilation,3,2
0X6E5CF1D1178DF20B.avi,73,1555,1215,340,27.983539094650205,morphological_dilation,3,2
0X6E5CF1D1178DF20B.avi,84,898,626,272,43.45047923322684,morphological_dilation,3,2
0X6E5FD447C07DFA5.avi,42,1528,1176,352,29.931972789115648,morphological_dilation,3,2
0X6E5FD447C07DFA5.avi,58,950,658,292,44.37689969604863,morphological_dilation,3,2
0X6E6024E7AF5E6B15.avi,115,1300,968,332,34.29752066115703,morphological_dilation,3,2
0X6E6024E7AF5E6B15.avi,125,1040,724,316,43.646408839779006,morphological_dilation,3,2
0X6E60A779DF3494E3.avi,67,1713,1338,375,28.02690582959641,morphological_dilation,3,2
0X6E60A779DF3494E3.avi,86,1236,924,312,33.76623376623377,morphological_dilation,3,2
0X6E6108E3D0E8983C.avi,111,1818,1410,408,28.936170212765955,morphological_dilation,3,2
0X6E6108E3D0E8983C.avi,130,1089,761,328,43.1011826544021,morphological_dilation,3,2
0X6E63D1AE66B1DFF4.avi,69,2026,1634,392,23.990208078335375,morphological_dilation,3,2
0X6E63D1AE66B1DFF4.avi,86,1131,835,296,35.449101796407184,morphological_dilation,3,2
0X6E6B700BBFFFD2D6.avi,51,2312,1853,459,24.770642201834864,morphological_dilation,3,2
0X6E6B700BBFFFD2D6.avi,68,1304,960,344,35.833333333333336,morphological_dilation,3,2
0X6E6C739C44829062.avi,39,1489,1137,352,30.958663148636763,morphological_dilation,3,2
0X6E6C739C44829062.avi,53,1196,868,328,37.78801843317972,morphological_dilation,3,2
0X6E6C9C85DEA40694.avi,46,1803,1403,400,28.51033499643621,morphological_dilation,3,2
0X6E6C9C85DEA40694.avi,62,1025,721,304,42.163661581137305,morphological_dilation,3,2
0X6E6FB1DA53C8351.avi,4,1501,1153,348,30.18213356461405,morphological_dilation,3,2
0X6E6FB1DA53C8351.avi,19,960,654,306,46.788990825688074,morphological_dilation,3,2
0X6E7132ABF64DB8BE.avi,95,1470,1122,348,31.016042780748666,morphological_dilation,3,2
0X6E7132ABF64DB8BE.avi,114,1020,716,304,42.45810055865922,morphological_dilation,3,2
0X6E765BA3B1865957.avi,55,2206,1762,444,25.198637911464246,morphological_dilation,3,2
0X6E765BA3B1865957.avi,74,1311,955,356,37.27748691099477,morphological_dilation,3,2
0X6E7E20A098A0C7A2.avi,47,1955,1575,380,24.126984126984127,morphological_dilation,3,2
0X6E7E20A098A0C7A2.avi,63,1160,860,300,34.883720930232556,morphological_dilation,3,2
0X6E8033C53E37D4D0.avi,103,1886,1482,404,27.26045883940621,morphological_dilation,3,2
0X6E8033C53E37D4D0.avi,120,1123,797,326,40.903387703889585,morphological_dilation,3,2
0X6E811944559EDC3F.avi,72,1348,1016,332,32.677165354330704,morphological_dilation,3,2
0X6E811944559EDC3F.avi,93,1014,718,296,41.22562674094708,morphological_dilation,3,2
0X6E88964C832AB9E4.avi,106,2490,2022,468,23.14540059347181,morphological_dilation,3,2
0X6E88964C832AB9E4.avi,122,2043,1605,438,27.289719626168225,morphological_dilation,3,2
0X6E9C31795E54A821.avi,66,2669,2213,456,20.60551287844555,morphological_dilation,3,2
0X6E9C31795E54A821.avi,84,1735,1351,384,28.423390081421168,morphological_dilation,3,2
0X6E9F4870B113C2C6.avi,0,1646,1282,364,28.39313572542902,morphological_dilation,3,2
0X6E9F4870B113C2C6.avi,16,1124,820,304,37.073170731707314,morphological_dilation,3,2
0X6E9F5C6EB262E26A.avi,34,1183,874,309,35.35469107551488,morphological_dilation,3,2
0X6E9F5C6EB262E26A.avi,50,1035,731,304,41.58686730506156,morphological_dilation,3,2
0X6EA93533C06E1E1B.avi,33,2774,2290,484,21.1353711790393,morphological_dilation,3,2
0X6EA93533C06E1E1B.avi,46,1506,1134,372,32.804232804232804,morphological_dilation,3,2
0X6EA93E2EBB466F3A.avi,45,2016,1608,408,25.37313432835821,morphological_dilation,3,2
0X6EA93E2EBB466F3A.avi,60,1253,905,348,38.453038674033145,morphological_dilation,3,2
0X6EA9E49ABF8EFEE1.avi,42,2179,1744,435,24.942660550458715,morphological_dilation,3,2
0X6EA9E49ABF8EFEE1.avi,59,1762,1366,396,28.989751098096633,morphological_dilation,3,2
0X6EAED583DBF1F916.avi,45,1058,757,301,39.76221928665786,morphological_dilation,3,2
0X6EAED583DBF1F916.avi,61,796,528,268,50.75757575757576,morphological_dilation,3,2
0X6EB436F0D1B7CE84.avi,5,2025,1633,392,24.004898958971218,morphological_dilation,3,2
0X6EB436F0D1B7CE84.avi,27,1612,1264,348,27.531645569620256,morphological_dilation,3,2
0X6EB95ADCC03B7B3C.avi,100,2173,1757,416,23.67672168468981,morphological_dilation,3,2
0X6EB95ADCC03B7B3C.avi,121,1308,964,344,35.684647302904565,morphological_dilation,3,2
0X6EBA417515E62FD5.avi,84,1738,1358,380,27.982326951399116,morphological_dilation,3,2
0X6EBA417515E62FD5.avi,98,981,685,296,43.21167883211679,morphological_dilation,3,2
0X6EBCC08A401F9B5B.avi,44,1838,1426,412,28.892005610098177,morphological_dilation,3,2
0X6EBCC08A401F9B5B.avi,64,1127,795,332,41.76100628930818,morphological_dilation,3,2
0X6EC16E49F1C9337C.avi,46,1305,985,320,32.48730964467005,morphological_dilation,3,2
0X6EC16E49F1C9337C.avi,61,749,513,236,46.00389863547758,morphological_dilation,3,2
0X6EC20DDF9804A94E.avi,41,2099,1667,432,25.91481703659268,morphological_dilation,3,2
0X6EC20DDF9804A94E.avi,60,1623,1243,380,30.57119871279163,morphological_dilation,3,2
0X6EC3018E83F6DC05.avi,55,1523,1159,364,31.406384814495254,morphological_dilation,3,2
0X6EC3018E83F6DC05.avi,73,913,629,284,45.151033386327505,morphological_dilation,3,2
0X6EC9433198E4B6EE.avi,100,1559,1203,356,29.592684954280962,morphological_dilation,3,2
0X6EC9433198E4B6EE.avi,112,991,710,281,39.57746478873239,morphological_dilation,3,2
0X6ECDA48CE778B00A.avi,80,1027,719,308,42.83727399165508,morphological_dilation,3,2
0X6ECDA48CE778B00A.avi,91,634,366,268,73.224043715847,morphological_dilation,3,2
0X6ECDFA5069831090.avi,3,1861,1469,392,26.684819605173587,morphological_dilation,3,2
0X6ECDFA5069831090.avi,13,1599,1231,368,29.894394800974815,morphological_dilation,3,2
0X6ED5C7B1BB4E2BB6.avi,3,2211,1747,464,26.55981682884946,morphological_dilation,3,2
0X6ED5C7B1BB4E2BB6.avi,18,1511,1103,408,36.99002719854941,morphological_dilation,3,2
0X6EDD9E4450E09630.avi,77,1313,981,332,33.84301732925586,morphological_dilation,3,2
0X6EDD9E4450E09630.avi,90,873,589,284,48.217317487266556,morphological_dilation,3,2
0X6EDF5FFA911E093E.avi,59,2664,2196,468,21.311475409836063,morphological_dilation,3,2
0X6EDF5FFA911E093E.avi,78,1581,1193,388,32.52305113160101,morphological_dilation,3,2
0X6EE0A841475D41E8.avi,58,2235,1811,424,23.412479293208172,morphological_dilation,3,2
0X6EE0A841475D41E8.avi,78,1774,1390,384,27.62589928057554,morphological_dilation,3,2
0X6EE748ED071E4598.avi,49,1324,996,328,32.93172690763052,morphological_dilation,3,2
0X6EE748ED071E4598.avi,63,753,497,256,51.50905432595574,morphological_dilation,3,2
0X6EE923F8B9F82820.avi,225,1979,1575,404,25.650793650793652,morphological_dilation,3,2
0X6EE923F8B9F82820.avi,252,1277,948,329,34.70464135021097,morphological_dilation,3,2
0X6EEC06B1FBB5BB16.avi,115,1723,1333,390,29.257314328582147,morphological_dilation,3,2
0X6EEC06B1FBB5BB16.avi,138,1405,1022,383,37.47553816046967,morphological_dilation,3,2
0X6EEC24E41B261C6F.avi,44,2104,1688,416,24.644549763033176,morphological_dilation,3,2
0X6EEC24E41B261C6F.avi,61,1350,990,360,36.36363636363637,morphological_dilation,3,2
0X6EEDB606DA0C8EDE.avi,96,2307,1871,436,23.30304649919829,morphological_dilation,3,2
0X6EEDB606DA0C8EDE.avi,113,1465,1113,352,31.626235399820306,morphological_dilation,3,2
0X6EEFDA0A9F0144FF.avi,37,1772,1392,380,27.298850574712645,morphological_dilation,3,2
0X6EEFDA0A9F0144FF.avi,50,1186,846,340,40.189125295508276,morphological_dilation,3,2
0X6EF41C2BBBAA83EF.avi,40,2250,1830,420,22.950819672131146,morphological_dilation,3,2
0X6EF41C2BBBAA83EF.avi,54,1382,1042,340,32.629558541266796,morphological_dilation,3,2
0X6EF44A176770ADBA.avi,34,1785,1381,404,29.254163649529325,morphological_dilation,3,2
0X6EF44A176770ADBA.avi,46,1045,725,320,44.13793103448276,morphological_dilation,3,2
0X6EF6260B0E6665D0.avi,126,1725,1353,372,27.494456762749447,morphological_dilation,3,2
0X6EF6260B0E6665D0.avi,142,1157,849,308,36.27797408716137,morphological_dilation,3,2
0X6EF63902D4BD8E89.avi,96,1769,1393,376,26.99210337401292,morphological_dilation,3,2
0X6EF63902D4BD8E89.avi,112,1111,779,332,42.61874197689345,morphological_dilation,3,2
0X6EFD8278BC9B7522.avi,129,2420,1956,464,23.721881390593047,morphological_dilation,3,2
0X6EFD8278BC9B7522.avi,148,1407,1035,372,35.94202898550725,morphological_dilation,3,2
0X6F00E1B88FF7F2B6.avi,34,1790,1402,388,27.674750356633382,morphological_dilation,3,2
0X6F00E1B88FF7F2B6.avi,50,1125,813,312,38.37638376383764,morphological_dilation,3,2
0X6F0A5B2A3E3B11AB.avi,63,1466,1108,358,32.31046931407942,morphological_dilation,3,2
0X6F0A5B2A3E3B11AB.avi,80,929,629,300,47.69475357710652,morphological_dilation,3,2
0X6F0D9D384C0A3EBD.avi,37,1938,1542,396,25.680933852140075,morphological_dilation,3,2
0X6F0D9D384C0A3EBD.avi,54,1240,912,328,35.96491228070175,morphological_dilation,3,2
0X6F11EDE37AC0CF42.avi,39,3169,2625,544,20.723809523809525,morphological_dilation,3,2
0X6F11EDE37AC0CF42.avi,53,1721,1313,408,31.073876618431072,morphological_dilation,3,2
0X6F126C1C6883BA56.avi,155,2431,1984,447,22.530241935483872,morphological_dilation,3,2
0X6F126C1C6883BA56.avi,172,1368,1012,356,35.177865612648226,morphological_dilation,3,2
0X6F13E57513BEFA0.avi,83,1878,1478,400,27.06359945872801,morphological_dilation,3,2
0X6F13E57513BEFA0.avi,98,1154,834,320,38.36930455635492,morphological_dilation,3,2
0X6F16B7AB9191A5E5.avi,43,2585,2125,460,21.64705882352941,morphological_dilation,3,2
0X6F16B7AB9191A5E5.avi,60,1593,1205,388,32.19917012448133,morphological_dilation,3,2
0X6F1A76C8595E054A.avi,66,1551,1203,348,28.92768079800499,morphological_dilation,3,2
0X6F1A76C8595E054A.avi,86,969,692,277,40.028901734104046,morphological_dilation,3,2
0X6F1C009FD8963620.avi,52,1608,1216,392,32.23684210526316,morphological_dilation,3,2
0X6F1C009FD8963620.avi,65,1010,670,340,50.74626865671642,morphological_dilation,3,2
0X6F1EA03DBB298142.avi,48,3797,3221,576,17.88264514126048,morphological_dilation,3,2
0X6F1EA03DBB298142.avi,62,2240,1780,460,25.842696629213485,morphological_dilation,3,2
0X6F2B6B1280773A8.avi,84,2485,2013,472,23.447590660705416,morphological_dilation,3,2
0X6F2B6B1280773A8.avi,103,1575,1164,411,35.30927835051546,morphological_dilation,3,2
0X6F2C4C1B7A791CB9.avi,46,2197,1761,436,24.758659852356615,morphological_dilation,3,2
0X6F2C4C1B7A791CB9.avi,64,1475,1123,352,31.34461264470169,morphological_dilation,3,2
0X6F3232FD37FD13C5.avi,0,1410,1081,329,30.434782608695656,morphological_dilation,3,2
0X6F3232FD37FD13C5.avi,14,800,539,261,48.42300556586271,morphological_dilation,3,2
0X6F376F31663F3E61.avi,31,2687,2199,488,22.191905411550707,morphological_dilation,3,2
0X6F376F31663F3E61.avi,46,1749,1357,392,28.887251289609434,morphological_dilation,3,2
0X6F38AF03CE1A24E2.avi,46,1956,1528,428,28.01047120418848,morphological_dilation,3,2
0X6F38AF03CE1A24E2.avi,63,1347,979,368,37.58937691521961,morphological_dilation,3,2
0X6F3A6E1B710C13D1.avi,63,1132,828,304,36.71497584541063,morphological_dilation,3,2
0X6F3A6E1B710C13D1.avi,75,676,443,233,52.595936794582386,morphological_dilation,3,2
0X6F3E6EC0B32CBB66.avi,42,1213,909,304,33.44334433443345,morphological_dilation,3,2
0X6F3E6EC0B32CBB66.avi,58,747,503,244,48.508946322067594,morphological_dilation,3,2
0X6F44A51223E9F1E.avi,41,970,694,276,39.76945244956772,morphological_dilation,3,2
0X6F44A51223E9F1E.avi,59,681,437,244,55.83524027459954,morphological_dilation,3,2
0X6F489746D4866AAC.avi,44,1177,869,308,35.44303797468354,morphological_dilation,3,2
0X6F489746D4866AAC.avi,60,871,607,264,43.49258649093905,morphological_dilation,3,2
0X6F4E16CE27A18A6E.avi,46,2250,1814,436,24.035281146637267,morphological_dilation,3,2
0X6F4E16CE27A18A6E.avi,64,1288,956,332,34.72803347280335,morphological_dilation,3,2
0X6F4F950A5396343A.avi,29,1266,946,320,33.82663847780127,morphological_dilation,3,2
0X6F4F950A5396343A.avi,41,876,593,283,47.72344013490725,morphological_dilation,3,2
0X6F515874049619B1.avi,90,2122,1714,408,23.80396732788798,morphological_dilation,3,2
0X6F515874049619B1.avi,111,1666,1298,368,28.35130970724191,morphological_dilation,3,2
0X6F53D60A3AECC9.avi,45,1428,1056,372,35.22727272727273,morphological_dilation,3,2
0X6F53D60A3AECC9.avi,59,1009,697,312,44.76327116212339,morphological_dilation,3,2
0X6F57F1A540CA8629.avi,45,2267,1827,440,24.0831964969896,morphological_dilation,3,2
0X6F57F1A540CA8629.avi,63,1455,1095,360,32.87671232876712,morphological_dilation,3,2
0X6F5932D336F6CB12.avi,44,1309,989,320,32.355915065722954,morphological_dilation,3,2
0X6F5932D336F6CB12.avi,62,999,715,284,39.72027972027972,morphological_dilation,3,2
0X6F59844503FFC8FB.avi,98,1702,1314,388,29.52815829528158,morphological_dilation,3,2
0X6F59844503FFC8FB.avi,120,1001,693,308,44.44444444444444,morphological_dilation,3,2
0X6F59F94EF318EF6F.avi,106,3214,2670,544,20.374531835205993,morphological_dilation,3,2
0X6F59F94EF318EF6F.avi,129,1802,1371,431,31.436907366885485,morphological_dilation,3,2
0X6F5EB0942891DF30.avi,97,1251,935,316,33.79679144385027,morphological_dilation,3,2
0X6F5EB0942891DF30.avi,110,818,550,268,48.72727272727273,morphological_dilation,3,2
0X6F62E9BEC35BDCF2.avi,53,3047,2519,528,20.96069868995633,morphological_dilation,3,2
0X6F62E9BEC35BDCF2.avi,74,2054,1596,458,28.696741854636592,morphological_dilation,3,2
0X6F684CDA94ECA62B.avi,36,1248,932,316,33.90557939914164,morphological_dilation,3,2
0X6F684CDA94ECA62B.avi,50,826,558,268,48.028673835125446,morphological_dilation,3,2
0X6F6DB4A07AA7BED2.avi,40,1186,864,322,37.26851851851852,morphological_dilation,3,2
0X6F6DB4A07AA7BED2.avi,54,687,451,236,52.328159645232816,morphological_dilation,3,2
0X6F6DBAC7292C3E36.avi,4,2282,1854,428,23.085221143473568,morphological_dilation,3,2
0X6F6DBAC7292C3E36.avi,23,1473,1121,352,31.400535236396077,morphological_dilation,3,2
0X6F6EA16F5E3467AA.avi,102,1367,1013,354,34.9457058242843,morphological_dilation,3,2
0X6F6EA16F5E3467AA.avi,118,803,513,290,56.53021442495126,morphological_dilation,3,2
0X6F713E0BFAAF743B.avi,83,2072,1640,432,26.34146341463415,morphological_dilation,3,2
0X6F713E0BFAAF743B.avi,102,1390,1010,380,37.62376237623762,morphological_dilation,3,2
0X6F739801341A22F6.avi,89,2870,2394,476,19.883040935672515,morphological_dilation,3,2
0X6F739801341A22F6.avi,104,2204,1748,456,26.08695652173913,morphological_dilation,3,2
0X6F7817E2F5DC217F.avi,154,1914,1486,428,28.802153432032302,morphological_dilation,3,2
0X6F7817E2F5DC217F.avi,166,1272,923,349,37.81148429035753,morphological_dilation,3,2
0X6F7BF22A07F61BC8.avi,69,2122,1682,440,26.159334126040427,morphological_dilation,3,2
0X6F7BF22A07F61BC8.avi,79,1342,988,354,35.82995951417004,morphological_dilation,3,2
0X6F7F4362C857E0FC.avi,34,2773,2261,512,22.64484741264927,morphological_dilation,3,2
0X6F7F4362C857E0FC.avi,45,1701,1281,420,32.78688524590164,morphological_dilation,3,2
0X6F81F5F5E980BF50.avi,49,2016,1608,408,25.37313432835821,morphological_dilation,3,2
0X6F81F5F5E980BF50.avi,62,1376,1020,356,34.90196078431372,morphological_dilation,3,2
0X6F8676CBA5E2571A.avi,38,1903,1483,420,28.320971004720164,morphological_dilation,3,2
0X6F8676CBA5E2571A.avi,53,1297,933,364,39.01393354769561,morphological_dilation,3,2
0X6F89061323A89C46.avi,33,1985,1573,412,26.191989828353464,morphological_dilation,3,2
0X6F89061323A89C46.avi,46,1029,713,316,44.31977559607293,morphological_dilation,3,2
0X6F89F46E2350BAD3.avi,70,1558,1186,372,31.365935919055648,morphological_dilation,3,2
0X6F89F46E2350BAD3.avi,81,1032,712,320,44.9438202247191,morphological_dilation,3,2
0X6F8CC942DF924170.avi,58,2591,2131,460,21.586109807602064,morphological_dilation,3,2
0X6F8CC942DF924170.avi,78,1675,1287,388,30.14763014763015,morphological_dilation,3,2
0X6F8D259324E0E9D0.avi,99,1553,1197,356,29.741019214703424,morphological_dilation,3,2
0X6F8D259324E0E9D0.avi,112,1005,705,300,42.5531914893617,morphological_dilation,3,2
0X6F9AC7D6A33B3FBD.avi,53,1198,878,320,36.44646924829157,morphological_dilation,3,2
0X6F9AC7D6A33B3FBD.avi,70,735,453,282,62.251655629139066,morphological_dilation,3,2
0X6F9C221EE2CE3A8B.avi,79,2492,2028,464,22.879684418145956,morphological_dilation,3,2
0X6F9C221EE2CE3A8B.avi,96,1734,1342,392,29.210134128166914,morphological_dilation,3,2
0X6F9E0DEF7A32E75E.avi,28,1125,820,305,37.19512195121951,morphological_dilation,3,2
0X6F9E0DEF7A32E75E.avi,42,711,451,260,57.64966740576497,morphological_dilation,3,2
0X6F9FD41E87A2BF22.avi,147,1724,1317,407,30.903568716780562,morphological_dilation,3,2
0X6F9FD41E87A2BF22.avi,174,981,673,308,45.76523031203566,morphological_dilation,3,2
0X6FA1794B8CBE3C04.avi,75,2306,1870,436,23.315508021390375,morphological_dilation,3,2
0X6FA1794B8CBE3C04.avi,90,1477,1105,372,33.665158371040725,morphological_dilation,3,2
0X6FA8D7C2278B5073.avi,3,2844,2360,484,20.508474576271183,morphological_dilation,3,2
0X6FA8D7C2278B5073.avi,31,2069,1657,412,24.864212432106218,morphological_dilation,3,2
0X6FAA89F3C9D58522.avi,39,1852,1464,388,26.50273224043716,morphological_dilation,3,2
0X6FAA89F3C9D58522.avi,55,1261,921,340,36.91639522258415,morphological_dilation,3,2
0X6FAB02B40464E30.avi,51,1030,722,308,42.65927977839335,morphological_dilation,3,2
0X6FAB02B40464E30.avi,70,597,357,240,67.22689075630252,morphological_dilation,3,2
0X6FAC8B9E8907EBF3.avi,44,1687,1327,360,27.128862094951018,morphological_dilation,3,2
0X6FAC8B9E8907EBF3.avi,70,1091,783,308,39.33588761174968,morphological_dilation,3,2
0X6FAD9DF07824297B.avi,22,1515,1132,383,33.8339222614841,morphological_dilation,3,2
0X6FAD9DF07824297B.avi,39,883,564,319,56.560283687943254,morphological_dilation,3,2
0X6FADD66D9851B383.avi,49,1388,1032,356,34.49612403100775,morphological_dilation,3,2
0X6FADD66D9851B383.avi,69,876,572,304,53.14685314685315,morphological_dilation,3,2
0X6FB192AE737A59F2.avi,55,2230,1794,436,24.30323299888517,morphological_dilation,3,2
0X6FB192AE737A59F2.avi,71,1492,1148,344,29.965156794425084,morphological_dilation,3,2
0X6FB47E8BB8464F42.avi,40,1423,1099,324,29.481346678798907,morphological_dilation,3,2
0X6FB47E8BB8464F42.avi,51,952,668,284,42.51497005988024,morphological_dilation,3,2
0X6FB59E8686C472A1.avi,83,1404,1056,348,32.95454545454545,morphological_dilation,3,2
0X6FB59E8686C472A1.avi,94,988,672,316,47.023809523809526,morphological_dilation,3,2
0X6FBA1BCD968A92CD.avi,58,3718,3150,568,18.03174603174603,morphological_dilation,3,2
0X6FBA1BCD968A92CD.avi,82,2213,1769,444,25.098925946862632,morphological_dilation,3,2
0X6FBEF41EB6975D30.avi,49,2125,1721,404,23.47472399767577,morphological_dilation,3,2
0X6FBEF41EB6975D30.avi,71,1378,1030,348,33.78640776699029,morphological_dilation,3,2
0X6FC112B490B34E0F.avi,58,1901,1477,424,28.70683818551117,morphological_dilation,3,2
0X6FC112B490B34E0F.avi,76,1137,805,332,41.24223602484472,morphological_dilation,3,2
0X6FC504B60333F621.avi,89,2921,2418,503,20.802315963606286,morphological_dilation,3,2
0X6FC504B60333F621.avi,107,1702,1322,380,28.74432677760968,morphological_dilation,3,2
0X6FC50A1C8B616D06.avi,53,1694,1322,372,28.139183055975792,morphological_dilation,3,2
0X6FC50A1C8B616D06.avi,71,1079,755,324,42.91390728476821,morphological_dilation,3,2
0X6FC541ABB4081E98.avi,73,2980,2500,480,19.2,morphological_dilation,3,2
0X6FC541ABB4081E98.avi,83,2589,2118,471,22.237960339943346,morphological_dilation,3,2
0X6FC8A2C44917FE58.avi,35,1586,1222,364,29.78723404255319,morphological_dilation,3,2
0X6FC8A2C44917FE58.avi,47,1078,770,308,40.0,morphological_dilation,3,2
0X6FCB1BA18A58D7F2.avi,36,2142,1734,408,23.52941176470588,morphological_dilation,3,2
0X6FCB1BA18A58D7F2.avi,51,1435,1091,344,31.53070577451879,morphological_dilation,3,2
0X6FCDD9107094644A.avi,45,1646,1264,382,30.22151898734177,morphological_dilation,3,2
0X6FCDD9107094644A.avi,62,1213,873,340,38.94616265750287,morphological_dilation,3,2
0X6FCE7C69AE34FBF7.avi,73,1771,1391,380,27.31847591660676,morphological_dilation,3,2
0X6FCE7C69AE34FBF7.avi,89,1008,716,292,40.78212290502793,morphological_dilation,3,2
0X6FD03091458DAD1C.avi,41,3683,3155,528,16.735340729001585,morphological_dilation,3,2
0X6FD03091458DAD1C.avi,57,2112,1692,420,24.822695035460992,morphological_dilation,3,2
0X6FDBAFEA74C9BC7E.avi,80,1225,861,364,42.27642276422765,morphological_dilation,3,2
0X6FDBAFEA74C9BC7E.avi,95,578,354,224,63.2768361581921,morphological_dilation,3,2
0X6FE03765A01F42BB.avi,78,1463,1119,344,30.741733690795353,morphological_dilation,3,2
0X6FE03765A01F42BB.avi,90,1035,754,281,37.267904509283824,morphological_dilation,3,2
0X6FE2B29A1FEB5D59.avi,43,2398,1954,444,22.722620266120778,morphological_dilation,3,2
0X6FE2B29A1FEB5D59.avi,60,1579,1190,389,32.6890756302521,morphological_dilation,3,2
0X6FE853660ADC4185.avi,45,2024,1604,420,26.184538653366584,morphological_dilation,3,2
0X6FE853660ADC4185.avi,59,1278,933,345,36.97749196141479,morphological_dilation,3,2
0X6FEAD8540CA87C27.avi,74,1392,1052,340,32.31939163498099,morphological_dilation,3,2
0X6FEAD8540CA87C27.avi,92,925,633,292,46.12954186413902,morphological_dilation,3,2
0X6FECBE1633D70BD1.avi,4,1421,1061,360,33.93025447690858,morphological_dilation,3,2
0X6FECBE1633D70BD1.avi,14,906,618,288,46.601941747572816,morphological_dilation,3,2
0X6FF3977D7086E468.avi,100,2981,2489,492,19.766974688629972,morphological_dilation,3,2
0X6FF3977D7086E468.avi,114,2544,2096,448,21.374045801526716,morphological_dilation,3,2
0X6FF416B50E42532F.avi,67,1550,1166,384,32.933104631217844,morphological_dilation,3,2
0X6FF416B50E42532F.avi,83,864,564,300,53.191489361702125,morphological_dilation,3,2
0X6FF709E2C5589D01.avi,86,1775,1391,384,27.60603882099209,morphological_dilation,3,2
0X6FF709E2C5589D01.avi,105,1016,724,292,40.331491712707184,morphological_dilation,3,2
0X6FF9A4411F2F8A34.avi,3,1334,974,360,36.96098562628337,morphological_dilation,3,2
0X6FF9A4411F2F8A34.avi,16,808,532,276,51.8796992481203,morphological_dilation,3,2
0X7005CBA88A578C96.avi,0,2279,1867,412,22.06748794858061,morphological_dilation,3,2
0X7005CBA88A578C96.avi,18,1595,1235,360,29.1497975708502,morphological_dilation,3,2
0X700762E763698FC5.avi,48,1477,1137,340,29.90325417766051,morphological_dilation,3,2
0X700762E763698FC5.avi,68,938,654,284,43.425076452599384,morphological_dilation,3,2
0X7009D23E3B00F78B.avi,72,2298,1834,464,25.29989094874591,morphological_dilation,3,2
0X7009D23E3B00F78B.avi,90,1283,936,347,37.072649572649574,morphological_dilation,3,2
0X700A648C41DE6CFB.avi,121,1817,1425,392,27.50877192982456,morphological_dilation,3,2
0X700A648C41DE6CFB.avi,141,1295,951,344,36.17245005257624,morphological_dilation,3,2
0X700C7EFB75691A.avi,1,1154,834,320,38.36930455635492,morphological_dilation,3,2
0X700C7EFB75691A.avi,14,803,515,288,55.92233009708738,morphological_dilation,3,2
0X7012247CA8314DC5.avi,108,1977,1553,424,27.30199613650998,morphological_dilation,3,2
0X7012247CA8314DC5.avi,124,1362,1006,356,35.387673956262425,morphological_dilation,3,2
0X7013EE30D524B6B0.avi,113,1184,882,302,34.24036281179138,morphological_dilation,3,2
0X7013EE30D524B6B0.avi,132,838,566,272,48.0565371024735,morphological_dilation,3,2
0X701410DAEAC658EF.avi,43,2190,1766,424,24.009060022650054,morphological_dilation,3,2
0X701410DAEAC658EF.avi,61,1329,989,340,34.37815975733064,morphological_dilation,3,2
0X7014D866DE2E617A.avi,64,1648,1288,360,27.95031055900621,morphological_dilation,3,2
0X7014D866DE2E617A.avi,80,970,666,304,45.645645645645644,morphological_dilation,3,2
0X70190C8882ECDB13.avi,4,1478,1138,340,29.876977152899826,morphological_dilation,3,2
0X70190C8882ECDB13.avi,21,996,700,296,42.285714285714285,morphological_dilation,3,2
0X7020667D86884D88.avi,123,1549,1201,348,28.975853455453787,morphological_dilation,3,2
0X7020667D86884D88.avi,141,981,693,288,41.55844155844156,morphological_dilation,3,2
0X7023BDE81F8A00C0.avi,1,1787,1387,400,28.83922134102379,morphological_dilation,3,2
0X7023BDE81F8A00C0.avi,14,1179,843,336,39.8576512455516,morphological_dilation,3,2
0X7026A611CB19B457.avi,84,1481,1109,372,33.543733092876465,morphological_dilation,3,2
0X7026A611CB19B457.avi,96,898,594,304,51.178451178451176,morphological_dilation,3,2
0X702756FBB896F42.avi,162,2791,2323,468,20.14636246233319,morphological_dilation,3,2
0X702756FBB896F42.avi,171,1769,1389,380,27.35781137508999,morphological_dilation,3,2
0X70275A298A8CF5ED.avi,3,1826,1444,382,26.454293628808866,morphological_dilation,3,2
0X70275A298A8CF5ED.avi,23,1554,1206,348,28.855721393034827,morphological_dilation,3,2
0X7027715D06DA15FD.avi,0,1732,1356,376,27.728613569321535,morphological_dilation,3,2
0X7027715D06DA15FD.avi,16,1221,896,325,36.27232142857143,morphological_dilation,3,2
0X702A639A91967D29.avi,56,1796,1392,404,29.022988505747126,morphological_dilation,3,2
0X702A639A91967D29.avi,67,1080,760,320,42.10526315789473,morphological_dilation,3,2
0X702D4E353E3B6A04.avi,61,1804,1400,404,28.857142857142858,morphological_dilation,3,2
0X702D4E353E3B6A04.avi,75,1293,937,356,37.99359658484525,morphological_dilation,3,2
0X702EF9BCE901DC90.avi,53,1940,1528,412,26.96335078534031,morphological_dilation,3,2
0X702EF9BCE901DC90.avi,73,1135,807,328,40.644361833952914,morphological_dilation,3,2
0X703273C4B5E6308B.avi,2,1732,1336,396,29.64071856287425,morphological_dilation,3,2
0X703273C4B5E6308B.avi,16,1324,984,340,34.552845528455286,morphological_dilation,3,2
0X7032E1A414DEC083.avi,71,3090,2598,492,18.937644341801384,morphological_dilation,3,2
0X7032E1A414DEC083.avi,86,2802,2338,464,19.84602224123182,morphological_dilation,3,2
0X7034CDD3E709AC39.avi,31,1517,1153,364,31.569817866435386,morphological_dilation,3,2
0X7034CDD3E709AC39.avi,43,840,568,272,47.88732394366197,morphological_dilation,3,2
0X70351F9FD9444C30.avi,44,1715,1327,388,29.238884702336097,morphological_dilation,3,2
0X70351F9FD9444C30.avi,62,1162,830,332,40.0,morphological_dilation,3,2
0X7036B875624A51E5.avi,78,1113,801,312,38.951310861423224,morphological_dilation,3,2
0X7036B875624A51E5.avi,96,813,537,276,51.39664804469274,morphological_dilation,3,2
0X703774EFA4BCF502.avi,45,2077,1650,427,25.87878787878788,morphological_dilation,3,2
0X703774EFA4BCF502.avi,61,1287,951,336,35.33123028391167,morphological_dilation,3,2
0X7044F4025752BCB6.avi,38,1920,1512,408,26.984126984126984,morphological_dilation,3,2
0X7044F4025752BCB6.avi,52,1191,851,340,39.9529964747356,morphological_dilation,3,2
0X704845139A356532.avi,87,1462,1102,360,32.66787658802178,morphological_dilation,3,2
0X704845139A356532.avi,105,891,587,304,51.78875638841567,morphological_dilation,3,2
0X7048F0997184EE82.avi,45,1216,872,344,39.44954128440367,morphological_dilation,3,2
0X7048F0997184EE82.avi,59,753,481,272,56.54885654885655,morphological_dilation,3,2
0X705277E7D6EF6A7A.avi,104,1655,1295,360,27.7992277992278,morphological_dilation,3,2
0X705277E7D6EF6A7A.avi,116,1063,771,292,37.87289234760052,morphological_dilation,3,2
0X7055E89AD38B36BC.avi,49,996,716,280,39.10614525139665,morphological_dilation,3,2
0X7055E89AD38B36BC.avi,66,622,403,219,54.3424317617866,morphological_dilation,3,2
0X705789F6BD6B3A46.avi,23,1612,1208,404,33.443708609271525,morphological_dilation,3,2
0X705789F6BD6B3A46.avi,36,1243,891,352,39.50617283950617,morphological_dilation,3,2
0X705A3B3F265BFE44.avi,95,1167,855,312,36.49122807017544,morphological_dilation,3,2
0X705A3B3F265BFE44.avi,112,732,488,244,50.0,morphological_dilation,3,2
0X705E3B9AFAB0574E.avi,95,1682,1326,356,26.84766214177979,morphological_dilation,3,2
0X705E3B9AFAB0574E.avi,111,1022,738,284,38.482384823848236,morphological_dilation,3,2
0X705E75D6928EF51E.avi,56,1648,1284,364,28.34890965732087,morphological_dilation,3,2
0X705E75D6928EF51E.avi,70,1406,1074,332,30.91247672253259,morphological_dilation,3,2
0X7061256767FDFE90.avi,50,2038,1619,419,25.880172946263123,morphological_dilation,3,2
0X7061256767FDFE90.avi,64,1321,985,336,34.11167512690355,morphological_dilation,3,2
0X706610E923C8C8EF.avi,40,1427,1087,340,31.278748850046,morphological_dilation,3,2
0X706610E923C8C8EF.avi,57,896,616,280,45.45454545454545,morphological_dilation,3,2
0X706626FF3D23F7A.avi,81,2721,2233,488,21.85400806090461,morphological_dilation,3,2
0X706626FF3D23F7A.avi,98,1919,1499,420,28.018679119412944,morphological_dilation,3,2
0X706A53B9FE10409B.avi,123,1642,1282,360,28.081123244929795,morphological_dilation,3,2
0X706A53B9FE10409B.avi,138,996,704,292,41.47727272727273,morphological_dilation,3,2
0X706B389AF6175FE4.avi,88,1629,1267,362,28.57142857142857,morphological_dilation,3,2
0X706B389AF6175FE4.avi,109,1070,758,312,41.16094986807388,morphological_dilation,3,2
0X706C949699E80227.avi,132,1529,1185,344,29.0295358649789,morphological_dilation,3,2
0X706C949699E80227.avi,147,1065,761,304,39.94743758212878,morphological_dilation,3,2
0X70702683D6C909DB.avi,48,1872,1484,388,26.1455525606469,morphological_dilation,3,2
0X70702683D6C909DB.avi,70,1084,756,328,43.386243386243386,morphological_dilation,3,2
0X707B067AEDFAD712.avi,70,2685,2185,500,22.883295194508012,morphological_dilation,3,2
0X707B067AEDFAD712.avi,88,1777,1322,455,34.41754916792738,morphological_dilation,3,2
0X707C17FA96DF27D1.avi,85,1873,1465,408,27.84982935153584,morphological_dilation,3,2
0X707C17FA96DF27D1.avi,100,1145,813,332,40.836408364083645,morphological_dilation,3,2
0X7083497ECE270656.avi,35,1480,1144,336,29.37062937062937,morphological_dilation,3,2
0X7083497ECE270656.avi,49,1096,784,312,39.795918367346935,morphological_dilation,3,2
0X70873D84AF6D4274.avi,87,3516,2988,528,17.670682730923694,morphological_dilation,3,2
0X70873D84AF6D4274.avi,104,2326,1890,436,23.06878306878307,morphological_dilation,3,2
0X7087C253BDEAFDF9.avi,42,1515,1135,380,33.480176211453745,morphological_dilation,3,2
0X7087C253BDEAFDF9.avi,56,1104,768,336,43.75,morphological_dilation,3,2
0X708AF5A9AE4F5DB1.avi,37,2341,1910,431,22.56544502617801,morphological_dilation,3,2
0X708AF5A9AE4F5DB1.avi,55,1807,1415,392,27.703180212014132,morphological_dilation,3,2
0X708BD14C8A32B53D.avi,75,1839,1415,424,29.964664310954063,morphological_dilation,3,2
0X708BD14C8A32B53D.avi,88,1182,850,332,39.05882352941176,morphological_dilation,3,2
0X708D0E99CDFD8420.avi,49,1759,1379,380,27.556200145032633,morphological_dilation,3,2
0X708D0E99CDFD8420.avi,64,1096,780,316,40.51282051282051,morphological_dilation,3,2
0X7093FB30EB363260.avi,46,1904,1502,402,26.764314247669773,morphological_dilation,3,2
0X7093FB30EB363260.avi,60,1212,872,340,38.99082568807339,morphological_dilation,3,2
0X709522F8FD4A92DF.avi,79,2537,2101,436,20.752022846263685,morphological_dilation,3,2
0X709522F8FD4A92DF.avi,93,1998,1598,400,25.03128911138924,morphological_dilation,3,2
0X7097365FC2F8B218.avi,35,2255,1795,460,25.62674094707521,morphological_dilation,3,2
0X7097365FC2F8B218.avi,47,1481,1093,388,35.49862763037511,morphological_dilation,3,2
0X709A3DD7C31252F3.avi,135,1578,1218,360,29.55665024630542,morphological_dilation,3,2
0X709A3DD7C31252F3.avi,150,887,615,272,44.22764227642276,morphological_dilation,3,2
0X70A2BC92934984FF.avi,52,1693,1317,376,28.549734244495063,morphological_dilation,3,2
0X70A2BC92934984FF.avi,65,1094,797,297,37.26474278544542,morphological_dilation,3,2
0X70A5167D3A618D63.avi,50,1434,1098,336,30.601092896174865,morphological_dilation,3,2
0X70A5167D3A618D63.avi,66,973,688,285,41.424418604651166,morphological_dilation,3,2
0X70A99B2DE372C268.avi,46,1835,1427,408,28.59145059565522,morphological_dilation,3,2
0X70A99B2DE372C268.avi,65,1088,728,360,49.45054945054945,morphological_dilation,3,2
0X70AA5048370C9DC2.avi,52,3136,2628,508,19.330289193302892,morphological_dilation,3,2
0X70AA5048370C9DC2.avi,67,1743,1340,403,30.074626865671643,morphological_dilation,3,2
0X70AB615C12541CA8.avi,97,1645,1262,383,30.348652931854197,morphological_dilation,3,2
0X70AB615C12541CA8.avi,112,1258,927,331,35.706580366774546,morphological_dilation,3,2
0X70ACF2035FC035DE.avi,74,1326,1002,324,32.33532934131736,morphological_dilation,3,2
0X70ACF2035FC035DE.avi,92,899,611,288,47.13584288052373,morphological_dilation,3,2
0X70ADF1B72CC150A9.avi,76,2662,2170,492,22.672811059907836,morphological_dilation,3,2
0X70ADF1B72CC150A9.avi,96,1563,1179,384,32.56997455470738,morphological_dilation,3,2
0X70AE1E2408B80316.avi,45,2888,2452,436,17.781402936378466,morphological_dilation,3,2
0X70AE1E2408B80316.avi,66,1602,1230,372,30.24390243902439,morphological_dilation,3,2
0X70B2BF6C41F06457.avi,48,1792,1432,360,25.139664804469277,morphological_dilation,3,2
0X70B2BF6C41F06457.avi,61,1317,993,324,32.62839879154079,morphological_dilation,3,2
0X70B49CEB13611B36.avi,43,2047,1639,408,24.893227577791336,morphological_dilation,3,2
0X70B49CEB13611B36.avi,63,1320,980,340,34.69387755102041,morphological_dilation,3,2
0X70B8D6F5238FAFCF.avi,114,1334,998,336,33.66733466933868,morphological_dilation,3,2
0X70B8D6F5238FAFCF.avi,136,830,546,284,52.01465201465202,morphological_dilation,3,2
0X70BD7DAF007680A6.avi,105,1899,1496,403,26.938502673796794,morphological_dilation,3,2
0X70BD7DAF007680A6.avi,117,1208,876,332,37.89954337899543,morphological_dilation,3,2
0X70BE977A39DCF1C6.avi,85,2812,2320,492,21.20689655172414,morphological_dilation,3,2
0X70BE977A39DCF1C6.avi,101,1788,1363,425,31.181217901687454,morphological_dilation,3,2
0X70C4138A90A72155.avi,100,1866,1446,420,29.045643153526974,morphological_dilation,3,2
0X70C4138A90A72155.avi,117,1145,797,348,43.66373902132999,morphological_dilation,3,2
0X70C42F855DC5568E.avi,41,2233,1809,424,23.4383637368712,morphological_dilation,3,2
0X70C42F855DC5568E.avi,56,1574,1198,376,31.385642737896497,morphological_dilation,3,2
0X70C62920786CE4C2.avi,54,2627,2164,463,21.395563770794823,morphological_dilation,3,2
0X70C62920786CE4C2.avi,75,1606,1230,376,30.569105691056908,morphological_dilation,3,2
0X70C6ED8487CEA4F6.avi,47,1385,1049,336,32.030505243088655,morphological_dilation,3,2
0X70C6ED8487CEA4F6.avi,64,887,615,272,44.22764227642276,morphological_dilation,3,2
0X70C72825311E1EE.avi,134,1637,1289,348,26.997672614429792,morphological_dilation,3,2
0X70C72825311E1EE.avi,153,1168,860,308,35.81395348837209,morphological_dilation,3,2
0X70C7E7E952C28C1.avi,45,2144,1700,444,26.11764705882353,morphological_dilation,3,2
0X70C7E7E952C28C1.avi,61,1790,1378,412,29.898403483309146,morphological_dilation,3,2
0X70C7EBC3408A81DD.avi,42,1668,1292,376,29.102167182662537,morphological_dilation,3,2
0X70C7EBC3408A81DD.avi,58,1109,793,316,39.84867591424969,morphological_dilation,3,2
0X70C80E8613294FE6.avi,217,1865,1481,384,25.928426738690074,morphological_dilation,3,2
0X70C80E8613294FE6.avi,249,1199,876,323,36.87214611872146,morphological_dilation,3,2
0X70CDA916837C0563.avi,66,2990,2470,520,21.052631578947366,morphological_dilation,3,2
0X70CDA916837C0563.avi,85,1640,1222,418,34.20621931260229,morphological_dilation,3,2
0X70E038A53FD778FE.avi,50,1596,1221,375,30.71253071253071,morphological_dilation,3,2
0X70E038A53FD778FE.avi,66,1052,721,331,45.90846047156727,morphological_dilation,3,2
0X70E1AE6BC18EE77C.avi,4,1544,1188,356,29.96632996632997,morphological_dilation,3,2
0X70E1AE6BC18EE77C.avi,16,1004,705,299,42.4113475177305,morphological_dilation,3,2
0X70E2AFD806E85866.avi,50,1098,794,304,38.287153652392945,morphological_dilation,3,2
0X70E2AFD806E85866.avi,66,617,365,252,69.04109589041096,morphological_dilation,3,2
0X70EF20826840207B.avi,76,1670,1286,384,29.86003110419907,morphological_dilation,3,2
0X70EF20826840207B.avi,93,1018,701,317,45.22111269614836,morphological_dilation,3,2
0X70F08157D6C11C06.avi,52,1811,1431,380,26.554856743535986,morphological_dilation,3,2
0X70F08157D6C11C06.avi,68,1238,918,320,34.85838779956427,morphological_dilation,3,2
0X70F0F3896BAA0A92.avi,6,1469,1129,340,30.115146147032775,morphological_dilation,3,2
0X70F0F3896BAA0A92.avi,21,997,705,292,41.41843971631206,morphological_dilation,3,2
0X70F4F530DB582570.avi,65,1719,1347,372,27.616926503340757,morphological_dilation,3,2
0X70F4F530DB582570.avi,82,1075,751,324,43.142476697736356,morphological_dilation,3,2
0X70F82461E9DA9509.avi,53,2324,1888,436,23.093220338983052,morphological_dilation,3,2
0X70F82461E9DA9509.avi,73,1780,1400,380,27.142857142857142,morphological_dilation,3,2
0X70FC196E362DA53.avi,0,2428,2000,428,21.4,morphological_dilation,3,2
0X70FC196E362DA53.avi,12,1483,1143,340,29.74628171478565,morphological_dilation,3,2
0X70FEA4410C358456.avi,93,2484,2032,452,22.244094488188974,morphological_dilation,3,2
0X70FEA4410C358456.avi,115,2163,1751,412,23.52941176470588,morphological_dilation,3,2
0X7101796E23DB2C6C.avi,48,2489,2037,452,22.189494354442807,morphological_dilation,3,2
0X7101796E23DB2C6C.avi,61,1543,1175,368,31.319148936170212,morphological_dilation,3,2
0X7102D17A09373238.avi,37,1651,1299,352,27.097767513471897,morphological_dilation,3,2
0X7102D17A09373238.avi,55,955,671,284,42.32488822652757,morphological_dilation,3,2
0X71087954DB99E5FB.avi,64,1765,1373,392,28.55061908230153,morphological_dilation,3,2
0X71087954DB99E5FB.avi,80,1056,724,332,45.85635359116022,morphological_dilation,3,2
0X710AB66715EBDE2E.avi,69,1060,764,296,38.7434554973822,morphological_dilation,3,2
0X710AB66715EBDE2E.avi,83,678,441,237,53.74149659863946,morphological_dilation,3,2
0X710BC7A746C16F30.avi,84,1781,1409,372,26.40170333569908,morphological_dilation,3,2
0X710BC7A746C16F30.avi,96,1538,1194,344,28.8107202680067,morphological_dilation,3,2
0X710CEE694461AA2E.avi,39,1462,1118,344,30.76923076923077,morphological_dilation,3,2
0X710CEE694461AA2E.avi,55,866,598,268,44.81605351170568,morphological_dilation,3,2
0X710EC36F325037EE.avi,78,1020,704,316,44.88636363636363,morphological_dilation,3,2
0X710EC36F325037EE.avi,90,689,396,293,73.98989898989899,morphological_dilation,3,2
0X7111782DEA339319.avi,61,1478,1126,352,31.261101243339258,morphological_dilation,3,2
0X7111782DEA339319.avi,73,931,651,280,43.01075268817204,morphological_dilation,3,2
0X7118ED94A443E8E7.avi,2,1133,841,292,34.720570749108205,morphological_dilation,3,2
0X7118ED94A443E8E7.avi,19,846,582,264,45.36082474226804,morphological_dilation,3,2
0X711CC31DFD8C6CE6.avi,39,1700,1320,380,28.78787878787879,morphological_dilation,3,2
0X711CC31DFD8C6CE6.avi,53,1066,751,315,41.944074567243675,morphological_dilation,3,2
0X7120B54F5E975B0.avi,3,1466,1118,348,31.12701252236136,morphological_dilation,3,2
0X7120B54F5E975B0.avi,16,1096,792,304,38.38383838383838,morphological_dilation,3,2
0X7122CEBF07A2DE69.avi,77,1914,1526,388,25.4259501965924,morphological_dilation,3,2
0X7122CEBF07A2DE69.avi,91,1534,1170,364,31.11111111111111,morphological_dilation,3,2
0X712458E135BD7CD0.avi,42,1429,1077,352,32.68337975858867,morphological_dilation,3,2
0X712458E135BD7CD0.avi,55,968,669,299,44.69357249626308,morphological_dilation,3,2
0X71258BC9BF14F659.avi,47,1884,1500,384,25.6,morphological_dilation,3,2
0X71258BC9BF14F659.avi,63,1223,911,312,34.24807903402854,morphological_dilation,3,2
0X7125909CA78A239F.avi,139,1626,1262,364,28.84310618066561,morphological_dilation,3,2
0X7125909CA78A239F.avi,157,943,667,276,41.37931034482759,morphological_dilation,3,2
0X71270AD323D7C627.avi,44,1653,1269,384,30.260047281323878,morphological_dilation,3,2
0X71270AD323D7C627.avi,64,1018,700,318,45.42857142857143,morphological_dilation,3,2
0X712BBDD024BB89D4.avi,37,1777,1366,411,30.08784773060029,morphological_dilation,3,2
0X712BBDD024BB89D4.avi,50,1255,919,336,36.56147986942329,morphological_dilation,3,2
0X7131C08459C410A1.avi,155,1716,1360,356,26.176470588235297,morphological_dilation,3,2
0X7131C08459C410A1.avi,173,1001,725,276,38.068965517241374,morphological_dilation,3,2
0X713283EFDECFC71F.avi,128,2765,2289,476,20.795107033639145,morphological_dilation,3,2
0X713283EFDECFC71F.avi,146,2210,1762,448,25.425652667423382,morphological_dilation,3,2
0X713C7B1DB0E7CB75.avi,151,1824,1448,376,25.96685082872928,morphological_dilation,3,2
0X713C7B1DB0E7CB75.avi,168,1211,891,320,35.91470258136925,morphological_dilation,3,2
0X714EE9D5B7A7CB68.avi,60,1176,868,308,35.483870967741936,morphological_dilation,3,2
0X714EE9D5B7A7CB68.avi,87,838,578,260,44.982698961937714,morphological_dilation,3,2
0X715397AF1E4562CB.avi,31,1611,1239,372,30.024213075060537,morphological_dilation,3,2
0X715397AF1E4562CB.avi,47,1020,710,310,43.66197183098591,morphological_dilation,3,2
0X7159C74F59E908A1.avi,110,1420,1068,352,32.958801498127336,morphological_dilation,3,2
0X7159C74F59E908A1.avi,126,982,682,300,43.988269794721404,morphological_dilation,3,2
0X71609DB7DBE8E5C9.avi,80,1751,1371,380,27.716994894237786,morphological_dilation,3,2
0X71609DB7DBE8E5C9.avi,92,958,654,304,46.48318042813456,morphological_dilation,3,2
0X7161E52DA45FA80A.avi,73,1478,1142,336,29.422066549912433,morphological_dilation,3,2
0X7161E52DA45FA80A.avi,88,1026,746,280,37.533512064343164,morphological_dilation,3,2
0X7166874B45E63C2B.avi,216,2673,2197,476,21.6659080564406,morphological_dilation,3,2
0X7166874B45E63C2B.avi,247,1530,1155,375,32.467532467532465,morphological_dilation,3,2
0X716A0C710832A933.avi,66,1219,891,328,36.81257014590348,morphological_dilation,3,2
0X716A0C710832A933.avi,87,761,493,268,54.361054766734284,morphological_dilation,3,2
0X716A4A1F44C246C2.avi,91,2168,1728,440,25.462962962962965,morphological_dilation,3,2
0X716A4A1F44C246C2.avi,102,1358,1002,356,35.528942115768466,morphological_dilation,3,2
0X716B30133939FDA5.avi,52,1821,1445,376,26.02076124567474,morphological_dilation,3,2
0X716B30133939FDA5.avi,70,1176,847,329,38.84297520661157,morphological_dilation,3,2
0X716BD6EC64183751.avi,44,1783,1395,388,27.813620071684586,morphological_dilation,3,2
0X716BD6EC64183751.avi,56,1128,804,324,40.298507462686565,morphological_dilation,3,2
0X716ED8AC3405BBCF.avi,126,1229,925,304,32.86486486486486,morphological_dilation,3,2
0X716ED8AC3405BBCF.avi,136,886,630,256,40.63492063492063,morphological_dilation,3,2
0X71722CC01AF2175D.avi,102,1679,1303,376,28.85648503453569,morphological_dilation,3,2
0X71722CC01AF2175D.avi,118,1123,786,337,42.87531806615776,morphological_dilation,3,2
0X717323632DAF18D2.avi,54,1649,1293,356,27.532869296210364,morphological_dilation,3,2
0X717323632DAF18D2.avi,67,1105,797,308,38.64491844416562,morphological_dilation,3,2
0X7174E265B5635A11.avi,86,1009,715,294,41.11888111888112,morphological_dilation,3,2
0X7174E265B5635A11.avi,101,568,348,220,63.2183908045977,morphological_dilation,3,2
0X71755FC85FCCA3DE.avi,58,2529,2065,464,22.469733656174334,morphological_dilation,3,2
0X71755FC85FCCA3DE.avi,79,1490,1126,364,32.326820603907635,morphological_dilation,3,2
0X71787F5C9B2F37BD.avi,51,1799,1415,384,27.13780918727915,morphological_dilation,3,2
0X71787F5C9B2F37BD.avi,66,1300,972,328,33.744855967078195,morphological_dilation,3,2
0X717A7E3193260492.avi,0,1635,1247,388,31.11467522052927,morphological_dilation,3,2
0X717A7E3193260492.avi,17,990,682,308,45.16129032258064,morphological_dilation,3,2
0X717DCB2A4258FA9B.avi,40,1439,1091,348,31.897341888175983,morphological_dilation,3,2
0X717DCB2A4258FA9B.avi,59,921,617,304,49.270664505672606,morphological_dilation,3,2
0X717E05B4B54B895A.avi,127,2333,1909,424,22.210581456259824,morphological_dilation,3,2
0X717E05B4B54B895A.avi,148,1956,1564,392,25.063938618925828,morphological_dilation,3,2
0X718E2A768B2DAAD4.avi,59,1700,1336,364,27.245508982035926,morphological_dilation,3,2
0X718E2A768B2DAAD4.avi,80,1112,808,304,37.62376237623762,morphological_dilation,3,2
0X718F2A065EA36E9E.avi,2,2037,1633,404,24.73974280465401,morphological_dilation,3,2
0X718F2A065EA36E9E.avi,18,1346,998,348,34.86973947895792,morphological_dilation,3,2
0X7192B220A4F9B614.avi,0,1955,1575,380,24.126984126984127,morphological_dilation,3,2
0X7192B220A4F9B614.avi,17,1218,918,300,32.6797385620915,morphological_dilation,3,2
0X719610DCE293C29B.avi,95,1935,1531,404,26.3879817112998,morphological_dilation,3,2
0X719610DCE293C29B.avi,109,1282,928,354,38.146551724137936,morphological_dilation,3,2
0X719ADE4E464DE956.avi,39,990,686,304,44.31486880466473,morphological_dilation,3,2
0X719ADE4E464DE956.avi,54,568,340,228,67.05882352941175,morphological_dilation,3,2
0X719F5441F4D7F772.avi,161,2036,1632,404,24.754901960784316,morphological_dilation,3,2
0X719F5441F4D7F772.avi,177,1168,840,328,39.04761904761905,morphological_dilation,3,2
0X71A140B2F6A6062F.avi,60,1009,729,280,38.40877914951989,morphological_dilation,3,2
0X71A140B2F6A6062F.avi,72,610,376,234,62.23404255319149,morphological_dilation,3,2
0X71A38FBA15CAA56E.avi,74,1131,807,324,40.14869888475837,morphological_dilation,3,2
0X71A38FBA15CAA56E.avi,92,716,440,276,62.727272727272734,morphological_dilation,3,2
0X71A68ED541CAFABD.avi,30,1564,1216,348,28.618421052631575,morphological_dilation,3,2
0X71A68ED541CAFABD.avi,47,982,706,276,39.09348441926346,morphological_dilation,3,2
0X71A79CF4AE112004.avi,164,2302,1836,466,25.381263616557735,morphological_dilation,3,2
0X71A79CF4AE112004.avi,183,1299,943,356,37.75185577942736,morphological_dilation,3,2
0X71B1D648746922B0.avi,58,2196,1760,436,24.772727272727273,morphological_dilation,3,2
0X71B1D648746922B0.avi,82,1601,1225,376,30.69387755102041,morphological_dilation,3,2
0X71B423886D8BB117.avi,48,2349,1901,448,23.566543924250393,morphological_dilation,3,2
0X71B423886D8BB117.avi,64,1550,1178,372,31.57894736842105,morphological_dilation,3,2
0X71B7B5A51EB88F54.avi,4,1389,1061,328,30.914231856738926,morphological_dilation,3,2
0X71B7B5A51EB88F54.avi,13,990,711,279,39.24050632911392,morphological_dilation,3,2
0X71B8479C56197371.avi,24,2130,1694,436,25.737898465171195,morphological_dilation,3,2
0X71B8479C56197371.avi,39,1357,1021,336,32.90891283055827,morphological_dilation,3,2
0X71BB6DF9BBBA718F.avi,52,1443,1107,336,30.35230352303523,morphological_dilation,3,2
0X71BB6DF9BBBA718F.avi,69,955,679,276,40.6480117820324,morphological_dilation,3,2
0X71BC28A1041B6981.avi,41,1517,1129,388,34.366696191319754,morphological_dilation,3,2
0X71BC28A1041B6981.avi,57,957,641,316,49.297971918876755,morphological_dilation,3,2
0X71BECC036C3DD693.avi,53,2572,2124,448,21.092278719397363,morphological_dilation,3,2
0X71BECC036C3DD693.avi,69,2166,1758,408,23.208191126279864,morphological_dilation,3,2
0X71C37D3E936D08DA.avi,106,1306,966,340,35.196687370600415,morphological_dilation,3,2
0X71C37D3E936D08DA.avi,122,770,510,260,50.98039215686274,morphological_dilation,3,2
0X71C8CFCE2B3483F6.avi,123,1688,1320,368,27.878787878787882,morphological_dilation,3,2
0X71C8CFCE2B3483F6.avi,139,964,692,272,39.30635838150289,morphological_dilation,3,2
0X71C9BD7600883FA3.avi,47,1726,1346,380,28.231797919762258,morphological_dilation,3,2
0X71C9BD7600883FA3.avi,60,1172,848,324,38.20754716981132,morphological_dilation,3,2
0X71CAB00A955A0BB7.avi,103,2284,1856,428,23.060344827586206,morphological_dilation,3,2
0X71CAB00A955A0BB7.avi,123,1425,1085,340,31.336405529953915,morphological_dilation,3,2
0X71CEA697EC901543.avi,69,1672,1300,372,28.615384615384613,morphological_dilation,3,2
0X71CEA697EC901543.avi,85,1065,757,308,40.686922060766186,morphological_dilation,3,2
0X71D3E92F0E283A45.avi,41,1913,1537,376,24.46324007807417,morphological_dilation,3,2
0X71D3E92F0E283A45.avi,57,1447,1091,356,32.630614115490374,morphological_dilation,3,2
0X71DA17261425414F.avi,77,2463,2003,460,22.965551672491262,morphological_dilation,3,2
0X71DA17261425414F.avi,95,1356,992,364,36.693548387096776,morphological_dilation,3,2
0X71DB4E0E745B22D4.avi,88,1480,1132,348,30.742049469964666,morphological_dilation,3,2
0X71DB4E0E745B22D4.avi,103,984,688,296,43.02325581395349,morphological_dilation,3,2
0X71EBD87DBF90BC93.avi,145,3063,2555,508,19.882583170254403,morphological_dilation,3,2
0X71EBD87DBF90BC93.avi,158,1971,1515,456,30.099009900990097,morphological_dilation,3,2
0X71ECEE29C97C0292.avi,37,1812,1436,376,26.18384401114206,morphological_dilation,3,2
0X71ECEE29C97C0292.avi,50,1278,954,324,33.9622641509434,morphological_dilation,3,2
0X71EE3626BC57AB55.avi,26,2597,2121,476,22.442244224422442,morphological_dilation,3,2
0X71EE3626BC57AB55.avi,41,1817,1417,400,28.228652081863093,morphological_dilation,3,2
0X71F4D803A9CE35AA.avi,60,2053,1657,396,23.898611949305977,morphological_dilation,3,2
0X71F4D803A9CE35AA.avi,73,1688,1332,356,26.726726726726728,morphological_dilation,3,2
0X71F6ECDFB811C998.avi,89,2193,1777,416,23.410241980866626,morphological_dilation,3,2
0X71F6ECDFB811C998.avi,108,1535,1179,356,30.195080576759963,morphological_dilation,3,2
0X71F7F25CC893F72.avi,2,1284,956,328,34.30962343096235,morphological_dilation,3,2
0X71F7F25CC893F72.avi,9,891,591,300,50.76142131979695,morphological_dilation,3,2
0X71F9AA38B454A66A.avi,116,1527,1187,340,28.64363942712721,morphological_dilation,3,2
0X71F9AA38B454A66A.avi,132,955,679,276,40.6480117820324,morphological_dilation,3,2
0X71FB4521E8DC4E3D.avi,95,1742,1346,396,29.420505200594356,morphological_dilation,3,2
0X71FB4521E8DC4E3D.avi,109,1257,911,346,37.980241492864984,morphological_dilation,3,2
0X71FB4930667AD953.avi,44,1767,1367,400,29.261155815654718,morphological_dilation,3,2
0X71FB4930667AD953.avi,60,1040,729,311,42.661179698216735,morphological_dilation,3,2
0X71FE0206D64EDD39.avi,48,1850,1450,400,27.586206896551722,morphological_dilation,3,2
0X71FE0206D64EDD39.avi,72,1384,1016,368,36.22047244094488,morphological_dilation,3,2
0X720404AB389CDF96.avi,123,1775,1395,380,27.24014336917563,morphological_dilation,3,2
0X720404AB389CDF96.avi,136,1165,845,320,37.8698224852071,morphological_dilation,3,2
0X720443862A5F44D4.avi,95,2573,2093,480,22.933588150979457,morphological_dilation,3,2
0X720443862A5F44D4.avi,112,1594,1181,413,34.97036409822184,morphological_dilation,3,2
0X7204B716FE2009EA.avi,32,1492,1128,364,32.269503546099294,morphological_dilation,3,2
0X7204B716FE2009EA.avi,44,984,672,312,46.42857142857143,morphological_dilation,3,2
0X720E0C79D9B2B018.avi,141,1680,1306,374,28.637059724349157,morphological_dilation,3,2
0X720E0C79D9B2B018.avi,158,1113,809,304,37.57725587144623,morphological_dilation,3,2
0X720F9F5DA429C676.avi,0,1433,1097,336,30.628988149498632,morphological_dilation,3,2
0X720F9F5DA429C676.avi,17,875,599,276,46.07679465776294,morphological_dilation,3,2
0X7211958526AE3A51.avi,166,1313,967,346,35.780765253360904,morphological_dilation,3,2
0X7211958526AE3A51.avi,182,822,548,274,50.0,morphological_dilation,3,2
0X7218A5217E8BA6E5.avi,45,1984,1596,388,24.31077694235589,morphological_dilation,3,2
0X7218A5217E8BA6E5.avi,61,1232,920,312,33.91304347826087,morphological_dilation,3,2
0X721A90EE2322377A.avi,42,1621,1269,352,27.73837667454689,morphological_dilation,3,2
0X721A90EE2322377A.avi,61,1082,774,308,39.79328165374677,morphological_dilation,3,2
0X72227A5D210CFA13.avi,79,2549,2085,464,22.25419664268585,morphological_dilation,3,2
0X72227A5D210CFA13.avi,93,1803,1417,386,27.240649258997884,morphological_dilation,3,2
0X72247857F10306AE.avi,82,1047,767,280,36.50586701434159,morphological_dilation,3,2
0X72247857F10306AE.avi,101,676,432,244,56.481481481481474,morphological_dilation,3,2
0X7230B41AA70ED90D.avi,103,1326,1010,316,31.287128712871286,morphological_dilation,3,2
0X7230B41AA70ED90D.avi,121,901,633,268,42.338072669826225,morphological_dilation,3,2
0X7234FFD3D26F08F1.avi,99,1287,955,332,34.76439790575917,morphological_dilation,3,2
0X7234FFD3D26F08F1.avi,110,756,496,260,52.41935483870967,morphological_dilation,3,2
0X723DEBB24B6737BD.avi,46,2408,1948,460,23.613963039014372,morphological_dilation,3,2
0X723DEBB24B6737BD.avi,61,1463,1083,380,35.08771929824561,morphological_dilation,3,2
0X7244FC1F0267202F.avi,45,1975,1571,404,25.716104392106935,morphological_dilation,3,2
0X7244FC1F0267202F.avi,59,1556,1192,364,30.536912751677853,morphological_dilation,3,2
0X7246713ACDF6B2E.avi,70,1363,1029,334,32.458697764820215,morphological_dilation,3,2
0X7246713ACDF6B2E.avi,87,866,588,278,47.27891156462585,morphological_dilation,3,2
0X7246B70B391D7CED.avi,1,1477,1133,344,30.36187113857017,morphological_dilation,3,2
0X7246B70B391D7CED.avi,17,1046,697,349,50.07173601147776,morphological_dilation,3,2
0X7254D04113C8EA7F.avi,94,1669,1305,364,27.892720306513407,morphological_dilation,3,2
0X7254D04113C8EA7F.avi,109,1240,924,316,34.1991341991342,morphological_dilation,3,2
0X7258541793A94047.avi,8,1514,1162,352,30.292598967297764,morphological_dilation,3,2
0X7258541793A94047.avi,18,1186,866,320,36.95150115473441,morphological_dilation,3,2
0X725B0209DBD7F41B.avi,148,2216,1772,444,25.056433408577877,morphological_dilation,3,2
0X725B0209DBD7F41B.avi,165,1812,1400,412,29.428571428571427,morphological_dilation,3,2
0X725C7955468D7BAA.avi,93,1796,1393,403,28.930366116295765,morphological_dilation,3,2
0X725C7955468D7BAA.avi,119,1457,1087,370,34.038638454461825,morphological_dilation,3,2
0X725F2E47573B3648.avi,108,1777,1377,400,29.048656499636895,morphological_dilation,3,2
0X725F2E47573B3648.avi,130,1272,940,332,35.319148936170215,morphological_dilation,3,2
0X72611744EE97633F.avi,115,1837,1442,395,27.392510402219138,morphological_dilation,3,2
0X72611744EE97633F.avi,131,1210,881,329,37.3439273552781,morphological_dilation,3,2
0X726340B293ADED52.avi,47,1331,987,344,34.853090172239106,morphological_dilation,3,2
0X726340B293ADED52.avi,62,826,544,282,51.83823529411765,morphological_dilation,3,2
0X72641E8B44DDA6E3.avi,113,1289,957,332,34.69174503657263,morphological_dilation,3,2
0X72641E8B44DDA6E3.avi,123,829,549,280,51.001821493624774,morphological_dilation,3,2
0X72669FE268B8CA29.avi,103,1368,1028,340,33.07392996108949,morphological_dilation,3,2
0X72669FE268B8CA29.avi,122,796,544,252,46.32352941176471,morphological_dilation,3,2
0X72685B35200F4C48.avi,52,1871,1479,392,26.504394861392832,morphological_dilation,3,2
0X72685B35200F4C48.avi,67,1211,899,312,34.705228031145715,morphological_dilation,3,2
0X726967D49A9BD73A.avi,50,2259,1828,431,23.577680525164112,morphological_dilation,3,2
0X726967D49A9BD73A.avi,66,1946,1550,396,25.548387096774196,morphological_dilation,3,2
0X727106F39B6E611E.avi,30,1770,1394,376,26.97274031563845,morphological_dilation,3,2
0X727106F39B6E611E.avi,46,1136,808,328,40.5940594059406,morphological_dilation,3,2
0X7273C017B303827B.avi,108,1905,1517,388,25.576796308503624,morphological_dilation,3,2
0X7273C017B303827B.avi,126,1196,864,332,38.425925925925924,morphological_dilation,3,2
0X7273D2DCA14BFE52.avi,197,2252,1808,444,24.557522123893804,morphological_dilation,3,2
0X7273D2DCA14BFE52.avi,211,1673,1293,380,29.389017788089717,morphological_dilation,3,2
0X727574CAF516696A.avi,94,2123,1687,436,25.84469472436278,morphological_dilation,3,2
0X727574CAF516696A.avi,111,1250,898,352,39.198218262806236,morphological_dilation,3,2
0X728343B49BC0BC70.avi,121,1749,1340,409,30.522388059701495,morphological_dilation,3,2
0X728343B49BC0BC70.avi,135,971,649,322,49.61479198767334,morphological_dilation,3,2
0X72858D35CFD4490A.avi,50,2404,1972,432,21.906693711967545,morphological_dilation,3,2
0X72858D35CFD4490A.avi,68,1562,1210,352,29.09090909090909,morphological_dilation,3,2
0X728647F593EBCFED.avi,44,2965,2465,500,20.28397565922921,morphological_dilation,3,2
0X728647F593EBCFED.avi,64,1758,1342,416,30.998509687034275,morphological_dilation,3,2
0X72868EA70E22F4F6.avi,2,1405,1073,332,30.941286113699906,morphological_dilation,3,2
0X72868EA70E22F4F6.avi,20,858,582,276,47.42268041237113,morphological_dilation,3,2
0X72890FDB8C6E5396.avi,87,1314,990,324,32.72727272727273,morphological_dilation,3,2
0X72890FDB8C6E5396.avi,104,830,554,276,49.81949458483754,morphological_dilation,3,2
0X728966175618192B.avi,4,1991,1599,392,24.515322076297686,morphological_dilation,3,2
0X728966175618192B.avi,27,1267,935,332,35.50802139037433,morphological_dilation,3,2
0X728D7EF689FADA01.avi,154,2670,2215,455,20.54176072234763,morphological_dilation,3,2
0X728D7EF689FADA01.avi,172,1471,1131,340,30.061892130857647,morphological_dilation,3,2
0X7299D46E48AD3C37.avi,70,1974,1570,404,25.73248407643312,morphological_dilation,3,2
0X7299D46E48AD3C37.avi,91,1314,966,348,36.024844720496894,morphological_dilation,3,2
0X729CBDBABBA099C1.avi,38,1457,1117,340,30.43867502238138,morphological_dilation,3,2
0X729CBDBABBA099C1.avi,55,873,597,276,46.231155778894475,morphological_dilation,3,2
0X729CD3050F8450DF.avi,82,1808,1424,384,26.96629213483146,morphological_dilation,3,2
0X729CD3050F8450DF.avi,94,1094,782,312,39.89769820971867,morphological_dilation,3,2
0X72A32C36FF4B3157.avi,91,1325,997,328,32.89869608826479,morphological_dilation,3,2
0X72A32C36FF4B3157.avi,105,913,629,284,45.151033386327505,morphological_dilation,3,2
0X72A626C96C71FCC.avi,53,1603,1231,372,30.219333874898457,morphological_dilation,3,2
0X72A626C96C71FCC.avi,74,1053,729,324,44.44444444444444,morphological_dilation,3,2
0X72A8D28B7FB9F369.avi,43,1885,1469,416,28.31858407079646,morphological_dilation,3,2
0X72A8D28B7FB9F369.avi,61,976,668,308,46.10778443113773,morphological_dilation,3,2
0X72A9BD119B9C7C5E.avi,76,1347,1015,332,32.70935960591133,morphological_dilation,3,2
0X72A9BD119B9C7C5E.avi,95,877,573,304,53.054101221640494,morphological_dilation,3,2
0X72AC2AF862DED456.avi,76,1942,1534,408,26.597131681877446,morphological_dilation,3,2
0X72AC2AF862DED456.avi,92,1210,882,328,37.188208616780045,morphological_dilation,3,2
0X72AFD8330D1A2378.avi,36,1925,1545,380,24.59546925566343,morphological_dilation,3,2
0X72AFD8330D1A2378.avi,47,1785,1417,368,25.970359915314045,morphological_dilation,3,2
0X72B134B9DB954CE0.avi,42,3591,3011,580,19.262703420790437,morphological_dilation,3,2
0X72B134B9DB954CE0.avi,66,1786,1378,408,29.60812772133527,morphological_dilation,3,2
0X72B2D4A1633D4D14.avi,0,2522,2062,460,22.30843840931135,morphological_dilation,3,2
0X72B2D4A1633D4D14.avi,14,1515,1123,392,34.90650044523598,morphological_dilation,3,2
0X72B3B527971FE713.avi,52,2206,1786,420,23.516237402015676,morphological_dilation,3,2
0X72B3B527971FE713.avi,71,1403,1055,348,32.98578199052133,morphological_dilation,3,2
0X72B520E2CC016AC4.avi,134,2750,2266,484,21.35922330097087,morphological_dilation,3,2
0X72B520E2CC016AC4.avi,152,1646,1254,392,31.259968102073366,morphological_dilation,3,2
0X72BA22CA9CD1AEDD.avi,3,1354,1018,336,33.00589390962672,morphological_dilation,3,2
0X72BA22CA9CD1AEDD.avi,21,781,509,272,53.43811394891945,morphological_dilation,3,2
0X72BE557C5F55572B.avi,50,1269,953,316,33.15844700944386,morphological_dilation,3,2
0X72BE557C5F55572B.avi,68,859,587,272,46.33730834752981,morphological_dilation,3,2
0X72BF8A29F8CF0359.avi,50,1934,1518,416,27.40447957839262,morphological_dilation,3,2
0X72BF8A29F8CF0359.avi,68,1104,768,336,43.75,morphological_dilation,3,2
0X72C39CB9185ABCB3.avi,136,3345,2769,576,20.801733477789817,morphological_dilation,3,2
0X72C39CB9185ABCB3.avi,156,2147,1622,525,32.36744759556103,morphological_dilation,3,2
0X72C54782C645967A.avi,46,1412,1082,330,30.499075785582253,morphological_dilation,3,2
0X72C54782C645967A.avi,63,1045,769,276,35.890767230169054,morphological_dilation,3,2
0X72CA19464A24E2B5.avi,51,1278,950,328,34.526315789473685,morphological_dilation,3,2
0X72CA19464A24E2B5.avi,69,757,470,287,61.06382978723405,morphological_dilation,3,2
0X72CDA4DD9AD5C01E.avi,119,2059,1659,400,24.110910186859556,morphological_dilation,3,2
0X72CDA4DD9AD5C01E.avi,137,1330,1002,328,32.734530938123754,morphological_dilation,3,2
0X72D0449A54F721F.avi,137,2222,1806,416,23.034330011074196,morphological_dilation,3,2
0X72D0449A54F721F.avi,159,1556,1184,372,31.41891891891892,morphological_dilation,3,2
0X72D31B9B3CD67721.avi,96,1102,810,292,36.04938271604938,morphological_dilation,3,2
0X72D31B9B3CD67721.avi,111,821,561,260,46.3458110516934,morphological_dilation,3,2
0X72D980B0EF1D8FA4.avi,1,1779,1393,386,27.70997846374731,morphological_dilation,3,2
0X72D980B0EF1D8FA4.avi,14,1288,948,340,35.86497890295359,morphological_dilation,3,2
0X72DB58A40280753B.avi,51,1479,1103,376,34.08884859474162,morphological_dilation,3,2
0X72DB58A40280753B.avi,68,876,584,292,50.0,morphological_dilation,3,2
0X72E13FF47AEEAE04.avi,1,2414,1936,478,24.6900826446281,morphological_dilation,3,2
0X72E13FF47AEEAE04.avi,18,1365,1001,364,36.36363636363637,morphological_dilation,3,2
0X72E41E49681C6CEB.avi,55,1339,999,340,34.034034034034036,morphological_dilation,3,2
0X72E41E49681C6CEB.avi,72,1095,780,315,40.38461538461539,morphological_dilation,3,2
0X72E86E75402DEFAD.avi,151,1244,932,312,33.47639484978541,morphological_dilation,3,2
0X72E86E75402DEFAD.avi,166,715,483,232,48.033126293995856,morphological_dilation,3,2
0X72F46FF82263E9BB.avi,99,2210,1783,427,23.948401570386988,morphological_dilation,3,2
0X72F46FF82263E9BB.avi,115,1277,922,355,38.50325379609544,morphological_dilation,3,2
0X72F90AFD1A6DC3F5.avi,107,2197,1789,408,22.806036892118502,morphological_dilation,3,2
0X72F90AFD1A6DC3F5.avi,127,1532,1192,340,28.523489932885905,morphological_dilation,3,2
0X72FBB4E0E2561747.avi,57,1264,956,308,32.21757322175732,morphological_dilation,3,2
0X72FBB4E0E2561747.avi,75,803,531,272,51.2241054613936,morphological_dilation,3,2
0X72FBDAE8D9EF8D0E.avi,65,1908,1528,380,24.86910994764398,morphological_dilation,3,2
0X72FBDAE8D9EF8D0E.avi,79,1791,1423,368,25.8608573436402,morphological_dilation,3,2
0X7302018616588BE1.avi,92,1320,972,348,35.80246913580247,morphological_dilation,3,2
0X7302018616588BE1.avi,107,825,537,288,53.63128491620112,morphological_dilation,3,2
0X7302BA5E11336B0D.avi,52,1879,1483,396,26.70262980445044,morphological_dilation,3,2
0X7302BA5E11336B0D.avi,69,1149,813,336,41.32841328413284,morphological_dilation,3,2
0X730370D5459157D2.avi,114,1505,1145,360,31.4410480349345,morphological_dilation,3,2
0X730370D5459157D2.avi,131,912,620,292,47.096774193548384,morphological_dilation,3,2
0X7306CC1667084C19.avi,64,1538,1174,364,31.005110732538334,morphological_dilation,3,2
0X7306CC1667084C19.avi,76,907,619,288,46.52665589660743,morphological_dilation,3,2
0X7307134A5F851D7B.avi,30,1391,1063,328,30.85606773283161,morphological_dilation,3,2
0X7307134A5F851D7B.avi,47,940,652,288,44.171779141104295,morphological_dilation,3,2
0X730D323F56D3D95B.avi,4,1778,1399,379,27.090779127948533,morphological_dilation,3,2
0X730D323F56D3D95B.avi,21,1138,838,300,35.79952267303103,morphological_dilation,3,2
0X7310ACB3B6BDAEB0.avi,126,2381,1921,460,23.945861530452888,morphological_dilation,3,2
0X7310ACB3B6BDAEB0.avi,148,1496,1112,384,34.53237410071942,morphological_dilation,3,2
0X7313C9F94735726B.avi,80,1753,1381,372,26.937002172338886,morphological_dilation,3,2
0X7313C9F94735726B.avi,96,1045,729,316,43.34705075445816,morphological_dilation,3,2
0X73157CDC07CC521A.avi,51,1773,1397,376,26.91481746599857,morphological_dilation,3,2
0X73157CDC07CC521A.avi,70,1105,797,308,38.64491844416562,morphological_dilation,3,2
0X731BBCC68C30384D.avi,71,2119,1695,424,25.014749262536874,morphological_dilation,3,2
0X731BBCC68C30384D.avi,84,1404,1052,352,33.460076045627375,morphological_dilation,3,2
0X731CE25F892AF5.avi,0,1740,1356,384,28.31858407079646,morphological_dilation,3,2
0X731CE25F892AF5.avi,18,964,651,313,48.07987711213518,morphological_dilation,3,2
0X7320E95D3BDA1C67.avi,46,2227,1767,460,26.032823995472555,morphological_dilation,3,2
0X7320E95D3BDA1C67.avi,61,1257,901,356,39.51165371809101,morphological_dilation,3,2
0X73216341691AED3F.avi,65,1701,1322,379,28.668683812405447,morphological_dilation,3,2
0X73216341691AED3F.avi,81,1104,784,320,40.816326530612244,morphological_dilation,3,2
0X7321C0F7FDA48773.avi,58,1909,1525,384,25.18032786885246,morphological_dilation,3,2
0X7321C0F7FDA48773.avi,78,1149,841,308,36.623067776456594,morphological_dilation,3,2
0X7323E0F1366BE491.avi,49,1453,1109,344,31.01893597835888,morphological_dilation,3,2
0X7323E0F1366BE491.avi,69,945,665,280,42.10526315789473,morphological_dilation,3,2
0X7327A7A5AD3EAF3A.avi,40,2650,2178,472,21.671258034894397,morphological_dilation,3,2
0X7327A7A5AD3EAF3A.avi,57,2085,1653,432,26.13430127041742,morphological_dilation,3,2
0X7327AFFC293E3F3E.avi,107,1132,820,312,38.048780487804876,morphological_dilation,3,2
0X7327AFFC293E3F3E.avi,127,710,434,276,63.594470046082954,morphological_dilation,3,2
0X73283509266FA479.avi,46,1448,1112,336,30.215827338129497,morphological_dilation,3,2
0X73283509266FA479.avi,58,1187,891,296,33.221099887766556,morphological_dilation,3,2
0X7329DF92A352EC62.avi,52,2624,2141,483,22.559551611396543,morphological_dilation,3,2
0X7329DF92A352EC62.avi,67,2150,1707,443,25.95196250732279,morphological_dilation,3,2
0X7334E8F890A16192.avi,53,1983,1555,428,27.524115755627008,morphological_dilation,3,2
0X7334E8F890A16192.avi,68,1176,848,328,38.67924528301887,morphological_dilation,3,2
0X7337462DDC2B8F16.avi,68,2470,2022,448,22.15628090999011,morphological_dilation,3,2
0X7337462DDC2B8F16.avi,88,1569,1189,380,31.959629941126998,morphological_dilation,3,2
0X733DE78E141F8487.avi,63,2024,1634,390,23.867809057527538,morphological_dilation,3,2
0X733DE78E141F8487.avi,79,1381,1049,332,31.649189704480456,morphological_dilation,3,2
0X733FE55DDB6B588E.avi,57,1333,992,341,34.375,morphological_dilation,3,2
0X733FE55DDB6B588E.avi,68,833,549,284,51.73041894353369,morphological_dilation,3,2
0X73402C06C929E8EF.avi,161,3442,2870,572,19.930313588850172,morphological_dilation,3,2
0X73402C06C929E8EF.avi,183,2627,2095,532,25.39379474940334,morphological_dilation,3,2
0X734706E202C7BEBE.avi,41,1580,1192,388,32.5503355704698,morphological_dilation,3,2
0X734706E202C7BEBE.avi,53,920,620,300,48.38709677419355,morphological_dilation,3,2
0X73496542C2F1F928.avi,44,1607,1231,376,30.544272948822094,morphological_dilation,3,2
0X73496542C2F1F928.avi,64,1034,714,320,44.81792717086835,morphological_dilation,3,2
0X7349742DCA7B38DF.avi,93,1786,1394,392,28.120516499282637,morphological_dilation,3,2
0X7349742DCA7B38DF.avi,112,1117,797,320,40.150564617314934,morphological_dilation,3,2
0X734CB51813AC8430.avi,38,925,665,260,39.097744360902254,morphological_dilation,3,2
0X734CB51813AC8430.avi,58,577,357,220,61.62464985994398,morphological_dilation,3,2
0X73501E4D51E5DF62.avi,28,1559,1199,360,30.025020850708923,morphological_dilation,3,2
0X73501E4D51E5DF62.avi,42,1014,695,319,45.89928057553957,morphological_dilation,3,2
0X735A2D72D186ABDF.avi,34,1343,1007,336,33.36643495531281,morphological_dilation,3,2
0X735A2D72D186ABDF.avi,50,919,627,292,46.57097288676236,morphological_dilation,3,2
0X735C86AD64E736BF.avi,4,1554,1210,344,28.429752066115704,morphological_dilation,3,2
0X735C86AD64E736BF.avi,13,986,702,284,40.45584045584046,morphological_dilation,3,2
0X735F0DB71E45133F.avi,56,1510,1158,352,30.397236614853195,morphological_dilation,3,2
0X735F0DB71E45133F.avi,71,944,668,276,41.31736526946108,morphological_dilation,3,2
0X735F588BB61D6CAA.avi,51,1411,1075,336,31.25581395348837,morphological_dilation,3,2
0X735F588BB61D6CAA.avi,69,918,634,284,44.79495268138801,morphological_dilation,3,2
0X73612CEEAF383F2D.avi,94,2310,1871,439,23.463388562266168,morphological_dilation,3,2
0X73612CEEAF383F2D.avi,111,1374,1014,360,35.50295857988166,morphological_dilation,3,2
0X7361844FD9363EEA.avi,63,2322,1886,436,23.117709437963946,morphological_dilation,3,2
0X7361844FD9363EEA.avi,86,1446,1082,364,33.64140480591497,morphological_dilation,3,2
0X7363FE8BE097BA58.avi,50,2756,2280,476,20.87719298245614,morphological_dilation,3,2
0X7363FE8BE097BA58.avi,68,1574,1210,364,30.082644628099175,morphological_dilation,3,2
0X7364F152A024A66.avi,47,1581,1205,376,31.203319502074688,morphological_dilation,3,2
0X7364F152A024A66.avi,63,1060,760,300,39.473684210526315,morphological_dilation,3,2
0X736D9AEB697FDDF0.avi,64,1822,1446,376,26.00276625172891,morphological_dilation,3,2
0X736D9AEB697FDDF0.avi,82,1112,796,316,39.698492462311556,morphological_dilation,3,2
0X736E10551271694D.avi,76,1585,1229,356,28.966639544344996,morphological_dilation,3,2
0X736E10551271694D.avi,92,942,654,288,44.03669724770643,morphological_dilation,3,2
0X736ED14581138752.avi,3,1823,1427,396,27.75052557813595,morphological_dilation,3,2
0X736ED14581138752.avi,23,1042,738,304,41.19241192411924,morphological_dilation,3,2
0X73707FBC492E69C7.avi,98,2559,2107,452,21.452301850972948,morphological_dilation,3,2
0X73707FBC492E69C7.avi,114,1657,1285,372,28.949416342412455,morphological_dilation,3,2
0X7374FD2832640365.avi,56,1683,1303,380,29.16346891788181,morphological_dilation,3,2
0X7374FD2832640365.avi,77,1006,702,304,43.3048433048433,morphological_dilation,3,2
0X7378F346BE3CD053.avi,58,1008,716,292,40.78212290502793,morphological_dilation,3,2
0X7378F346BE3CD053.avi,74,598,362,236,65.19337016574586,morphological_dilation,3,2
0X73793EDBF1409C1E.avi,64,2071,1659,412,24.83423749246534,morphological_dilation,3,2
0X73793EDBF1409C1E.avi,80,1379,1019,360,35.328753680078506,morphological_dilation,3,2
0X7381676B84209CF0.avi,0,1758,1366,392,28.69692532942899,morphological_dilation,3,2
0X7381676B84209CF0.avi,17,1393,1010,383,37.92079207920792,morphological_dilation,3,2
0X7384FCD4DDDF9740.avi,164,1890,1498,392,26.168224299065418,morphological_dilation,3,2
0X7384FCD4DDDF9740.avi,178,1220,904,316,34.95575221238938,morphological_dilation,3,2
0X73887804901441E1.avi,133,2303,1879,424,22.56519425226184,morphological_dilation,3,2
0X73887804901441E1.avi,157,1503,1151,352,30.582102519548222,morphological_dilation,3,2
0X73897D7AE3BFB060.avi,115,1659,1295,364,28.10810810810811,morphological_dilation,3,2
0X73897D7AE3BFB060.avi,130,1006,714,292,40.896358543417364,morphological_dilation,3,2
0X7389E32FF1D284E.avi,51,3171,2663,508,19.076229815996996,morphological_dilation,3,2
0X7389E32FF1D284E.avi,68,2788,2308,480,20.797227036395146,morphological_dilation,3,2
0X738BA7947C53A64C.avi,44,3567,3019,548,18.1517058628685,morphological_dilation,3,2
0X738BA7947C53A64C.avi,64,2283,1821,462,25.370675453047774,morphological_dilation,3,2
0X7395A2178B8DD011.avi,158,1891,1483,408,27.5118004045853,morphological_dilation,3,2
0X7395A2178B8DD011.avi,173,1201,869,332,38.204833141542004,morphological_dilation,3,2
0X73995C715F09779B.avi,43,913,641,272,42.43369734789392,morphological_dilation,3,2
0X73995C715F09779B.avi,61,683,427,256,59.95316159250586,morphological_dilation,3,2
0X739DC030F18706BB.avi,5,1354,1006,348,34.59244532803181,morphological_dilation,3,2
0X739DC030F18706BB.avi,18,877,589,288,48.89643463497453,morphological_dilation,3,2
0X73A06B412F7611EA.avi,3,1534,1178,356,30.220713073005097,morphological_dilation,3,2
0X73A06B412F7611EA.avi,19,1001,703,298,42.38975817923186,morphological_dilation,3,2
0X73A4D918B6CA3C90.avi,45,2274,1834,440,23.991275899672846,morphological_dilation,3,2
0X73A4D918B6CA3C90.avi,60,1451,1087,364,33.48666053357866,morphological_dilation,3,2
0X73AD3070008C7EF9.avi,41,1777,1382,395,28.58176555716353,morphological_dilation,3,2
0X73AD3070008C7EF9.avi,57,1291,943,348,36.90349946977731,morphological_dilation,3,2
0X73AF0618B125251B.avi,105,2677,2209,468,21.186057039384337,morphological_dilation,3,2
0X73AF0618B125251B.avi,125,1505,1129,376,33.30380868024801,morphological_dilation,3,2
0X73B655A8FCF9F25B.avi,55,2155,1731,424,24.494511842865396,morphological_dilation,3,2
0X73B655A8FCF9F25B.avi,71,1231,907,324,35.72216097023153,morphological_dilation,3,2
0X73B805054B52B4D0.avi,59,1688,1312,376,28.65853658536585,morphological_dilation,3,2
0X73B805054B52B4D0.avi,74,1105,805,300,37.267080745341616,morphological_dilation,3,2
0X73B810568F40AFE4.avi,44,2707,2219,488,21.99188823794502,morphological_dilation,3,2
0X73B810568F40AFE4.avi,57,1560,1147,413,36.00697471665214,morphological_dilation,3,2
0X73BAB1DA81605904.avi,103,2165,1753,412,23.502567027952082,morphological_dilation,3,2
0X73BAB1DA81605904.avi,131,1338,990,348,35.15151515151515,morphological_dilation,3,2
0X73BDFA9C889E6149.avi,112,1919,1483,436,29.39986513823331,morphological_dilation,3,2
0X73BDFA9C889E6149.avi,132,1047,715,332,46.43356643356643,morphological_dilation,3,2
0X73BFDA4FB4F6235E.avi,43,2827,2283,544,23.828296101620676,morphological_dilation,3,2
0X73BFDA4FB4F6235E.avi,61,1667,1255,412,32.82868525896414,morphological_dilation,3,2
0X73C0839C4D54DBDB.avi,47,2957,2449,508,20.74316047366272,morphological_dilation,3,2
0X73C0839C4D54DBDB.avi,66,1680,1260,420,33.33333333333333,morphological_dilation,3,2
0X73C0AD458889A9FD.avi,60,2188,1744,444,25.458715596330272,morphological_dilation,3,2
0X73C0AD458889A9FD.avi,71,1300,936,364,38.88888888888889,morphological_dilation,3,2
0X73C3FC7FB8A7BC9E.avi,107,2540,2056,484,23.540856031128403,morphological_dilation,3,2
0X73C3FC7FB8A7BC9E.avi,123,1760,1340,420,31.343283582089555,morphological_dilation,3,2
0X73CBCADA2191104C.avi,0,2222,1802,420,23.307436182019977,morphological_dilation,3,2
0X73CBCADA2191104C.avi,17,1599,1227,372,30.317848410757946,morphological_dilation,3,2
0X73CC4E768F5C61D5.avi,2,2034,1630,404,24.785276073619634,morphological_dilation,3,2
0X73CC4E768F5C61D5.avi,26,1247,919,328,35.69096844396083,morphological_dilation,3,2
0X73CC9D0B1F28A704.avi,100,2674,2174,500,22.999080036798528,morphological_dilation,3,2
0X73CC9D0B1F28A704.avi,119,1469,1092,377,34.523809523809526,morphological_dilation,3,2
0X73D0401BA6131E49.avi,56,2797,2305,492,21.344902386117138,morphological_dilation,3,2
0X73D0401BA6131E49.avi,79,1808,1376,432,31.3953488372093,morphological_dilation,3,2
0X73D25D118343CC88.avi,0,1990,1598,392,24.53066332916145,morphological_dilation,3,2
0X73D25D118343CC88.avi,11,1102,786,316,40.20356234096692,morphological_dilation,3,2
0X73D38D822D999A40.avi,46,1354,1002,352,35.12974051896208,morphological_dilation,3,2
0X73D38D822D999A40.avi,71,806,526,280,53.2319391634981,morphological_dilation,3,2
0X73D50DE693F798E3.avi,46,2097,1689,408,24.156305506216697,morphological_dilation,3,2
0X73D50DE693F798E3.avi,65,1333,1005,328,32.63681592039801,morphological_dilation,3,2
0X73DD393CD2CBDE7D.avi,107,1520,1154,366,31.715771230502597,morphological_dilation,3,2
0X73DD393CD2CBDE7D.avi,127,944,644,300,46.58385093167702,morphological_dilation,3,2
0X73E028B05C13AD4C.avi,114,1301,977,324,33.16274309109519,morphological_dilation,3,2
0X73E028B05C13AD4C.avi,130,855,573,282,49.21465968586388,morphological_dilation,3,2
0X73E1750D79C18CE6.avi,47,2002,1606,396,24.65753424657534,morphological_dilation,3,2
0X73E1750D79C18CE6.avi,67,1389,1057,332,31.409649952696313,morphological_dilation,3,2
0X73E20506F6BF4FD6.avi,94,1589,1217,372,30.56696795398521,morphological_dilation,3,2
0X73E20506F6BF4FD6.avi,113,947,639,308,48.200312989045386,morphological_dilation,3,2
0X73E3BB1E0A5DAADB.avi,6,4239,3643,596,16.36014273950041,morphological_dilation,3,2
0X73E3BB1E0A5DAADB.avi,27,2522,2018,504,24.975222993062438,morphological_dilation,3,2
0X73E49B1080094361.avi,99,2197,1741,456,26.19184376794945,morphological_dilation,3,2
0X73E49B1080094361.avi,116,1598,1210,388,32.06611570247934,morphological_dilation,3,2
0X73E7E893FB817BED.avi,40,2190,1774,416,23.449830890642616,morphological_dilation,3,2
0X73E7E893FB817BED.avi,62,1395,1055,340,32.22748815165877,morphological_dilation,3,2
0X73E8465DDBF29918.avi,142,1732,1333,399,29.932483120780194,morphological_dilation,3,2
0X73E8465DDBF29918.avi,158,1023,727,296,40.715268225584595,morphological_dilation,3,2
0X73E9825196EB26F9.avi,3,1718,1354,364,26.88330871491876,morphological_dilation,3,2
0X73E9825196EB26F9.avi,16,1498,1166,332,28.473413379073758,morphological_dilation,3,2
0X73EA8274FC52080F.avi,55,1693,1305,388,29.731800766283524,morphological_dilation,3,2
0X73EA8274FC52080F.avi,75,1002,686,316,46.06413994169096,morphological_dilation,3,2
0X73EB274CEED30582.avi,43,1648,1276,372,29.153605015673982,morphological_dilation,3,2
0X73EB274CEED30582.avi,59,1237,901,336,37.29189789123196,morphological_dilation,3,2
0X73F5C8B7C26ADF0D.avi,46,1448,1092,356,32.6007326007326,morphological_dilation,3,2
0X73F5C8B7C26ADF0D.avi,61,936,644,292,45.3416149068323,morphological_dilation,3,2
0X73F6DA33A9F3A272.avi,46,1277,965,312,32.33160621761658,morphological_dilation,3,2
0X73F6DA33A9F3A272.avi,67,789,537,252,46.927374301675975,morphological_dilation,3,2
0X73F79A58680979D6.avi,48,1579,1215,364,29.958847736625515,morphological_dilation,3,2
0X73F79A58680979D6.avi,63,1055,755,300,39.735099337748345,morphological_dilation,3,2
0X73F7C900EE5F7BDA.avi,77,1823,1447,376,25.984796129923982,morphological_dilation,3,2
0X73F7C900EE5F7BDA.avi,97,1109,813,296,36.40836408364084,morphological_dilation,3,2
0X7402E875B7F92C39.avi,34,1021,741,280,37.7867746288799,morphological_dilation,3,2
0X7402E875B7F92C39.avi,48,702,466,236,50.64377682403433,morphological_dilation,3,2
0X74084E3472EDBC5B.avi,21,1234,938,296,31.556503198294244,morphological_dilation,3,2
0X74084E3472EDBC5B.avi,28,816,556,260,46.76258992805755,morphological_dilation,3,2
0X740B08561D0382B.avi,42,1610,1254,356,28.38915470494418,morphological_dilation,3,2
0X740B08561D0382B.avi,58,1329,1013,316,31.19447186574531,morphological_dilation,3,2
0X740C8D1BB435F52D.avi,81,1347,1023,324,31.671554252199414,morphological_dilation,3,2
0X740C8D1BB435F52D.avi,91,838,562,276,49.11032028469751,morphological_dilation,3,2
0X740C9FC96463133D.avi,50,2095,1667,428,25.674865026994603,morphological_dilation,3,2
0X740C9FC96463133D.avi,72,1209,853,356,41.73505275498242,morphological_dilation,3,2
0X740E3E79F3D8FD83.avi,29,1481,1131,350,30.94606542882405,morphological_dilation,3,2
0X740E3E79F3D8FD83.avi,35,1832,1448,384,26.519337016574585,morphological_dilation,3,2
0X740F540B87B8AF3.avi,83,2203,1767,436,24.674589700056593,morphological_dilation,3,2
0X740F540B87B8AF3.avi,99,1300,964,336,34.85477178423236,morphological_dilation,3,2
0X7411B4F7A67BA8B5.avi,40,2661,2189,472,21.5623572407492,morphological_dilation,3,2
0X7411B4F7A67BA8B5.avi,53,1675,1279,396,30.961688819390147,morphological_dilation,3,2
0X7415C8B1BD8C89F0.avi,22,1734,1374,360,26.200873362445414,morphological_dilation,3,2
0X7415C8B1BD8C89F0.avi,38,1166,858,308,35.8974358974359,morphological_dilation,3,2
0X74179B492A2A5797.avi,151,1488,1152,336,29.166666666666668,morphological_dilation,3,2
0X74179B492A2A5797.avi,165,887,611,276,45.171849427168574,morphological_dilation,3,2
0X741BD841B1FBA276.avi,108,1843,1463,380,25.97402597402597,morphological_dilation,3,2
0X741BD841B1FBA276.avi,125,1376,1048,328,31.297709923664126,morphological_dilation,3,2
0X741BECA9987E71FE.avi,2,1769,1385,384,27.72563176895307,morphological_dilation,3,2
0X741BECA9987E71FE.avi,18,1062,753,309,41.03585657370518,morphological_dilation,3,2
0X74219E2082D4E07C.avi,32,1217,877,340,38.76852907639681,morphological_dilation,3,2
0X74219E2082D4E07C.avi,46,1080,736,344,46.73913043478261,morphological_dilation,3,2
0X74223A9F6F471ABB.avi,50,1929,1521,408,26.82445759368836,morphological_dilation,3,2
0X74223A9F6F471ABB.avi,70,1662,1279,383,29.945269741985925,morphological_dilation,3,2
0X7428DD73E48A8B91.avi,212,1367,1031,336,32.58971871968962,morphological_dilation,3,2
0X7428DD73E48A8B91.avi,237,766,494,272,55.06072874493927,morphological_dilation,3,2
0X74370D9F34D1B158.avi,3,1606,1254,352,28.07017543859649,morphological_dilation,3,2
0X74370D9F34D1B158.avi,20,993,715,278,38.88111888111888,morphological_dilation,3,2
0X743DC850101325BA.avi,108,1511,1147,364,31.734960767218833,morphological_dilation,3,2
0X743DC850101325BA.avi,123,960,648,312,48.148148148148145,morphological_dilation,3,2
0X743ED9E602F4C401.avi,0,2304,1888,416,22.033898305084744,morphological_dilation,3,2
0X743ED9E602F4C401.avi,11,1246,934,312,33.40471092077088,morphological_dilation,3,2
0X7442C6F159E69F2C.avi,52,2063,1655,408,24.652567975830816,morphological_dilation,3,2
0X7442C6F159E69F2C.avi,72,1372,1020,352,34.509803921568626,morphological_dilation,3,2
0X744318292E6F77CD.avi,164,1704,1305,399,30.574712643678158,morphological_dilation,3,2
0X744318292E6F77CD.avi,177,987,666,321,48.1981981981982,morphological_dilation,3,2
0X744867670A05CAB6.avi,40,1266,930,336,36.12903225806451,morphological_dilation,3,2
0X744867670A05CAB6.avi,54,791,507,284,56.01577909270217,morphological_dilation,3,2
0X744B061341172EE8.avi,34,1485,1101,384,34.87738419618528,morphological_dilation,3,2
0X744B061341172EE8.avi,47,859,575,284,49.391304347826086,morphological_dilation,3,2
0X744B44C9E0FAB522.avi,51,2885,2381,504,21.167576648467033,morphological_dilation,3,2
0X744B44C9E0FAB522.avi,68,1631,1230,401,32.60162601626016,morphological_dilation,3,2
0X744CE89425556B93.avi,37,1348,992,356,35.88709677419355,morphological_dilation,3,2
0X744CE89425556B93.avi,53,899,597,302,50.58626465661642,morphological_dilation,3,2
0X744E923850EFD4BA.avi,34,2833,2365,468,19.788583509513742,morphological_dilation,3,2
0X744E923850EFD4BA.avi,50,2549,2097,452,21.55460181211254,morphological_dilation,3,2
0X74582CAF1FE19301.avi,80,1539,1183,356,30.092983939137785,morphological_dilation,3,2
0X74582CAF1FE19301.avi,92,1114,798,316,39.59899749373433,morphological_dilation,3,2
0X74596DA2E143D6B6.avi,43,1563,1203,360,29.925187032418954,morphological_dilation,3,2
0X74596DA2E143D6B6.avi,55,996,700,296,42.285714285714285,morphological_dilation,3,2
0X745E6D6BDDF80DCD.avi,0,2859,2383,476,19.974821653378093,morphological_dilation,3,2
0X745E6D6BDDF80DCD.avi,21,1654,1294,360,27.820710973724882,morphological_dilation,3,2
0X746492156F4D1DBA.avi,39,1705,1329,376,28.291948833709558,morphological_dilation,3,2
0X746492156F4D1DBA.avi,59,1103,795,308,38.742138364779876,morphological_dilation,3,2
0X746834EDB4528A59.avi,72,1205,897,308,34.33667781493868,morphological_dilation,3,2
0X746834EDB4528A59.avi,87,767,514,253,49.221789883268485,morphological_dilation,3,2
0X746AE949330474EF.avi,130,2791,2291,500,21.82453077258839,morphological_dilation,3,2
0X746AE949330474EF.avi,150,2226,1806,420,23.25581395348837,morphological_dilation,3,2
0X746F499A43B6E4FF.avi,51,2177,1759,418,23.763501989766915,morphological_dilation,3,2
0X746F499A43B6E4FF.avi,67,1670,1294,376,29.057187017001546,morphological_dilation,3,2
0X74730225B5BBF275.avi,50,2318,1850,468,25.2972972972973,morphological_dilation,3,2
0X74730225B5BBF275.avi,70,1510,1097,413,37.64813126709207,morphological_dilation,3,2
0X7476874DC8F10D2A.avi,81,2120,1712,408,23.83177570093458,morphological_dilation,3,2
0X7476874DC8F10D2A.avi,105,1413,1061,352,33.17624882186617,morphological_dilation,3,2
0X7479583EA6499D94.avi,49,1864,1460,404,27.671232876712327,morphological_dilation,3,2
0X7479583EA6499D94.avi,69,1157,845,312,36.92307692307693,morphological_dilation,3,2
0X747A2BD26A77088C.avi,54,1712,1336,376,28.143712574850298,morphological_dilation,3,2
0X747A2BD26A77088C.avi,72,1086,778,308,39.588688946015424,morphological_dilation,3,2
0X7484EE46AD3659CC.avi,36,2411,1983,428,21.58345940494201,morphological_dilation,3,2
0X7484EE46AD3659CC.avi,55,1579,1219,360,29.532403609515995,morphological_dilation,3,2
0X748CE60009AB49AB.avi,49,1695,1311,384,29.290617848970253,morphological_dilation,3,2
0X748CE60009AB49AB.avi,67,1074,754,320,42.44031830238727,morphological_dilation,3,2
0X748F2E7A97DCC6E5.avi,66,1540,1192,348,29.194630872483224,morphological_dilation,3,2
0X748F2E7A97DCC6E5.avi,80,940,646,294,45.51083591331269,morphological_dilation,3,2
0X74900986127D0528.avi,0,2290,1870,420,22.459893048128343,morphological_dilation,3,2
0X74900986127D0528.avi,21,1677,1321,356,26.949280847842545,morphological_dilation,3,2
0X7495513F82B76105.avi,69,2327,1839,488,26.536160957041872,morphological_dilation,3,2
0X7495513F82B76105.avi,82,1355,902,453,50.22172949002217,morphological_dilation,3,2
0X749761A9AF29C863.avi,95,1484,1128,356,31.560283687943265,morphological_dilation,3,2
0X749761A9AF29C863.avi,113,990,672,318,47.32142857142857,morphological_dilation,3,2
0X7498BD710B94CF12.avi,84,1828,1436,392,27.298050139275766,morphological_dilation,3,2
0X7498BD710B94CF12.avi,103,1227,883,344,38.95809739524349,morphological_dilation,3,2
0X74A2D8CA7E7F14E.avi,70,1811,1379,432,31.327048585931834,morphological_dilation,3,2
0X74A2D8CA7E7F14E.avi,84,1469,1085,384,35.39170506912443,morphological_dilation,3,2
0X74A50C8DEAF4CBA8.avi,88,2362,1922,440,22.892819979188346,morphological_dilation,3,2
0X74A50C8DEAF4CBA8.avi,103,1809,1413,396,28.02547770700637,morphological_dilation,3,2
0X74A8521201588DDE.avi,79,918,658,260,39.51367781155015,morphological_dilation,3,2
0X74A8521201588DDE.avi,94,642,402,240,59.70149253731343,morphological_dilation,3,2
0X74A87351D519ABBB.avi,32,3033,2553,480,18.80141010575793,morphological_dilation,3,2
0X74A87351D519ABBB.avi,43,2896,2416,480,19.867549668874172,morphological_dilation,3,2
0X74AE577182FB112A.avi,60,1762,1350,412,30.518518518518515,morphological_dilation,3,2
0X74AE577182FB112A.avi,79,1115,771,344,44.61738002594034,morphological_dilation,3,2
0X74AF472F5C3E02A4.avi,77,2092,1680,412,24.523809523809522,morphological_dilation,3,2
0X74AF472F5C3E02A4.avi,89,1309,965,344,35.64766839378238,morphological_dilation,3,2
0X74AFC03F1383C4A.avi,48,1638,1278,360,28.169014084507044,morphological_dilation,3,2
0X74AFC03F1383C4A.avi,64,1209,889,320,35.9955005624297,morphological_dilation,3,2
0X74B46A261E8088EA.avi,66,3406,2894,512,17.69177608845888,morphological_dilation,3,2
0X74B46A261E8088EA.avi,78,3004,2512,492,19.5859872611465,morphological_dilation,3,2
0X74B4D8E3459FFF7C.avi,71,1507,1147,360,31.386224934612034,morphological_dilation,3,2
0X74B4D8E3459FFF7C.avi,90,995,679,316,46.53902798232695,morphological_dilation,3,2
0X74B54899CC2CFB7B.avi,139,1742,1354,388,28.65583456425406,morphological_dilation,3,2
0X74B54899CC2CFB7B.avi,156,996,692,304,43.93063583815029,morphological_dilation,3,2
0X74B6576AF56AECD4.avi,37,1312,976,336,34.42622950819672,morphological_dilation,3,2
0X74B6576AF56AECD4.avi,44,772,508,264,51.96850393700787,morphological_dilation,3,2
0X74B8D224405BA094.avi,28,2277,1822,455,24.972557628979146,morphological_dilation,3,2
0X74B8D224405BA094.avi,44,1368,1008,360,35.714285714285715,morphological_dilation,3,2
0X74C3D288B3E288B9.avi,65,1409,1081,328,30.3422756706753,morphological_dilation,3,2
0X74C3D288B3E288B9.avi,77,922,654,268,40.97859327217125,morphological_dilation,3,2
0X74C54B277B5B012A.avi,71,2934,2422,512,21.139554087530964,morphological_dilation,3,2
0X74C54B277B5B012A.avi,83,1823,1363,460,33.749082905355834,morphological_dilation,3,2
0X74CC94D6336F349.avi,108,1149,821,328,39.95127892813642,morphological_dilation,3,2
0X74CC94D6336F349.avi,123,694,428,266,62.149532710280376,morphological_dilation,3,2
0X74CE156E0D1988F0.avi,1,1632,1264,368,29.11392405063291,morphological_dilation,3,2
0X74CE156E0D1988F0.avi,21,1077,777,300,38.61003861003861,morphological_dilation,3,2
0X74CFDB0155A5F839.avi,38,2158,1714,444,25.90431738623104,morphological_dilation,3,2
0X74CFDB0155A5F839.avi,54,1374,1010,364,36.039603960396036,morphological_dilation,3,2
0X74D2AB50ABC3BC70.avi,128,2001,1601,400,24.984384759525298,morphological_dilation,3,2
0X74D2AB50ABC3BC70.avi,146,1202,894,308,34.45190156599553,morphological_dilation,3,2
0X74D4DD80DA8C2996.avi,55,1043,743,300,40.376850605652756,morphological_dilation,3,2
0X74D4DD80DA8C2996.avi,67,802,535,267,49.90654205607476,morphological_dilation,3,2
0X74D8C8C813E756D9.avi,58,1255,931,324,34.80128893662729,morphological_dilation,3,2
0X74D8C8C813E756D9.avi,80,815,547,268,48.9945155393053,morphological_dilation,3,2
0X74DCA6B99E9BC121.avi,47,1645,1285,360,28.01556420233463,morphological_dilation,3,2
0X74DCA6B99E9BC121.avi,64,1009,715,294,41.11888111888112,morphological_dilation,3,2
0X74E8C723FC9CE35A.avi,156,1382,1042,340,32.629558541266796,morphological_dilation,3,2
0X74E8C723FC9CE35A.avi,178,907,627,280,44.65709728867623,morphological_dilation,3,2
0X74EBC28051D5C897.avi,116,1722,1307,415,31.752104055087987,morphological_dilation,3,2
0X74EBC28051D5C897.avi,131,1502,1125,377,33.51111111111111,morphological_dilation,3,2
0X74EC1E2F247AFC9B.avi,28,1692,1308,384,29.357798165137616,morphological_dilation,3,2
0X74EC1E2F247AFC9B.avi,42,1288,964,324,33.60995850622407,morphological_dilation,3,2
0X74ECBD41FE00FDA9.avi,44,2030,1634,396,24.23500611995104,morphological_dilation,3,2
0X74ECBD41FE00FDA9.avi,57,1298,954,344,36.058700209643604,morphological_dilation,3,2
0X74EF11EA884BA69B.avi,56,1422,1086,336,30.939226519337016,morphological_dilation,3,2
0X74EF11EA884BA69B.avi,94,1008,704,304,43.18181818181818,morphological_dilation,3,2
0X74F1AB4BAE55B45C.avi,0,2228,1784,444,24.887892376681613,morphological_dilation,3,2
0X74F1AB4BAE55B45C.avi,16,1557,1189,368,30.95037846930194,morphological_dilation,3,2
0X74FFBF42469E1942.avi,61,1487,1123,364,32.41317898486198,morphological_dilation,3,2
0X74FFBF42469E1942.avi,83,941,620,321,51.774193548387096,morphological_dilation,3,2
0X75031E71CC6DBD81.avi,42,1694,1334,360,26.986506746626688,morphological_dilation,3,2
0X75031E71CC6DBD81.avi,64,1357,1009,348,34.489593657086225,morphological_dilation,3,2
0X7504D970F17544F7.avi,134,1479,1139,340,29.850746268656714,morphological_dilation,3,2
0X7504D970F17544F7.avi,153,999,703,296,42.10526315789473,morphological_dilation,3,2
0X7506BF768DE74BD.avi,87,2251,1823,428,23.477783872737245,morphological_dilation,3,2
0X7506BF768DE74BD.avi,101,1954,1554,400,25.74002574002574,morphological_dilation,3,2
0X751739EFA206F1FE.avi,53,2199,1756,443,25.22779043280182,morphological_dilation,3,2
0X751739EFA206F1FE.avi,71,1528,1152,376,32.63888888888889,morphological_dilation,3,2
0X75184C621776F4CB.avi,35,1849,1449,400,27.605244996549345,morphological_dilation,3,2
0X75184C621776F4CB.avi,48,1215,883,332,37.599093997735,morphological_dilation,3,2
0X751A4FB2CEA69C9C.avi,104,2462,2010,452,22.487562189054728,morphological_dilation,3,2
0X751A4FB2CEA69C9C.avi,121,1936,1532,404,26.370757180156655,morphological_dilation,3,2
0X7521A2DBEE71A1F2.avi,101,1695,1327,368,27.731725697061037,morphological_dilation,3,2
0X7521A2DBEE71A1F2.avi,120,1097,793,304,38.33543505674653,morphological_dilation,3,2
0X752317EDE8CCB915.avi,40,1777,1389,388,27.9337652987761,morphological_dilation,3,2
0X752317EDE8CCB915.avi,58,1154,830,324,39.036144578313255,morphological_dilation,3,2
0X7524D9CE7C6BD3B.avi,30,1199,875,324,37.028571428571425,morphological_dilation,3,2
0X7524D9CE7C6BD3B.avi,50,922,599,323,53.923205342237054,morphological_dilation,3,2
0X7524FCA7831EB79A.avi,56,1509,1161,348,29.97416020671835,morphological_dilation,3,2
0X7524FCA7831EB79A.avi,76,1067,783,284,36.27075351213283,morphological_dilation,3,2
0X7525596E8C33D4E0.avi,154,1663,1275,388,30.43137254901961,morphological_dilation,3,2
0X7525596E8C33D4E0.avi,170,1082,758,324,42.74406332453825,morphological_dilation,3,2
0X7525B9148C2CD0BD.avi,5,2130,1714,416,24.27071178529755,morphological_dilation,3,2
0X7525B9148C2CD0BD.avi,21,1298,962,336,34.92723492723493,morphological_dilation,3,2
0X7528AEAEC3FBA097.avi,79,2640,2132,508,23.827392120075046,morphological_dilation,3,2
0X7528AEAEC3FBA097.avi,95,1585,1185,400,33.755274261603375,morphological_dilation,3,2
0X7529294AFB270DA0.avi,106,2220,1796,424,23.608017817371937,morphological_dilation,3,2
0X7529294AFB270DA0.avi,117,1402,1040,362,34.80769230769231,morphological_dilation,3,2
0X7529FE87A088578B.avi,4,1459,1115,344,30.852017937219735,morphological_dilation,3,2
0X7529FE87A088578B.avi,16,1046,747,299,40.02677376171352,morphological_dilation,3,2
0X75302B43AECFF778.avi,93,2137,1654,483,29.20193470374849,morphological_dilation,3,2
0X75302B43AECFF778.avi,112,1077,670,407,60.74626865671642,morphological_dilation,3,2
0X75309BE6A3C65FC0.avi,121,2014,1614,400,24.783147459727388,morphological_dilation,3,2
0X75309BE6A3C65FC0.avi,139,1264,936,328,35.04273504273504,morphological_dilation,3,2
0X7532D043B2FE1A89.avi,2,2423,1971,452,22.932521562658547,morphological_dilation,3,2
0X7532D043B2FE1A89.avi,22,1503,1143,360,31.496062992125985,morphological_dilation,3,2
0X7532E58FAD68C533.avi,0,3183,2667,516,19.34758155230596,morphological_dilation,3,2
0X7532E58FAD68C533.avi,19,1783,1380,403,29.202898550724637,morphological_dilation,3,2
0X7533B5CFDF97B569.avi,45,3572,3036,536,17.654808959156785,morphological_dilation,3,2
0X7533B5CFDF97B569.avi,63,1982,1575,407,25.841269841269842,morphological_dilation,3,2
0X753683596D61C023.avi,41,2093,1665,428,25.705705705705707,morphological_dilation,3,2
0X753683596D61C023.avi,58,997,673,324,48.14264487369985,morphological_dilation,3,2
0X75378D82A1704679.avi,103,1900,1524,376,24.671916010498688,morphological_dilation,3,2
0X75378D82A1704679.avi,121,1636,1284,352,27.41433021806853,morphological_dilation,3,2
0X753AA26EA352BBB.avi,27,1677,1301,376,28.90084550345888,morphological_dilation,3,2
0X753AA26EA352BBB.avi,32,2753,1910,843,44.13612565445027,morphological_dilation,3,2
0X753D4BE480775FE7.avi,22,1228,912,316,34.64912280701755,morphological_dilation,3,2
0X753D4BE480775FE7.avi,29,759,507,252,49.70414201183432,morphological_dilation,3,2
0X75407F342647CDB9.avi,96,1901,1505,396,26.312292358803983,morphological_dilation,3,2
0X75407F342647CDB9.avi,118,1343,999,344,34.434434434434436,morphological_dilation,3,2
0X7540B06840A33DBF.avi,93,1706,1314,392,29.832572298325722,morphological_dilation,3,2
0X7540B06840A33DBF.avi,114,1218,875,343,39.2,morphological_dilation,3,2
0X7542FA5CAC850B43.avi,60,1549,1205,344,28.54771784232365,morphological_dilation,3,2
0X7542FA5CAC850B43.avi,75,953,665,288,43.30827067669173,morphological_dilation,3,2
0X75472032BA3A263A.avi,61,2525,2061,464,22.513343037360507,morphological_dilation,3,2
0X75472032BA3A263A.avi,84,1742,1334,408,30.584707646176913,morphological_dilation,3,2
0X754AD474CF769955.avi,46,1756,1352,404,29.88165680473373,morphological_dilation,3,2
0X754AD474CF769955.avi,67,1050,730,320,43.83561643835616,morphological_dilation,3,2
0X754B72455C00BFDF.avi,73,1542,1138,404,35.50087873462214,morphological_dilation,3,2
0X754B72455C00BFDF.avi,85,1007,655,352,53.74045801526718,morphological_dilation,3,2
0X754BCC1F775CBF82.avi,60,1849,1461,388,26.55715263518138,morphological_dilation,3,2
0X754BCC1F775CBF82.avi,77,1167,847,320,37.78040141676505,morphological_dilation,3,2
0X75501B93842BA401.avi,63,1253,929,324,34.8762109795479,morphological_dilation,3,2
0X75501B93842BA401.avi,78,771,507,264,52.071005917159766,morphological_dilation,3,2
0X7552A3BA5FC6E4FE.avi,40,1276,948,328,34.59915611814346,morphological_dilation,3,2
0X7552A3BA5FC6E4FE.avi,50,950,678,272,40.117994100294986,morphological_dilation,3,2
0X75537A0F4CC9575A.avi,0,1519,1159,360,31.061259706643657,morphological_dilation,3,2
0X75537A0F4CC9575A.avi,18,1003,701,302,43.081312410841655,morphological_dilation,3,2
0X75572AB3B3B48345.avi,47,873,617,256,41.49108589951378,morphological_dilation,3,2
0X75572AB3B3B48345.avi,65,628,408,220,53.92156862745098,morphological_dilation,3,2
0X75596F4699354CDA.avi,43,2690,2218,472,21.28043282236249,morphological_dilation,3,2
0X75596F4699354CDA.avi,62,1922,1526,396,25.950196592398427,morphological_dilation,3,2
0X755A90F50F4068A2.avi,56,1694,1318,376,28.528072837632777,morphological_dilation,3,2
0X755A90F50F4068A2.avi,77,1059,751,308,41.011984021304926,morphological_dilation,3,2
0X755B138AF2588FEB.avi,56,1532,1156,376,32.52595155709342,morphological_dilation,3,2
0X755B138AF2588FEB.avi,77,882,586,296,50.51194539249146,morphological_dilation,3,2
0X7563D12CC3D333.avi,55,2681,2213,468,21.14776321735201,morphological_dilation,3,2
0X7563D12CC3D333.avi,71,1699,1315,384,29.20152091254753,morphological_dilation,3,2
0X7564081D4345D54E.avi,52,1743,1371,372,27.13347921225383,morphological_dilation,3,2
0X7564081D4345D54E.avi,69,1377,1029,348,33.819241982507286,morphological_dilation,3,2
0X756A5DE88BADCAD5.avi,48,1805,1425,380,26.666666666666668,morphological_dilation,3,2
0X756A5DE88BADCAD5.avi,57,1274,942,332,35.24416135881104,morphological_dilation,3,2
0X756DAD54E9785E32.avi,57,1959,1571,388,24.697644812221515,morphological_dilation,3,2
0X756DAD54E9785E32.avi,73,1452,1104,348,31.521739130434785,morphological_dilation,3,2
0X756FC51037837AB9.avi,60,1318,978,340,34.76482617586912,morphological_dilation,3,2
0X756FC51037837AB9.avi,72,773,513,260,50.682261208576996,morphological_dilation,3,2
0X7571CEDC4D58BA99.avi,49,1506,1146,360,31.413612565445025,morphological_dilation,3,2
0X7571CEDC4D58BA99.avi,70,941,637,304,47.72370486656201,morphological_dilation,3,2
0X7573D0F166A745C2.avi,33,1751,1387,364,26.24369142033165,morphological_dilation,3,2
0X7573D0F166A745C2.avi,55,1319,1000,319,31.900000000000002,morphological_dilation,3,2
0X757B31FD347B7585.avi,0,1531,1179,352,29.855810008481765,morphological_dilation,3,2
0X757B31FD347B7585.avi,20,992,692,300,43.35260115606936,morphological_dilation,3,2
0X757E1FD68EA38804.avi,43,1819,1423,396,27.82853127196065,morphological_dilation,3,2
0X757E1FD68EA38804.avi,62,1178,850,328,38.588235294117645,morphological_dilation,3,2
0X7582300B0B9B7FE.avi,56,2146,1730,416,24.046242774566473,morphological_dilation,3,2
0X7582300B0B9B7FE.avi,76,1484,1116,368,32.97491039426524,morphological_dilation,3,2
0X7584A85D9038EE5.avi,47,1524,1156,368,31.833910034602077,morphological_dilation,3,2
0X7584A85D9038EE5.avi,64,909,617,292,47.3257698541329,morphological_dilation,3,2
0X758646B35B753982.avi,86,2706,2230,476,21.345291479820627,morphological_dilation,3,2
0X758646B35B753982.avi,104,1587,1199,388,32.36030025020851,morphological_dilation,3,2
0X758AD34A442E9B92.avi,87,2084,1688,396,23.459715639810426,morphological_dilation,3,2
0X758AD34A442E9B92.avi,103,1401,1069,332,31.057062675397567,morphological_dilation,3,2
0X758AD547400F166A.avi,33,2025,1621,404,24.922887106724247,morphological_dilation,3,2
0X758AD547400F166A.avi,62,1247,922,325,35.24945770065076,morphological_dilation,3,2
0X758BAF4513916559.avi,88,991,692,299,43.20809248554913,morphological_dilation,3,2
0X758BAF4513916559.avi,97,651,399,252,63.1578947368421,morphological_dilation,3,2
0X759190C681D52700.avi,94,1718,1347,371,27.542687453600596,morphological_dilation,3,2
0X759190C681D52700.avi,109,1107,791,316,39.94943109987358,morphological_dilation,3,2
0X7595258EBE9BF61E.avi,84,1459,1111,348,31.323132313231323,morphological_dilation,3,2
0X7595258EBE9BF61E.avi,101,940,644,296,45.962732919254655,morphological_dilation,3,2
0X75980C92D587017B.avi,2,1443,1107,336,30.35230352303523,morphological_dilation,3,2
0X75980C92D587017B.avi,16,1037,745,292,39.19463087248322,morphological_dilation,3,2
0X7599F574E8E51B1C.avi,45,1119,809,310,38.31891223733004,morphological_dilation,3,2
0X7599F574E8E51B1C.avi,63,690,446,244,54.7085201793722,morphological_dilation,3,2
0X759B7B28B1086707.avi,67,2754,2286,468,20.47244094488189,morphological_dilation,3,2
0X759B7B28B1086707.avi,88,1683,1299,384,29.561200923787528,morphological_dilation,3,2
0X75ACFE19B069E805.avi,96,1093,769,324,42.132639791937585,morphological_dilation,3,2
0X75ACFE19B069E805.avi,115,687,415,272,65.5421686746988,morphological_dilation,3,2
0X75AF130134AADF00.avi,36,1255,915,340,37.15846994535519,morphological_dilation,3,2
0X75AF130134AADF00.avi,55,1018,722,296,40.99722991689751,morphological_dilation,3,2
0X75B080DB873F09A8.avi,107,1507,1140,367,32.19298245614035,morphological_dilation,3,2
0X75B080DB873F09A8.avi,120,1094,758,336,44.327176781002635,morphological_dilation,3,2
0X75B1C628D4FBB8B0.avi,53,1478,1130,348,30.796460176991154,morphological_dilation,3,2
0X75B1C628D4FBB8B0.avi,72,857,589,268,45.50084889643464,morphological_dilation,3,2
0X75B466DF0FE8BDF8.avi,63,1677,1302,375,28.80184331797235,morphological_dilation,3,2
0X75B466DF0FE8BDF8.avi,85,1349,978,371,37.93456032719836,morphological_dilation,3,2
0X75BA1623CCCF0652.avi,3,2809,2345,464,19.78678038379531,morphological_dilation,3,2
0X75BA1623CCCF0652.avi,18,2101,1677,424,25.28324388789505,morphological_dilation,3,2
0X75BB68F0ACD22690.avi,64,1588,1232,356,28.8961038961039,morphological_dilation,3,2
0X75BB68F0ACD22690.avi,79,981,668,313,46.8562874251497,morphological_dilation,3,2
0X75BF25E961056A3C.avi,42,2544,2081,463,22.248918789043728,morphological_dilation,3,2
0X75BF25E961056A3C.avi,69,1527,1144,383,33.47902097902098,morphological_dilation,3,2
0X75C3DEC78DC6B030.avi,36,1888,1512,376,24.867724867724867,morphological_dilation,3,2
0X75C3DEC78DC6B030.avi,55,1450,1126,324,28.774422735346363,morphological_dilation,3,2
0X75C6B7A420E577F0.avi,57,1737,1357,380,28.002947678703023,morphological_dilation,3,2
0X75C6B7A420E577F0.avi,75,995,699,296,42.34620886981402,morphological_dilation,3,2
0X75CC279D832110B3.avi,95,932,637,295,46.31083202511774,morphological_dilation,3,2
0X75CC279D832110B3.avi,109,632,372,260,69.89247311827957,morphological_dilation,3,2
0X75CF68235B445C71.avi,47,1906,1514,392,25.891677675033026,morphological_dilation,3,2
0X75CF68235B445C71.avi,62,1185,857,328,38.2730455075846,morphological_dilation,3,2
0X75DABBB27803889E.avi,141,1604,1228,376,30.618892508143325,morphological_dilation,3,2
0X75DABBB27803889E.avi,161,1178,854,324,37.93911007025761,morphological_dilation,3,2
0X75DF068323A1B75A.avi,59,1573,1229,344,27.990235964198533,morphological_dilation,3,2
0X75DF068323A1B75A.avi,68,1109,809,300,37.08281829419035,morphological_dilation,3,2
0X75E662FDEB925647.avi,37,1607,1223,384,31.398201144726084,morphological_dilation,3,2
0X75E662FDEB925647.avi,51,962,646,316,48.91640866873065,morphological_dilation,3,2
0X75E84FBEEEE69FD8.avi,76,1980,1569,411,26.19502868068834,morphological_dilation,3,2
0X75E84FBEEEE69FD8.avi,91,1222,898,324,36.080178173719375,morphological_dilation,3,2
0X75ECC6694B60D05A.avi,27,1586,1206,380,31.509121061359867,morphological_dilation,3,2
0X75ECC6694B60D05A.avi,41,949,633,316,49.92101105845181,morphological_dilation,3,2
0X75ED030E56E85A27.avi,42,2142,1587,555,34.97164461247637,morphological_dilation,3,2
0X75ED030E56E85A27.avi,59,1362,1046,316,30.210325047801145,morphological_dilation,3,2
0X75F02C30D9BD67BD.avi,173,2456,2008,448,22.31075697211155,morphological_dilation,3,2
0X75F02C30D9BD67BD.avi,197,2000,1592,408,25.628140703517587,morphological_dilation,3,2
0X75F76AEBCE051CD1.avi,80,1467,1087,380,34.95860165593376,morphological_dilation,3,2
0X75F76AEBCE051CD1.avi,95,1041,697,344,49.35437589670014,morphological_dilation,3,2
0X75FA18E3007970A6.avi,41,2454,2014,440,21.847070506454816,morphological_dilation,3,2
0X75FA18E3007970A6.avi,58,1281,961,320,33.29864724245578,morphological_dilation,3,2
0X75FA93DC76BFB6A6.avi,0,1618,1270,348,27.401574803149607,morphological_dilation,3,2
0X75FA93DC76BFB6A6.avi,13,1083,791,292,36.91529709228824,morphological_dilation,3,2
0X75FCE4E4D09346E8.avi,126,1829,1453,376,25.877494838265658,morphological_dilation,3,2
0X75FCE4E4D09346E8.avi,145,1583,1235,348,28.17813765182186,morphological_dilation,3,2
0X75FD0277B3649F4C.avi,2,1940,1528,412,26.96335078534031,morphological_dilation,3,2
0X75FD0277B3649F4C.avi,19,1142,799,343,42.92866082603254,morphological_dilation,3,2
0X7600AA9CA94BC926.avi,81,1518,1166,352,30.18867924528302,morphological_dilation,3,2
0X7600AA9CA94BC926.avi,98,976,676,300,44.37869822485207,morphological_dilation,3,2
0X7602BD0B48EB9C41.avi,136,2250,1810,440,24.30939226519337,morphological_dilation,3,2
0X7602BD0B48EB9C41.avi,153,1337,986,351,35.598377281947265,morphological_dilation,3,2
0X760D32805B54A4DB.avi,45,2946,2438,508,20.836751435602956,morphological_dilation,3,2
0X760D32805B54A4DB.avi,62,1606,1190,416,34.95798319327731,morphological_dilation,3,2
0X760F20180FF2AF05.avi,57,1764,1384,380,27.45664739884393,morphological_dilation,3,2
0X760F20180FF2AF05.avi,73,1037,733,304,41.47339699863574,morphological_dilation,3,2
0X7611CD2E2F5D8D5A.avi,60,1371,1027,344,33.49561830574489,morphological_dilation,3,2
0X7611CD2E2F5D8D5A.avi,72,807,543,264,48.61878453038674,morphological_dilation,3,2
0X7611E73E48694DD2.avi,84,1219,903,316,34.99446290143965,morphological_dilation,3,2
0X7611E73E48694DD2.avi,92,915,634,281,44.321766561514195,morphological_dilation,3,2
0X7614D7711A328048.avi,53,2240,1812,428,23.62030905077263,morphological_dilation,3,2
0X7614D7711A328048.avi,69,1468,1108,360,32.49097472924188,morphological_dilation,3,2
0X76166F0E9F88A8EE.avi,35,1770,1362,408,29.955947136563875,morphological_dilation,3,2
0X76166F0E9F88A8EE.avi,51,1112,760,352,46.31578947368421,morphological_dilation,3,2
0X761FEC566D4FA6B4.avi,57,1868,1472,396,26.902173913043477,morphological_dilation,3,2
0X761FEC566D4FA6B4.avi,71,1189,853,336,39.390386869871044,morphological_dilation,3,2
0X7622FE00BC55FA93.avi,63,889,589,300,50.93378607809848,morphological_dilation,3,2
0X7622FE00BC55FA93.avi,76,643,356,287,80.6179775280899,morphological_dilation,3,2
0X76236768A07DC4A0.avi,0,1116,828,288,34.78260869565217,morphological_dilation,3,2
0X76236768A07DC4A0.avi,17,737,505,232,45.940594059405946,morphological_dilation,3,2
0X7624B8F339B7F9E2.avi,39,1216,904,312,34.51327433628318,morphological_dilation,3,2
0X7624B8F339B7F9E2.avi,50,755,495,260,52.52525252525253,morphological_dilation,3,2
0X7626288997509ED8.avi,110,2193,1781,412,23.13307130825379,morphological_dilation,3,2
0X7626288997509ED8.avi,137,1739,1375,364,26.47272727272727,morphological_dilation,3,2
0X76265CF61DC60700.avi,2,1754,1344,410,30.505952380952383,morphological_dilation,3,2
0X76265CF61DC60700.avi,12,1156,812,344,42.364532019704434,morphological_dilation,3,2
0X7628E85E157D1655.avi,36,1379,1012,367,36.26482213438735,morphological_dilation,3,2
0X7628E85E157D1655.avi,51,897,593,304,51.264755480607086,morphological_dilation,3,2
0X762A1DFE29A222B9.avi,48,2339,1872,467,24.946581196581196,morphological_dilation,3,2
0X762A1DFE29A222B9.avi,63,1458,1050,408,38.857142857142854,morphological_dilation,3,2
0X762B2F82E180F891.avi,120,1082,778,304,39.0745501285347,morphological_dilation,3,2
0X762B2F82E180F891.avi,131,647,411,236,57.420924574209245,morphological_dilation,3,2
0X762B3C5FFB4F6256.avi,50,1340,1008,332,32.93650793650794,morphological_dilation,3,2
0X762B3C5FFB4F6256.avi,67,829,561,268,47.771836007130126,morphological_dilation,3,2
0X762F3649CC03CEB2.avi,49,2553,2077,476,22.917669715936448,morphological_dilation,3,2
0X762F3649CC03CEB2.avi,67,1746,1346,400,29.71768202080238,morphological_dilation,3,2
0X763034E9D22CB7E1.avi,27,1492,1124,368,32.74021352313167,morphological_dilation,3,2
0X763034E9D22CB7E1.avi,44,1031,723,308,42.60027662517289,morphological_dilation,3,2
0X7630DA7B2D3E6F27.avi,139,2282,1838,444,24.156692056583243,morphological_dilation,3,2
0X7630DA7B2D3E6F27.avi,158,1891,1503,388,25.815036593479707,morphological_dilation,3,2
0X7631EA1C1A8CC24E.avi,33,1423,1061,362,34.11875589066918,morphological_dilation,3,2
0X7631EA1C1A8CC24E.avi,47,1121,767,354,46.15384615384615,morphological_dilation,3,2
0X7634C16A2566CB36.avi,148,2182,1764,418,23.69614512471655,morphological_dilation,3,2
0X7634C16A2566CB36.avi,164,1388,1039,349,33.58999037536093,morphological_dilation,3,2
0X7639DF523155EE5B.avi,2,1417,1065,352,33.051643192488264,morphological_dilation,3,2
0X7639DF523155EE5B.avi,19,1100,792,308,38.88888888888889,morphological_dilation,3,2
0X763E3FFF4DBBB792.avi,137,3178,2678,500,18.670649738610905,morphological_dilation,3,2
0X763E3FFF4DBBB792.avi,154,1942,1546,396,25.614489003880987,morphological_dilation,3,2
0X763F719D691570A5.avi,54,1358,1030,328,31.844660194174757,morphological_dilation,3,2
0X763F719D691570A5.avi,69,824,552,272,49.275362318840585,morphological_dilation,3,2
0X7640521DAB3774CD.avi,35,1738,1333,405,30.38259564891223,morphological_dilation,3,2
0X7640521DAB3774CD.avi,49,1003,697,306,43.90243902439025,morphological_dilation,3,2
0X76411FAE2DF2EEB5.avi,52,1577,1221,356,29.15642915642916,morphological_dilation,3,2
0X76411FAE2DF2EEB5.avi,68,918,630,288,45.714285714285715,morphological_dilation,3,2
0X7641C94226741EBA.avi,92,1920,1520,400,26.31578947368421,morphological_dilation,3,2
0X7641C94226741EBA.avi,108,1230,894,336,37.58389261744966,morphological_dilation,3,2
0X76437B0245B6762.avi,4,2243,1793,450,25.09760178471835,morphological_dilation,3,2
0X76437B0245B6762.avi,17,1871,1468,403,27.452316076294274,morphological_dilation,3,2
0X764C542E3E41E4D2.avi,14,2375,1939,436,22.485817431665808,morphological_dilation,3,2
0X764C542E3E41E4D2.avi,21,1762,1374,388,28.238719068413392,morphological_dilation,3,2
0X764F224CC78A22A3.avi,42,1109,801,308,38.45193508114856,morphological_dilation,3,2
0X764F224CC78A22A3.avi,55,693,437,256,58.58123569794051,morphological_dilation,3,2
0X765022B40B3129C0.avi,115,1850,1458,392,26.886145404663925,morphological_dilation,3,2
0X765022B40B3129C0.avi,136,1198,874,324,37.07093821510298,morphological_dilation,3,2
0X7650A9E7CE45FD9E.avi,0,1557,1181,376,31.837425910245553,morphological_dilation,3,2
0X7650A9E7CE45FD9E.avi,21,941,633,308,48.657187993680886,morphological_dilation,3,2
0X76525CBFC30D569F.avi,97,2178,1698,480,28.26855123674912,morphological_dilation,3,2
0X76525CBFC30D569F.avi,116,1512,1095,417,38.082191780821915,morphological_dilation,3,2
0X7655EF3942795C54.avi,112,1804,1424,380,26.685393258426966,morphological_dilation,3,2
0X7655EF3942795C54.avi,120,1163,855,308,36.0233918128655,morphological_dilation,3,2
0X76571CA78B208B80.avi,35,1536,1188,348,29.292929292929294,morphological_dilation,3,2
0X76571CA78B208B80.avi,53,937,641,296,46.17784711388456,morphological_dilation,3,2
0X765D336F80D8DC9C.avi,2,1742,1342,400,29.806259314456035,morphological_dilation,3,2
0X765D336F80D8DC9C.avi,22,1196,860,336,39.06976744186046,morphological_dilation,3,2
0X766164794562852B.avi,84,1885,1489,396,26.595030221625255,morphological_dilation,3,2
0X766164794562852B.avi,97,1159,831,328,39.4705174488568,morphological_dilation,3,2
0X7663D4D92BDD0DF0.avi,66,1598,1226,372,30.342577487765087,morphological_dilation,3,2
0X7663D4D92BDD0DF0.avi,79,1042,724,318,43.92265193370166,morphological_dilation,3,2
0X7666487BE51E1D94.avi,63,1544,1168,376,32.19178082191781,morphological_dilation,3,2
0X7666487BE51E1D94.avi,79,1295,932,363,38.94849785407725,morphological_dilation,3,2
0X766B7B0ABDB07CD5.avi,18,1273,845,428,50.650887573964496,morphological_dilation,3,2
0X766B7B0ABDB07CD5.avi,45,737,505,232,45.940594059405946,morphological_dilation,3,2
0X766FB03557B32F7.avi,39,1350,1002,348,34.73053892215569,morphological_dilation,3,2
0X766FB03557B32F7.avi,54,611,387,224,57.88113695090439,morphological_dilation,3,2
0X76736440F2A28290.avi,96,1599,1219,380,31.17309269893355,morphological_dilation,3,2
0X76736440F2A28290.avi,107,1063,749,314,41.922563417890515,morphological_dilation,3,2
0X76747A1A799357B5.avi,99,1950,1558,392,25.1604621309371,morphological_dilation,3,2
0X76747A1A799357B5.avi,113,1149,845,304,35.976331360946745,morphological_dilation,3,2
0X76759C3F748F7642.avi,3,1171,867,304,35.06343713956171,morphological_dilation,3,2
0X76759C3F748F7642.avi,15,733,493,240,48.6815415821501,morphological_dilation,3,2
0X7675A1B2694BA8E.avi,75,1756,1376,380,27.61627906976744,morphological_dilation,3,2
0X7675A1B2694BA8E.avi,90,1080,760,320,42.10526315789473,morphological_dilation,3,2
0X767947C7DECC2E0D.avi,82,2083,1659,424,25.557564798071127,morphological_dilation,3,2
0X767947C7DECC2E0D.avi,101,1195,883,312,35.334088335220834,morphological_dilation,3,2
0X767FB65F24445D49.avi,79,1466,1108,358,32.31046931407942,morphological_dilation,3,2
0X767FB65F24445D49.avi,90,1097,765,332,43.39869281045752,morphological_dilation,3,2
0X76833F5D02883757.avi,74,1345,1021,324,31.733594515181196,morphological_dilation,3,2
0X76833F5D02883757.avi,89,955,675,280,41.48148148148148,morphological_dilation,3,2
0X768E85852A1CF053.avi,31,1322,998,324,32.46492985971944,morphological_dilation,3,2
0X768E85852A1CF053.avi,44,853,573,280,48.86561954624782,morphological_dilation,3,2
0X7697FABB106CA020.avi,86,1573,1197,376,31.411862990810356,morphological_dilation,3,2
0X7697FABB106CA020.avi,102,925,623,302,48.47512038523274,morphological_dilation,3,2
0X769C3D56C7272A2.avi,34,1777,1413,364,25.760792639773534,morphological_dilation,3,2
0X769C3D56C7272A2.avi,49,1054,770,284,36.883116883116884,morphological_dilation,3,2
0X769E071800CFC0FB.avi,81,1564,1200,364,30.333333333333336,morphological_dilation,3,2
0X769E071800CFC0FB.avi,102,866,594,272,45.79124579124579,morphological_dilation,3,2
0X769E51557A324219.avi,51,2158,1738,420,24.165707710011507,morphological_dilation,3,2
0X769E51557A324219.avi,67,1512,1156,356,30.79584775086505,morphological_dilation,3,2
0X769EDBD7BD855F6E.avi,133,1418,1070,348,32.52336448598131,morphological_dilation,3,2
0X769EDBD7BD855F6E.avi,148,912,624,288,46.15384615384615,morphological_dilation,3,2
0X76A2F23E5CC3AE8.avi,20,1545,1161,384,33.0749354005168,morphological_dilation,3,2
0X76A2F23E5CC3AE8.avi,38,2499,2051,448,21.843003412969285,morphological_dilation,3,2
0X76A43B263DED8D2A.avi,29,1326,1002,324,32.33532934131736,morphological_dilation,3,2
0X76A43B263DED8D2A.avi,48,897,605,292,48.264462809917354,morphological_dilation,3,2
0X76A7219E8CDEDD94.avi,29,1638,1230,408,33.170731707317074,morphological_dilation,3,2
0X76A7219E8CDEDD94.avi,46,957,637,320,50.23547880690737,morphological_dilation,3,2
0X76AA056D7D126764.avi,55,1359,1003,356,35.49351944167498,morphological_dilation,3,2
0X76AA056D7D126764.avi,72,837,541,296,54.71349353049908,morphological_dilation,3,2
0X76AC76456CE65507.avi,48,1691,1299,392,30.177059276366435,morphological_dilation,3,2
0X76AC76456CE65507.avi,67,1117,717,400,55.78800557880056,morphological_dilation,3,2
0X76ACECF4ADDE5FEC.avi,61,1510,1138,372,32.68892794376098,morphological_dilation,3,2
0X76ACECF4ADDE5FEC.avi,72,949,657,292,44.44444444444444,morphological_dilation,3,2
0X76AFD129D4D3F9B6.avi,90,1844,1436,408,28.412256267409468,morphological_dilation,3,2
0X76AFD129D4D3F9B6.avi,106,1017,688,329,47.81976744186046,morphological_dilation,3,2
0X76B3419501D921D5.avi,111,3018,2494,524,21.010425020048114,morphological_dilation,3,2
0X76B3419501D921D5.avi,130,1770,1370,400,29.1970802919708,morphological_dilation,3,2
0X76B58AFEBD29ED3A.avi,89,1549,1177,372,31.60577740016992,morphological_dilation,3,2
0X76B58AFEBD29ED3A.avi,106,1012,696,316,45.40229885057471,morphological_dilation,3,2
0X76BA1F5294F6CED2.avi,44,1387,1051,336,31.969552806850622,morphological_dilation,3,2
0X76BA1F5294F6CED2.avi,66,1071,771,300,38.91050583657588,morphological_dilation,3,2
0X76BACDAE432385EB.avi,43,1608,1236,372,30.097087378640776,morphological_dilation,3,2
0X76BACDAE432385EB.avi,58,1044,720,324,45.0,morphological_dilation,3,2
0X76BDAF25BA25FB78.avi,59,1636,1256,380,30.254777070063692,morphological_dilation,3,2
0X76BDAF25BA25FB78.avi,75,1002,710,292,41.12676056338028,morphological_dilation,3,2
0X76C419ACD0EB7F21.avi,109,2575,2071,504,24.33606953162723,morphological_dilation,3,2
0X76C419ACD0EB7F21.avi,125,1604,1195,409,34.22594142259414,morphological_dilation,3,2
0X76C545439F4D8755.avi,40,2693,2193,500,22.79981760145919,morphological_dilation,3,2
0X76C545439F4D8755.avi,55,1891,1459,432,29.609321453050036,morphological_dilation,3,2
0X76C68DF9EAD541B2.avi,125,1710,1318,392,29.74203338391502,morphological_dilation,3,2
0X76C68DF9EAD541B2.avi,140,1093,769,324,42.132639791937585,morphological_dilation,3,2
0X76C84AD83FFD8620.avi,51,2724,2240,484,21.607142857142858,morphological_dilation,3,2
0X76C84AD83FFD8620.avi,71,1577,1181,396,33.53090601185436,morphological_dilation,3,2
0X76CA8EF02677FD92.avi,44,2045,1633,412,25.229638701775876,morphological_dilation,3,2
0X76CA8EF02677FD92.avi,63,1149,841,308,36.623067776456594,morphological_dilation,3,2
0X76CB8866FF386D70.avi,169,1978,1574,404,25.667090216010163,morphological_dilation,3,2
0X76CB8866FF386D70.avi,186,1095,779,316,40.564826700898585,morphological_dilation,3,2
0X76CD74B7A16F961C.avi,44,1476,1108,368,33.2129963898917,morphological_dilation,3,2
0X76CD74B7A16F961C.avi,61,932,612,320,52.28758169934641,morphological_dilation,3,2
0X76CF3E993E9964A9.avi,30,2297,1834,463,25.2453653217012,morphological_dilation,3,2
0X76CF3E993E9964A9.avi,60,2545,1862,683,36.680988184747584,morphological_dilation,3,2
0X76CF9DD42F1E65F5.avi,87,1727,1331,396,29.75206611570248,morphological_dilation,3,2
0X76CF9DD42F1E65F5.avi,103,1073,765,308,40.26143790849673,morphological_dilation,3,2
0X76D00C87BFFEF9ED.avi,34,2338,1882,456,24.22954303931987,morphological_dilation,3,2
0X76D00C87BFFEF9ED.avi,48,1287,935,352,37.64705882352941,morphological_dilation,3,2
0X76D0455E4D842528.avi,42,1261,933,328,35.155412647374064,morphological_dilation,3,2
0X76D0455E4D842528.avi,57,812,528,284,53.78787878787878,morphological_dilation,3,2
0X76D1CD83C813866F.avi,56,1368,1028,340,33.07392996108949,morphological_dilation,3,2
0X76D1CD83C813866F.avi,74,866,581,285,49.05335628227194,morphological_dilation,3,2
0X76D4127252AEE59B.avi,40,3212,2700,512,18.962962962962962,morphological_dilation,3,2
0X76D4127252AEE59B.avi,61,1824,1437,387,26.931106471816285,morphological_dilation,3,2
0X76D5689A73615919.avi,60,1066,778,288,37.01799485861182,morphological_dilation,3,2
0X76D5689A73615919.avi,72,640,412,228,55.33980582524271,morphological_dilation,3,2
0X76DC6D4505B83070.avi,92,1885,1490,395,26.51006711409396,morphological_dilation,3,2
0X76DC6D4505B83070.avi,108,1133,817,316,38.6780905752754,morphological_dilation,3,2
0X76E11B10B82CED38.avi,49,1899,1480,419,28.31081081081081,morphological_dilation,3,2
0X76E11B10B82CED38.avi,70,1219,859,360,41.90919674039581,morphological_dilation,3,2
0X76E3BEB91B015F9C.avi,32,1554,1163,391,33.61994840928632,morphological_dilation,3,2
0X76E3BEB91B015F9C.avi,48,948,663,285,42.98642533936652,morphological_dilation,3,2
0X76E4353961DF844D.avi,160,2511,2075,436,21.012048192771086,morphological_dilation,3,2
0X76E4353961DF844D.avi,180,1912,1532,380,24.804177545691903,morphological_dilation,3,2
0X76EB03C76DA83506.avi,82,1742,1370,372,27.153284671532845,morphological_dilation,3,2
0X76EB03C76DA83506.avi,104,1049,764,285,37.303664921465966,morphological_dilation,3,2
0X76ECD9C77CBF74DF.avi,87,2274,1830,444,24.262295081967213,morphological_dilation,3,2
0X76ECD9C77CBF74DF.avi,105,1372,1008,364,36.11111111111111,morphological_dilation,3,2
0X76F1860F9A3BA0D.avi,51,3143,2615,528,20.191204588910132,morphological_dilation,3,2
0X76F1860F9A3BA0D.avi,69,2099,1671,428,25.61340514661879,morphological_dilation,3,2
0X76F22089D5778788.avi,30,2062,1654,408,24.667472793228537,morphological_dilation,3,2
0X76F22089D5778788.avi,46,1323,991,332,33.501513622603426,morphological_dilation,3,2
0X76F4E037E279AF66.avi,104,1627,1248,379,30.36858974358974,morphological_dilation,3,2
0X76F4E037E279AF66.avi,122,930,634,296,46.68769716088328,morphological_dilation,3,2
0X76F8E59118B237E4.avi,94,2191,1751,440,25.1284980011422,morphological_dilation,3,2
0X76F8E59118B237E4.avi,110,1584,1193,391,32.774518021793796,morphological_dilation,3,2
0X76FCC20BE40D7420.avi,52,2291,1859,432,23.238300161377083,morphological_dilation,3,2
0X76FCC20BE40D7420.avi,72,1498,1134,364,32.098765432098766,morphological_dilation,3,2
0X76FD04F70E71C6B4.avi,61,1532,1192,340,28.523489932885905,morphological_dilation,3,2
0X76FD04F70E71C6B4.avi,79,940,676,264,39.053254437869825,morphological_dilation,3,2
0X76FE618100C74B17.avi,224,2293,1853,440,23.745277927684835,morphological_dilation,3,2
0X76FE618100C74B17.avi,242,1589,1221,368,30.13923013923014,morphological_dilation,3,2
0X76FFCEF160816C6D.avi,2,1604,1240,364,29.354838709677416,morphological_dilation,3,2
0X76FFCEF160816C6D.avi,21,872,580,292,50.3448275862069,morphological_dilation,3,2
0X770217E8A046549.avi,68,1389,1039,350,33.68623676612127,morphological_dilation,3,2
0X770217E8A046549.avi,86,876,591,285,48.223350253807105,morphological_dilation,3,2
0X7708922833D36759.avi,71,1622,1234,388,31.442463533225286,morphological_dilation,3,2
0X7708922833D36759.avi,88,1015,695,320,46.043165467625904,morphological_dilation,3,2
0X770BECBD81CA14F9.avi,60,1861,1477,384,25.998645903859174,morphological_dilation,3,2
0X770BECBD81CA14F9.avi,76,1655,1295,360,27.7992277992278,morphological_dilation,3,2
0X770D507C00A355B.avi,99,1408,1068,340,31.835205992509362,morphological_dilation,3,2
0X770D507C00A355B.avi,109,1006,717,289,40.306834030683405,morphological_dilation,3,2
0X770DA83A3089A1CE.avi,47,1930,1522,408,26.806833114323258,morphological_dilation,3,2
0X770DA83A3089A1CE.avi,72,1180,840,340,40.476190476190474,morphological_dilation,3,2
0X770E5896DC4FD92B.avi,138,1824,1416,408,28.8135593220339,morphological_dilation,3,2
0X770E5896DC4FD92B.avi,151,1199,856,343,40.070093457943926,morphological_dilation,3,2
0X7710551E470BE80A.avi,52,1612,1244,368,29.581993569131832,morphological_dilation,3,2
0X7710551E470BE80A.avi,69,980,684,296,43.27485380116959,morphological_dilation,3,2
0X771077249874A8C5.avi,83,3137,2629,508,19.322936477748193,morphological_dilation,3,2
0X771077249874A8C5.avi,102,2039,1603,436,27.199001871490953,morphological_dilation,3,2
0X771268F9558AC1F1.avi,119,1801,1409,392,27.82114975159688,morphological_dilation,3,2
0X771268F9558AC1F1.avi,131,1037,733,304,41.47339699863574,morphological_dilation,3,2
0X771366A13CB946B7.avi,113,1828,1432,396,27.6536312849162,morphological_dilation,3,2
0X771366A13CB946B7.avi,129,1106,794,312,39.29471032745592,morphological_dilation,3,2
0X7713736C58AE4285.avi,112,1895,1495,400,26.755852842809364,morphological_dilation,3,2
0X7713736C58AE4285.avi,136,1175,859,316,36.78696158323632,morphological_dilation,3,2
0X771C3F118CBF577A.avi,84,2507,2043,464,22.711698482623593,morphological_dilation,3,2
0X771C3F118CBF577A.avi,104,1450,1066,384,36.02251407129456,morphological_dilation,3,2
0X77205DA830ED3817.avi,50,1532,1164,368,31.615120274914087,morphological_dilation,3,2
0X77205DA830ED3817.avi,67,900,616,284,46.103896103896105,morphological_dilation,3,2
0X7724D6B08D73B212.avi,52,2937,2425,512,21.11340206185567,morphological_dilation,3,2
0X7724D6B08D73B212.avi,72,1887,1451,436,30.04824259131633,morphological_dilation,3,2
0X772970685B34F0F1.avi,65,1706,1346,360,26.74591381872214,morphological_dilation,3,2
0X772970685B34F0F1.avi,79,1094,794,300,37.78337531486146,morphological_dilation,3,2
0X772A0668FFB473C1.avi,49,2242,1794,448,24.972129319955407,morphological_dilation,3,2
0X772A0668FFB473C1.avi,69,1077,712,365,51.26404494382022,morphological_dilation,3,2
0X772AB2EA261CD16A.avi,188,1935,1535,400,26.058631921824105,morphological_dilation,3,2
0X772AB2EA261CD16A.avi,207,1269,945,324,34.285714285714285,morphological_dilation,3,2
0X772BAD84F86F709D.avi,51,1623,1279,344,26.89601250977326,morphological_dilation,3,2
0X772BAD84F86F709D.avi,67,1031,751,280,37.28362183754994,morphological_dilation,3,2
0X772EC799B52E7C56.avi,0,2027,1611,416,25.822470515207947,morphological_dilation,3,2
0X772EC799B52E7C56.avi,36,1336,964,372,38.589211618257266,morphological_dilation,3,2
0X77373A73E2BC8C9E.avi,128,1311,983,328,33.36724313326551,morphological_dilation,3,2
0X77373A73E2BC8C9E.avi,141,884,608,276,45.39473684210527,morphological_dilation,3,2
0X773AC247581BBBA1.avi,59,1517,1173,344,29.326513213981244,morphological_dilation,3,2
0X773AC247581BBBA1.avi,77,846,582,264,45.36082474226804,morphological_dilation,3,2
0X773AFFB19D6D921B.avi,91,1429,1081,348,32.192414431082334,morphological_dilation,3,2
0X773AFFB19D6D921B.avi,104,866,582,284,48.797250859106526,morphological_dilation,3,2
0X773D4F3643F9BF5F.avi,73,2434,1968,466,23.678861788617887,morphological_dilation,3,2
0X773D4F3643F9BF5F.avi,93,1635,1243,392,31.53660498793242,morphological_dilation,3,2
0X77435187285FD096.avi,87,1932,1532,400,26.109660574412537,morphological_dilation,3,2
0X77435187285FD096.avi,99,1214,874,340,38.901601830663616,morphological_dilation,3,2
0X77458937194C1E72.avi,57,2185,1749,436,24.928530588907947,morphological_dilation,3,2
0X77458937194C1E72.avi,72,1264,879,385,43.79977246871445,morphological_dilation,3,2
0X77512D8618DD734C.avi,60,2165,1721,444,25.79895409645555,morphological_dilation,3,2
0X77512D8618DD734C.avi,77,1398,1038,360,34.68208092485549,morphological_dilation,3,2
0X775319C257A48042.avi,95,2869,2373,496,20.90181205225453,morphological_dilation,3,2
0X775319C257A48042.avi,117,2134,1702,432,25.381903642773207,morphological_dilation,3,2
0X775716B41199062E.avi,62,1178,862,316,36.65893271461717,morphological_dilation,3,2
0X775716B41199062E.avi,84,790,506,284,56.126482213438734,morphological_dilation,3,2
0X7758757FDD3AA0D4.avi,2,2760,2272,488,21.47887323943662,morphological_dilation,3,2
0X7758757FDD3AA0D4.avi,21,1853,1450,403,27.793103448275865,morphological_dilation,3,2
0X7759E238B242AFBC.avi,84,2245,1833,412,22.47681396617567,morphological_dilation,3,2
0X7759E238B242AFBC.avi,103,1348,1032,316,30.620155038759687,morphological_dilation,3,2
0X775A2380C732189.avi,121,1557,1193,364,30.511316010058675,morphological_dilation,3,2
0X775A2380C732189.avi,141,928,640,288,45.0,morphological_dilation,3,2
0X775A9E14ECEB2A11.avi,54,2010,1622,388,23.921085080147968,morphological_dilation,3,2
0X775A9E14ECEB2A11.avi,72,1304,976,328,33.60655737704918,morphological_dilation,3,2
0X775B4EA7420EEECA.avi,33,1459,1131,328,29.000884173297965,morphological_dilation,3,2
0X775B4EA7420EEECA.avi,51,953,670,283,42.23880597014925,morphological_dilation,3,2
0X775EBA7C578E03AD.avi,75,2216,1804,412,22.838137472283815,morphological_dilation,3,2
0X775EBA7C578E03AD.avi,91,1806,1434,372,25.94142259414226,morphological_dilation,3,2
0X775F0DCC5003FFB.avi,33,1548,1200,348,28.999999999999996,morphological_dilation,3,2
0X775F0DCC5003FFB.avi,49,947,647,300,46.36785162287481,morphological_dilation,3,2
0X776060BC74A34C5F.avi,44,1233,921,312,33.876221498371336,morphological_dilation,3,2
0X776060BC74A34C5F.avi,60,1114,810,304,37.53086419753087,morphological_dilation,3,2
0X77609B23026AAFAA.avi,50,1696,1316,380,28.87537993920973,morphological_dilation,3,2
0X77609B23026AAFAA.avi,73,1000,708,292,41.24293785310734,morphological_dilation,3,2
0X776400751536FD2E.avi,57,2926,2414,512,21.209610604805302,morphological_dilation,3,2
0X776400751536FD2E.avi,72,1631,1235,396,32.064777327935225,morphological_dilation,3,2
0X77666FD212028DA8.avi,38,1742,1378,364,26.41509433962264,morphological_dilation,3,2
0X77666FD212028DA8.avi,53,1042,760,282,37.10526315789473,morphological_dilation,3,2
0X77673F84D3540E92.avi,66,1386,1054,332,31.499051233396585,morphological_dilation,3,2
0X77673F84D3540E92.avi,81,795,539,256,47.49536178107607,morphological_dilation,3,2
0X777110E46D3D382.avi,47,1609,1253,356,28.41181165203512,morphological_dilation,3,2
0X777110E46D3D382.avi,65,910,606,304,50.165016501650165,morphological_dilation,3,2
0X77714EEC1C79CC7F.avi,0,1689,1297,392,30.223592906707786,morphological_dilation,3,2
0X77714EEC1C79CC7F.avi,19,1008,704,304,43.18181818181818,morphological_dilation,3,2
0X7771F923B288DDB7.avi,53,2450,1994,456,22.868605817452355,morphological_dilation,3,2
0X7771F923B288DDB7.avi,75,1591,1223,368,30.08994276369583,morphological_dilation,3,2
0X7775D4576C04313E.avi,42,2092,1680,412,24.523809523809522,morphological_dilation,3,2
0X7775D4576C04313E.avi,57,1366,1018,348,34.18467583497053,morphological_dilation,3,2
0X77762963F999DEE3.avi,97,1396,1056,340,32.196969696969695,morphological_dilation,3,2
0X77762963F999DEE3.avi,122,1103,795,308,38.742138364779876,morphological_dilation,3,2
0X777692B30E35465A.avi,87,1462,1107,355,32.068654019873534,morphological_dilation,3,2
0X777692B30E35465A.avi,112,1018,726,292,40.22038567493113,morphological_dilation,3,2
0X777EA631128ED080.avi,103,1512,1172,340,29.01023890784983,morphological_dilation,3,2
0X777EA631128ED080.avi,116,935,651,284,43.625192012288785,morphological_dilation,3,2
0X778935C329CC1789.avi,103,1764,1404,360,25.64102564102564,morphological_dilation,3,2
0X778935C329CC1789.avi,116,1312,984,328,33.33333333333333,morphological_dilation,3,2
0X778CB82CED72873C.avi,51,2249,1817,432,23.775454045129337,morphological_dilation,3,2
0X778CB82CED72873C.avi,71,1299,961,338,35.17169614984391,morphological_dilation,3,2
0X778CFD575FF2145E.avi,56,1284,960,324,33.75,morphological_dilation,3,2
0X778CFD575FF2145E.avi,73,788,520,268,51.53846153846153,morphological_dilation,3,2
0X778D8A645214CBB0.avi,69,1765,1385,380,27.436823104693143,morphological_dilation,3,2
0X778D8A645214CBB0.avi,105,1122,816,306,37.5,morphological_dilation,3,2
0X7790F4DB18852455.avi,100,2328,1864,464,24.892703862660944,morphological_dilation,3,2
0X7790F4DB18852455.avi,116,1494,1102,392,35.57168784029038,morphological_dilation,3,2
0X7795868D5A8D56AC.avi,128,3260,2748,512,18.631732168850075,morphological_dilation,3,2
0X7795868D5A8D56AC.avi,144,2602,2126,476,22.389463781749765,morphological_dilation,3,2
0X779A65D152E67F94.avi,123,1449,1097,352,32.087511394712855,morphological_dilation,3,2
0X779A65D152E67F94.avi,143,967,667,300,44.97751124437781,morphological_dilation,3,2
0X779B9DB887C3B8C6.avi,43,2247,1815,432,23.801652892561982,morphological_dilation,3,2
0X779B9DB887C3B8C6.avi,60,1425,1077,348,32.31197771587744,morphological_dilation,3,2
0X779C1D2EE532F2FA.avi,49,1630,1246,384,30.818619582664525,morphological_dilation,3,2
0X779C1D2EE532F2FA.avi,67,1058,741,317,42.7800269905533,morphological_dilation,3,2
0X779CF7E0C461311.avi,1,1103,795,308,38.742138364779876,morphological_dilation,3,2
0X779CF7E0C461311.avi,15,768,500,268,53.6,morphological_dilation,3,2
0X77A2E6579D61CCC5.avi,31,2522,2066,456,22.07163601161665,morphological_dilation,3,2
0X77A2E6579D61CCC5.avi,45,1715,1332,383,28.753753753753752,morphological_dilation,3,2
0X77A68EB0325B1DFC.avi,33,1544,1196,348,29.09698996655518,morphological_dilation,3,2
0X77A68EB0325B1DFC.avi,46,1068,776,292,37.628865979381445,morphological_dilation,3,2
0X77A6AF7AADDA5798.avi,55,1896,1508,388,25.72944297082228,morphological_dilation,3,2
0X77A6AF7AADDA5798.avi,75,1279,959,320,33.36809176225234,morphological_dilation,3,2
0X77A6EEED554F8360.avi,45,1958,1492,466,31.233243967828418,morphological_dilation,3,2
0X77A6EEED554F8360.avi,64,1182,761,421,55.32194480946123,morphological_dilation,3,2
0X77AFF38EB600E72A.avi,82,1942,1550,392,25.290322580645164,morphological_dilation,3,2
0X77AFF38EB600E72A.avi,97,1244,924,320,34.63203463203463,morphological_dilation,3,2
0X77B0F03C4F1E0315.avi,51,1576,1202,374,31.114808652246257,morphological_dilation,3,2
0X77B0F03C4F1E0315.avi,68,1018,704,314,44.60227272727273,morphological_dilation,3,2
0X77B19349F044C8FF.avi,65,2474,2015,459,22.779156327543422,morphological_dilation,3,2
0X77B19349F044C8FF.avi,81,1772,1357,415,30.58216654384672,morphological_dilation,3,2
0X77B1CC9BB9CAF732.avi,34,1299,967,332,34.332988624612206,morphological_dilation,3,2
0X77B1CC9BB9CAF732.avi,50,969,662,307,46.37462235649547,morphological_dilation,3,2
0X77B797A13F96E759.avi,38,2286,1875,411,21.92,morphological_dilation,3,2
0X77B797A13F96E759.avi,54,2034,1654,380,22.97460701330109,morphological_dilation,3,2
0X77B8C03F736ABA4C.avi,43,1467,1127,340,30.168589174800353,morphological_dilation,3,2
0X77B8C03F736ABA4C.avi,62,1007,707,300,42.432814710042436,morphological_dilation,3,2
0X77C3278832702B6.avi,64,1530,1174,356,30.3236797274276,morphological_dilation,3,2
0X77C3278832702B6.avi,79,957,662,295,44.561933534743204,morphological_dilation,3,2
0X77C42751F7BDB257.avi,119,1697,1304,393,30.13803680981595,morphological_dilation,3,2
0X77C42751F7BDB257.avi,133,1006,633,373,58.92575039494471,morphological_dilation,3,2
0X77C5776C24812C92.avi,31,1680,1332,348,26.126126126126124,morphological_dilation,3,2
0X77C5776C24812C92.avi,48,1548,1204,344,28.57142857142857,morphological_dilation,3,2
0X77C6792EE63777FD.avi,82,1267,943,324,34.35843054082714,morphological_dilation,3,2
0X77C6792EE63777FD.avi,98,814,536,278,51.865671641791046,morphological_dilation,3,2
0X77CC33D53A20A219.avi,40,1639,1279,360,28.146989835809226,morphological_dilation,3,2
0X77CC33D53A20A219.avi,57,1064,748,316,42.24598930481284,morphological_dilation,3,2
0X77CF3CC14C7190A9.avi,37,1244,916,328,35.80786026200873,morphological_dilation,3,2
0X77CF3CC14C7190A9.avi,51,886,601,285,47.42096505823628,morphological_dilation,3,2
0X77D07E4FBCC59B0D.avi,50,1278,954,324,33.9622641509434,morphological_dilation,3,2
0X77D07E4FBCC59B0D.avi,69,769,517,252,48.74274661508704,morphological_dilation,3,2
0X77D12C545D5C9ACD.avi,49,1864,1484,380,25.60646900269542,morphological_dilation,3,2
0X77D12C545D5C9ACD.avi,65,1594,1238,356,28.75605815831987,morphological_dilation,3,2
0X77D53936A055CA6.avi,65,3276,2740,536,19.562043795620436,morphological_dilation,3,2
0X77D53936A055CA6.avi,87,1773,1353,420,31.042128603104214,morphological_dilation,3,2
0X77D9BAB1ED5B5837.avi,81,2452,1993,459,23.03060712493728,morphological_dilation,3,2
0X77D9BAB1ED5B5837.avi,101,1641,1243,398,32.01930812550282,morphological_dilation,3,2
0X77DA468737612781.avi,0,1406,1070,336,31.401869158878505,morphological_dilation,3,2
0X77DA468737612781.avi,15,827,563,264,46.89165186500888,morphological_dilation,3,2
0X77DFC0A0B3DA48DD.avi,60,1809,1398,411,29.399141630901287,morphological_dilation,3,2
0X77DFC0A0B3DA48DD.avi,87,1215,895,320,35.754189944134076,morphological_dilation,3,2
0X77E1E067C24C6E82.avi,60,2009,1593,416,26.1142498430634,morphological_dilation,3,2
0X77E1E067C24C6E82.avi,73,1323,974,349,35.831622176591374,morphological_dilation,3,2
0X77E79D44922605D6.avi,46,1846,1466,380,25.92087312414734,morphological_dilation,3,2
0X77E79D44922605D6.avi,62,1161,857,304,35.47257876312719,morphological_dilation,3,2
0X77EE3CD923A3952A.avi,56,2899,2411,488,20.240564081294067,morphological_dilation,3,2
0X77EE3CD923A3952A.avi,66,1980,1560,420,26.923076923076923,morphological_dilation,3,2
0X77EE9E3399043D40.avi,53,1769,1393,376,26.99210337401292,morphological_dilation,3,2
0X77EE9E3399043D40.avi,71,1077,765,312,40.78431372549019,morphological_dilation,3,2
0X77EF9056FBABD0D6.avi,113,1968,1578,390,24.714828897338403,morphological_dilation,3,2
0X77EF9056FBABD0D6.avi,130,1531,1195,336,28.117154811715483,morphological_dilation,3,2
0X77F114E014535570.avi,49,2538,2078,460,22.13666987487969,morphological_dilation,3,2
0X77F114E014535570.avi,66,1460,1112,348,31.294964028776977,morphological_dilation,3,2
0X77F14DF18E757A6A.avi,95,2521,2077,444,21.376986037554165,morphological_dilation,3,2
0X77F14DF18E757A6A.avi,111,1318,986,332,33.67139959432049,morphological_dilation,3,2
0X77F50BC6874F0950.avi,78,1956,1560,396,25.384615384615383,morphological_dilation,3,2
0X77F50BC6874F0950.avi,92,1344,1004,340,33.86454183266932,morphological_dilation,3,2
0X77F76DB5C3A42E76.avi,113,2546,2110,436,20.66350710900474,morphological_dilation,3,2
0X77F76DB5C3A42E76.avi,126,2277,1861,416,22.353573347662547,morphological_dilation,3,2
0X77F8C9F85AF592BF.avi,100,2196,1732,464,26.78983833718245,morphological_dilation,3,2
0X77F8C9F85AF592BF.avi,117,1295,923,372,40.30335861321777,morphological_dilation,3,2
0X77FC68F7D0062C8A.avi,117,1819,1435,384,26.7595818815331,morphological_dilation,3,2
0X77FC68F7D0062C8A.avi,131,1263,935,328,35.08021390374332,morphological_dilation,3,2
0X77FDD36CF78C6B3E.avi,0,1224,920,304,33.04347826086956,morphological_dilation,3,2
0X77FDD36CF78C6B3E.avi,18,768,500,268,53.6,morphological_dilation,3,2
0X77FE84AC7ED08242.avi,72,1331,1018,313,30.746561886051083,morphological_dilation,3,2
0X77FE84AC7ED08242.avi,82,858,593,265,44.68802698145025,morphological_dilation,3,2
0X7801FF9E1465E078.avi,94,2357,1909,448,23.467784180199057,morphological_dilation,3,2
0X7801FF9E1465E078.avi,114,1731,1355,376,27.74907749077491,morphological_dilation,3,2
0X7804E51BBB763327.avi,89,2187,1747,440,25.186033199771035,morphological_dilation,3,2
0X7804E51BBB763327.avi,105,1185,853,332,38.921453692848765,morphological_dilation,3,2
0X7807A42169BABF20.avi,93,1739,1347,392,29.101707498144023,morphological_dilation,3,2
0X7807A42169BABF20.avi,109,1102,772,330,42.74611398963731,morphological_dilation,3,2
0X7809B942D62CFBB5.avi,54,1792,1404,388,27.635327635327634,morphological_dilation,3,2
0X7809B942D62CFBB5.avi,72,1134,810,324,40.0,morphological_dilation,3,2
0X780AD0B949EEDBA0.avi,53,1063,791,272,34.38685208596713,morphological_dilation,3,2
0X780AD0B949EEDBA0.avi,71,742,514,228,44.3579766536965,morphological_dilation,3,2
0X780CE7F5E87A038.avi,1,1387,1047,340,32.473734479465136,morphological_dilation,3,2
0X780CE7F5E87A038.avi,15,860,596,264,44.29530201342282,morphological_dilation,3,2
0X780D5E4FEC1EC3B2.avi,126,1769,1385,384,27.72563176895307,morphological_dilation,3,2
0X780D5E4FEC1EC3B2.avi,147,1034,740,294,39.729729729729726,morphological_dilation,3,2
0X781152F1005A1522.avi,107,1127,795,332,41.76100628930818,morphological_dilation,3,2
0X781152F1005A1522.avi,131,1770,1378,392,28.44702467343977,morphological_dilation,3,2
0X78118555A5C07E29.avi,36,1850,1470,380,25.850340136054424,morphological_dilation,3,2
0X78118555A5C07E29.avi,52,1151,843,308,36.5361803084223,morphological_dilation,3,2
0X7817540F1219A27C.avi,2,1828,1444,384,26.59279778393352,morphological_dilation,3,2
0X7817540F1219A27C.avi,17,1183,851,332,39.01292596944771,morphological_dilation,3,2
0X781C2C22B0A7C2E3.avi,3,1615,1263,352,27.870150435471103,morphological_dilation,3,2
0X781C2C22B0A7C2E3.avi,16,1200,896,304,33.92857142857143,morphological_dilation,3,2
0X781D97826A1BF672.avi,76,2672,2200,472,21.454545454545453,morphological_dilation,3,2
0X781D97826A1BF672.avi,90,1656,1268,388,30.5993690851735,morphological_dilation,3,2
0X781FFD3CCFF0CA8E.avi,108,1565,1185,380,32.06751054852321,morphological_dilation,3,2
0X781FFD3CCFF0CA8E.avi,126,1076,760,316,41.578947368421055,morphological_dilation,3,2
0X78284C66D3F96F3.avi,0,1203,891,312,35.01683501683502,morphological_dilation,3,2
0X78284C66D3F96F3.avi,16,787,523,264,50.47801147227533,morphological_dilation,3,2
0X782AA3BADF83BB72.avi,68,3296,2792,504,18.05157593123209,morphological_dilation,3,2
0X782AA3BADF83BB72.avi,85,3085,2601,484,18.608227604767396,morphological_dilation,3,2
0X7833AEF73CFD8BD5.avi,107,1844,1460,384,26.301369863013697,morphological_dilation,3,2
0X7833AEF73CFD8BD5.avi,124,1058,762,296,38.84514435695538,morphological_dilation,3,2
0X783756A8026DBC56.avi,58,2584,2108,476,22.58064516129032,morphological_dilation,3,2
0X783756A8026DBC56.avi,72,1821,1433,388,27.076064200976973,morphological_dilation,3,2
0X78434E61DCE25DC8.avi,117,1196,908,288,31.718061674008812,morphological_dilation,3,2
0X78434E61DCE25DC8.avi,127,888,621,267,42.99516908212561,morphological_dilation,3,2
0X7843FB4B296F52B6.avi,102,1789,1421,368,25.8972554539057,morphological_dilation,3,2
0X7843FB4B296F52B6.avi,117,1283,959,324,33.7851929092805,morphological_dilation,3,2
0X7846A393403DCE9A.avi,128,1052,760,292,38.421052631578945,morphological_dilation,3,2
0X7846A393403DCE9A.avi,144,704,452,252,55.75221238938053,morphological_dilation,3,2
0X7849B8B5FE76FE05.avi,48,1197,845,352,41.65680473372781,morphological_dilation,3,2
0X7849B8B5FE76FE05.avi,63,713,429,284,66.2004662004662,morphological_dilation,3,2
0X7849D7A045150574.avi,103,1523,1159,364,31.406384814495254,morphological_dilation,3,2
0X7849D7A045150574.avi,124,862,598,264,44.14715719063545,morphological_dilation,3,2
0X784E5B7183AC020E.avi,4,1825,1438,387,26.912378303198885,morphological_dilation,3,2
0X784E5B7183AC020E.avi,21,1160,844,316,37.44075829383886,morphological_dilation,3,2
0X7850CA363820BC1C.avi,86,1713,1330,383,28.79699248120301,morphological_dilation,3,2
0X7850CA363820BC1C.avi,105,972,684,288,42.10526315789473,morphological_dilation,3,2
0X7855B4CFD2774B4A.avi,88,2080,1664,416,25.0,morphological_dilation,3,2
0X7855B4CFD2774B4A.avi,102,1534,1166,368,31.56089193825043,morphological_dilation,3,2
0X7858426972D973B3.avi,103,2785,2317,468,20.198532585239533,morphological_dilation,3,2
0X7858426972D973B3.avi,120,1875,1475,400,27.11864406779661,morphological_dilation,3,2
0X78586838FB284ED2.avi,162,1881,1478,403,27.266576454668474,morphological_dilation,3,2
0X78586838FB284ED2.avi,185,2378,1942,436,22.451081359423274,morphological_dilation,3,2
0X78591777FB7F524B.avi,81,1836,1420,416,29.295774647887324,morphological_dilation,3,2
0X78591777FB7F524B.avi,92,1131,792,339,42.803030303030305,morphological_dilation,3,2
0X7859D0AF85077667.avi,55,1289,933,356,38.156484458735264,morphological_dilation,3,2
0X7859D0AF85077667.avi,72,767,488,279,57.17213114754098,morphological_dilation,3,2
0X785B0B7BAD1E6DF0.avi,59,1566,1194,372,31.155778894472363,morphological_dilation,3,2
0X785B0B7BAD1E6DF0.avi,77,1012,692,320,46.24277456647399,morphological_dilation,3,2
0X785B6EB4524C1CD3.avi,32,2321,1889,432,22.869242985706723,morphological_dilation,3,2
0X785B6EB4524C1CD3.avi,46,1358,990,368,37.17171717171717,morphological_dilation,3,2
0X785B8C83B95EA6C4.avi,2,1997,1585,412,25.993690851735018,morphological_dilation,3,2
0X785B8C83B95EA6C4.avi,23,1335,991,344,34.71241170534813,morphological_dilation,3,2
0X78603C5A9F6ADF4E.avi,44,2754,2106,648,30.76923076923077,morphological_dilation,3,2
0X78603C5A9F6ADF4E.avi,62,2215,1629,586,35.972989564149785,morphological_dilation,3,2
0X786686A9B8DE6547.avi,70,964,680,284,41.76470588235294,morphological_dilation,3,2
0X786686A9B8DE6547.avi,84,593,372,221,59.40860215053764,morphological_dilation,3,2
0X786F77982DF76767.avi,89,1092,784,308,39.285714285714285,morphological_dilation,3,2
0X786F77982DF76767.avi,97,718,462,256,55.41125541125541,morphological_dilation,3,2
0X786F954EC983199B.avi,52,1429,1089,340,31.22130394857668,morphological_dilation,3,2
0X786F954EC983199B.avi,70,900,612,288,47.05882352941176,morphological_dilation,3,2
0X7871A13A25E72847.avi,84,2398,1938,460,23.735810113519094,morphological_dilation,3,2
0X7871A13A25E72847.avi,101,1588,1200,388,32.33333333333333,morphological_dilation,3,2
0X7872F013CA424271.avi,84,1339,1015,324,31.92118226600985,morphological_dilation,3,2
0X7872F013CA424271.avi,113,880,604,276,45.6953642384106,morphological_dilation,3,2
0X787792F77911F6F.avi,50,2427,1983,444,22.390317700453856,morphological_dilation,3,2
0X787792F77911F6F.avi,70,2239,1815,424,23.360881542699723,morphological_dilation,3,2
0X787E4FC76615DF81.avi,70,1216,889,327,36.782902137232846,morphological_dilation,3,2
0X787E4FC76615DF81.avi,79,809,540,269,49.81481481481482,morphological_dilation,3,2
0X7889C9C82EAA329B.avi,40,1523,1167,356,30.505569837189373,morphological_dilation,3,2
0X7889C9C82EAA329B.avi,48,986,667,319,47.82608695652174,morphological_dilation,3,2
0X788B2560A356EFFD.avi,118,2872,2384,488,20.469798657718123,morphological_dilation,3,2
0X788B2560A356EFFD.avi,132,1908,1504,404,26.861702127659576,morphological_dilation,3,2
0X788C21FC83ECEA3.avi,130,2473,2002,471,23.526473526473527,morphological_dilation,3,2
0X788C21FC83ECEA3.avi,148,1647,1260,387,30.714285714285715,morphological_dilation,3,2
0X788E36C66B235B5.avi,53,1197,881,316,35.8683314415437,morphological_dilation,3,2
0X788E36C66B235B5.avi,69,804,524,280,53.43511450381679,morphological_dilation,3,2
0X7891B8459BC3756F.avi,77,1671,1311,360,27.45995423340961,morphological_dilation,3,2
0X7891B8459BC3756F.avi,92,998,698,300,42.97994269340974,morphological_dilation,3,2
0X78926CFAF2EA0A0.avi,3,1997,1609,388,24.114356743318833,morphological_dilation,3,2
0X78926CFAF2EA0A0.avi,20,1174,860,314,36.51162790697675,morphological_dilation,3,2
0X78980D66F6E94B79.avi,100,1730,1343,387,28.81608339538347,morphological_dilation,3,2
0X78980D66F6E94B79.avi,118,1048,748,300,40.106951871657756,morphological_dilation,3,2
0X78981EA114F87C17.avi,105,2555,2103,452,21.493105087969568,morphological_dilation,3,2
0X78981EA114F87C17.avi,126,1542,1190,352,29.57983193277311,morphological_dilation,3,2
0X789C6979A03B622B.avi,66,2004,1592,412,25.879396984924625,morphological_dilation,3,2
0X789C6979A03B622B.avi,81,1274,930,344,36.98924731182795,morphological_dilation,3,2
0X789F3DB99F9D56CE.avi,57,1627,1271,356,28.009441384736427,morphological_dilation,3,2
0X789F3DB99F9D56CE.avi,74,1017,713,304,42.6367461430575,morphological_dilation,3,2
0X78A2ADFE42F241BD.avi,58,1222,890,332,37.30337078651685,morphological_dilation,3,2
0X78A2ADFE42F241BD.avi,79,741,489,252,51.533742331288344,morphological_dilation,3,2
0X78A317925103BFA3.avi,79,1466,1110,356,32.072072072072075,morphological_dilation,3,2
0X78A317925103BFA3.avi,91,973,649,324,49.922958397534664,morphological_dilation,3,2
0X78A41CFB09841F00.avi,5,2017,1629,388,23.8182934315531,morphological_dilation,3,2
0X78A41CFB09841F00.avi,24,1308,984,324,32.926829268292686,morphological_dilation,3,2
0X78A6383CDA0DFA47.avi,81,1177,881,296,33.59818388195232,morphological_dilation,3,2
0X78A6383CDA0DFA47.avi,100,786,542,244,45.018450184501845,morphological_dilation,3,2
0X78A712A3ED524435.avi,34,3245,2692,553,20.54234769687964,morphological_dilation,3,2
0X78A712A3ED524435.avi,48,1615,1102,513,46.55172413793103,morphological_dilation,3,2
0X78A88D003F122C35.avi,35,1650,1270,380,29.92125984251969,morphological_dilation,3,2
0X78A88D003F122C35.avi,52,1130,798,332,41.60401002506266,morphological_dilation,3,2
0X78AB39630A7770BC.avi,2,1773,1389,384,27.645788336933048,morphological_dilation,3,2
0X78AB39630A7770BC.avi,20,1164,836,328,39.23444976076555,morphological_dilation,3,2
0X78AC53487A0B4174.avi,178,1980,1580,400,25.31645569620253,morphological_dilation,3,2
0X78AC53487A0B4174.avi,195,1305,949,356,37.5131717597471,morphological_dilation,3,2
0X78B1A9C5DBBE470C.avi,51,1280,956,324,33.89121338912134,morphological_dilation,3,2
0X78B1A9C5DBBE470C.avi,66,721,477,244,51.15303983228512,morphological_dilation,3,2
0X78BAA3A2FD0AE7F1.avi,34,1875,1487,388,26.09280430396772,morphological_dilation,3,2
0X78BAA3A2FD0AE7F1.avi,50,1259,915,344,37.595628415300546,morphological_dilation,3,2
0X78C330A341555880.avi,41,1273,953,320,33.57817418677859,morphological_dilation,3,2
0X78C330A341555880.avi,56,763,487,276,56.67351129363449,morphological_dilation,3,2
0X78C6315BF03ABDA0.avi,37,1064,776,288,37.11340206185567,morphological_dilation,3,2
0X78C6315BF03ABDA0.avi,52,949,677,272,40.177252584933534,morphological_dilation,3,2
0X78C8E91921348D87.avi,65,1685,1329,356,26.787057938299476,morphological_dilation,3,2
0X78C8E91921348D87.avi,79,1037,741,296,39.94601889338731,morphological_dilation,3,2
0X78CDE711CB9223A5.avi,118,2123,1703,420,24.662360540223137,morphological_dilation,3,2
0X78CDE711CB9223A5.avi,135,1338,994,344,34.60764587525151,morphological_dilation,3,2
0X78D655F26D43004C.avi,58,1494,1146,348,30.36649214659686,morphological_dilation,3,2
0X78D655F26D43004C.avi,74,878,590,288,48.8135593220339,morphological_dilation,3,2
0X78D7E9160D4678EA.avi,58,1176,868,308,35.483870967741936,morphological_dilation,3,2
0X78D7E9160D4678EA.avi,74,727,471,256,54.35244161358811,morphological_dilation,3,2
0X78DC5645033F242A.avi,158,1906,1530,376,24.57516339869281,morphological_dilation,3,2
0X78DC5645033F242A.avi,176,1411,1079,332,30.76923076923077,morphological_dilation,3,2
0X78ED1868FE9D92E.avi,139,3709,3125,584,18.688,morphological_dilation,3,2
0X78ED1868FE9D92E.avi,173,2944,2420,524,21.65289256198347,morphological_dilation,3,2
0X78EF8C888EA44499.avi,82,2760,2285,475,20.787746170678336,morphological_dilation,3,2
0X78EF8C888EA44499.avi,103,1823,1423,400,28.109627547434997,morphological_dilation,3,2
0X78F080F8C0B17CAC.avi,105,1942,1510,432,28.60927152317881,morphological_dilation,3,2
0X78F080F8C0B17CAC.avi,127,1383,1007,376,37.33862959285005,morphological_dilation,3,2
0X78F0A016752E04BC.avi,56,948,668,280,41.91616766467065,morphological_dilation,3,2
0X78F0A016752E04BC.avi,69,579,359,220,61.28133704735376,morphological_dilation,3,2
0X78FAF371B4DBE44E.avi,100,2636,2144,492,22.94776119402985,morphological_dilation,3,2
0X78FAF371B4DBE44E.avi,119,1741,1329,412,31.000752445447706,morphological_dilation,3,2
0X78FC560A2C3016C8.avi,158,1248,924,324,35.064935064935064,morphological_dilation,3,2
0X78FC560A2C3016C8.avi,172,777,505,272,53.86138613861387,morphological_dilation,3,2
0X790031A481B03F12.avi,86,1339,981,358,36.493374108053004,morphological_dilation,3,2
0X790031A481B03F12.avi,93,853,549,304,55.373406193078324,morphological_dilation,3,2
0X7904206A590AD5FF.avi,118,1348,1004,344,34.26294820717131,morphological_dilation,3,2
0X7904206A590AD5FF.avi,133,820,508,312,61.417322834645674,morphological_dilation,3,2
0X7904526507C77812.avi,130,2570,2106,464,22.032288698955366,morphological_dilation,3,2
0X7904526507C77812.avi,146,1576,1204,372,30.89700996677741,morphological_dilation,3,2
0X790508AEB126988F.avi,28,1509,1173,336,28.644501278772378,morphological_dilation,3,2
0X790508AEB126988F.avi,48,1171,875,296,33.82857142857143,morphological_dilation,3,2
0X7906AC315D6DF35C.avi,67,1129,805,324,40.24844720496895,morphological_dilation,3,2
0X7906AC315D6DF35C.avi,84,719,459,260,56.644880174291934,morphological_dilation,3,2
0X790A3B476F1281A1.avi,34,2490,2058,432,20.99125364431487,morphological_dilation,3,2
0X790A3B476F1281A1.avi,45,2056,1660,396,23.85542168674699,morphological_dilation,3,2
0X790C79124FE1C985.avi,140,1570,1194,376,31.490787269681743,morphological_dilation,3,2
0X790C79124FE1C985.avi,157,990,686,304,44.31486880466473,morphological_dilation,3,2
0X790C871B162806D2.avi,0,1579,1227,352,28.687856560717194,morphological_dilation,3,2
0X790C871B162806D2.avi,18,1041,753,288,38.24701195219124,morphological_dilation,3,2
0X790DD9CAD22463CA.avi,29,1272,932,340,36.48068669527897,morphological_dilation,3,2
0X790DD9CAD22463CA.avi,40,958,653,305,46.70750382848392,morphological_dilation,3,2
0X790F741C3212659B.avi,44,1414,1074,340,31.65735567970205,morphological_dilation,3,2
0X790F741C3212659B.avi,61,906,618,288,46.601941747572816,morphological_dilation,3,2
0X79116483627C83FB.avi,38,3140,2636,504,19.119878603945374,morphological_dilation,3,2
0X79116483627C83FB.avi,55,2531,2079,452,21.741221741221743,morphological_dilation,3,2
0X79137B32737A8141.avi,60,1440,1092,348,31.868131868131865,morphological_dilation,3,2
0X79137B32737A8141.avi,78,881,605,276,45.6198347107438,morphological_dilation,3,2
0X7915D945D952B139.avi,87,2096,1700,396,23.294117647058822,morphological_dilation,3,2
0X7915D945D952B139.avi,101,1276,960,316,32.916666666666664,morphological_dilation,3,2
0X7917B2BCFC48DE01.avi,68,1989,1573,416,26.446280991735538,morphological_dilation,3,2
0X7917B2BCFC48DE01.avi,89,1142,803,339,42.21668742216688,morphological_dilation,3,2
0X7921E34728F85917.avi,37,2362,1914,448,23.406478578892372,morphological_dilation,3,2
0X7921E34728F85917.avi,56,1408,1056,352,33.33333333333333,morphological_dilation,3,2
0X7923B6B4614AF456.avi,4,1779,1407,372,26.439232409381663,morphological_dilation,3,2
0X7923B6B4614AF456.avi,18,1301,962,339,35.23908523908524,morphological_dilation,3,2
0X7923DC7612E3B47.avi,37,1166,852,314,36.85446009389671,morphological_dilation,3,2
0X7923DC7612E3B47.avi,52,652,408,244,59.80392156862745,morphological_dilation,3,2
0X7925C344B4A5872F.avi,22,1463,1087,376,34.590616375344986,morphological_dilation,3,2
0X7925C344B4A5872F.avi,56,2572,2088,484,23.18007662835249,morphological_dilation,3,2
0X7928A2EE4CEF22F6.avi,58,1852,1468,384,26.158038147138964,morphological_dilation,3,2
0X7928A2EE4CEF22F6.avi,76,1471,1119,352,31.456657730116177,morphological_dilation,3,2
0X792BB639F04589BF.avi,2,2829,2341,488,20.845792396411788,morphological_dilation,3,2
0X792BB639F04589BF.avi,25,1864,1464,400,27.322404371584703,morphological_dilation,3,2
0X792F6CC3B5F51F92.avi,31,1210,878,332,37.81321184510251,morphological_dilation,3,2
0X792F6CC3B5F51F92.avi,44,729,469,260,55.437100213219615,morphological_dilation,3,2
0X792FD48B11CB327F.avi,113,1357,1029,328,31.875607385811467,morphological_dilation,3,2
0X792FD48B11CB327F.avi,128,854,586,268,45.73378839590443,morphological_dilation,3,2
0X7933EC90C09036BB.avi,77,1931,1535,396,25.798045602605864,morphological_dilation,3,2
0X7933EC90C09036BB.avi,91,1321,969,352,36.326109391124874,morphological_dilation,3,2
0X7934C29136B9E43E.avi,35,1696,1332,364,27.32732732732733,morphological_dilation,3,2
0X7934C29136B9E43E.avi,53,1704,1212,492,40.5940594059406,morphological_dilation,3,2
0X793578146859F2C9.avi,74,1724,1348,376,27.89317507418398,morphological_dilation,3,2
0X793578146859F2C9.avi,94,1038,742,296,39.892183288409704,morphological_dilation,3,2
0X793831EF15DE432A.avi,70,1822,1428,394,27.591036414565828,morphological_dilation,3,2
0X793831EF15DE432A.avi,83,1180,852,328,38.497652582159624,morphological_dilation,3,2
0X7943AD7E68A9860E.avi,50,1514,1154,360,31.195840554592717,morphological_dilation,3,2
0X7943AD7E68A9860E.avi,73,995,689,306,44.412191582002905,morphological_dilation,3,2
0X794FD97F585E5500.avi,56,1337,1005,332,33.03482587064677,morphological_dilation,3,2
0X794FD97F585E5500.avi,69,852,580,272,46.89655172413793,morphological_dilation,3,2
0X794FDC47120BED40.avi,36,1365,1019,346,33.954857703631006,morphological_dilation,3,2
0X794FDC47120BED40.avi,49,948,657,291,44.29223744292237,morphological_dilation,3,2
0X795D88887DD0C961.avi,61,2972,2480,492,19.838709677419356,morphological_dilation,3,2
0X795D88887DD0C961.avi,78,1768,1392,376,27.011494252873565,morphological_dilation,3,2
0X79604A39051DBA4E.avi,92,1969,1513,456,30.138797091870455,morphological_dilation,3,2
0X79604A39051DBA4E.avi,114,1185,813,372,45.75645756457565,morphological_dilation,3,2
0X7961335E2F13823A.avi,80,2202,1758,444,25.25597269624573,morphological_dilation,3,2
0X7961335E2F13823A.avi,94,1253,903,350,38.759689922480625,morphological_dilation,3,2
0X79669F8008E1EB9B.avi,79,3848,3312,536,16.183574879227052,morphological_dilation,3,2
0X79669F8008E1EB9B.avi,90,3562,3050,512,16.78688524590164,morphological_dilation,3,2
0X7968FBFB3A8B73D4.avi,48,2652,2176,476,21.875,morphological_dilation,3,2
0X7968FBFB3A8B73D4.avi,69,1824,1428,396,27.73109243697479,morphological_dilation,3,2
0X796D96C289660E32.avi,86,1475,1116,359,32.168458781362006,morphological_dilation,3,2
0X796D96C289660E32.avi,98,874,570,304,53.333333333333336,morphological_dilation,3,2
0X796FE72A47DAC27A.avi,0,1696,1336,360,26.94610778443114,morphological_dilation,3,2
0X796FE72A47DAC27A.avi,17,954,662,292,44.10876132930513,morphological_dilation,3,2
0X797680E4E4D3A9EC.avi,83,3485,2949,536,18.175652763648696,morphological_dilation,3,2
0X797680E4E4D3A9EC.avi,101,2326,1878,448,23.85516506922258,morphological_dilation,3,2
0X797CA10A7CDE384B.avi,60,1489,1133,356,31.42100617828773,morphological_dilation,3,2
0X797CA10A7CDE384B.avi,80,831,506,325,64.2292490118577,morphological_dilation,3,2
0X7981CC0C94FC7EFC.avi,50,2146,1707,439,25.717633274751023,morphological_dilation,3,2
0X7981CC0C94FC7EFC.avi,65,1590,1210,380,31.40495867768595,morphological_dilation,3,2
0X7985E3E4BA6F1EEA.avi,60,1454,1110,344,30.99099099099099,morphological_dilation,3,2
0X7985E3E4BA6F1EEA.avi,86,884,584,300,51.369863013698634,morphological_dilation,3,2
0X798EA367FD9FD1EA.avi,75,928,644,284,44.099378881987576,morphological_dilation,3,2
0X798EA367FD9FD1EA.avi,103,1581,1245,336,26.987951807228917,morphological_dilation,3,2
0X7991910507FF074F.avi,102,1907,1511,396,26.207809397749838,morphological_dilation,3,2
0X7991910507FF074F.avi,120,1101,781,320,40.973111395646605,morphological_dilation,3,2
0X79921FA17BDD6678.avi,43,1900,1504,396,26.329787234042552,morphological_dilation,3,2
0X79921FA17BDD6678.avi,58,1275,920,355,38.58695652173913,morphological_dilation,3,2
0X79921FB7E516EE1F.avi,94,1308,976,332,34.01639344262295,morphological_dilation,3,2
0X79921FB7E516EE1F.avi,112,813,545,268,49.174311926605505,morphological_dilation,3,2
0X799797D05A6A8328.avi,80,1637,1257,380,30.23070803500398,morphological_dilation,3,2
0X799797D05A6A8328.avi,93,1150,824,326,39.56310679611651,morphological_dilation,3,2
0X799A232B2818C3BB.avi,104,2340,1912,428,22.384937238493723,morphological_dilation,3,2
0X799A232B2818C3BB.avi,119,1750,1347,403,29.91833704528582,morphological_dilation,3,2
0X799F64CF2E4B98EB.avi,55,1407,1067,340,31.865042174320525,morphological_dilation,3,2
0X799F64CF2E4B98EB.avi,78,939,655,284,43.358778625954194,morphological_dilation,3,2
0X79A37CEF1E1797D9.avi,44,2338,1872,466,24.89316239316239,morphological_dilation,3,2
0X79A37CEF1E1797D9.avi,57,1265,913,352,38.55421686746988,morphological_dilation,3,2
0X79AD01697FA403C6.avi,45,1686,1294,392,30.29366306027821,morphological_dilation,3,2
0X79AD01697FA403C6.avi,61,1078,738,340,46.070460704607044,morphological_dilation,3,2
0X79B116E3D0B6B1E2.avi,107,1300,972,328,33.744855967078195,morphological_dilation,3,2
0X79B116E3D0B6B1E2.avi,125,870,594,276,46.464646464646464,morphological_dilation,3,2
0X79B3467FF294267F.avi,0,2687,2223,464,20.872694556905085,morphological_dilation,3,2
0X79B3467FF294267F.avi,19,1726,1343,383,28.51824274013403,morphological_dilation,3,2
0X79B8C7CC275750D0.avi,122,1489,1088,401,36.856617647058826,morphological_dilation,3,2
0X79B8C7CC275750D0.avi,137,931,588,343,58.333333333333336,morphological_dilation,3,2
0X79BFA0749EA72B51.avi,59,1969,1569,400,25.493945188017847,morphological_dilation,3,2
0X79BFA0749EA72B51.avi,84,1259,939,320,34.07880724174654,morphological_dilation,3,2
0X79C4711A7BF18DD9.avi,100,1556,1184,372,31.41891891891892,morphological_dilation,3,2
0X79C4711A7BF18DD9.avi,118,955,658,297,45.13677811550152,morphological_dilation,3,2
0X79C5E146E59872EA.avi,47,1839,1447,392,27.090532135452662,morphological_dilation,3,2
0X79C5E146E59872EA.avi,62,1047,739,308,41.67794316644114,morphological_dilation,3,2
0X79CBB5F0922D0FDC.avi,102,1237,917,320,34.89640130861505,morphological_dilation,3,2
0X79CBB5F0922D0FDC.avi,121,747,499,248,49.69939879759519,morphological_dilation,3,2
0X79CCAED9E51AB16.avi,93,1834,1454,380,26.13480055020633,morphological_dilation,3,2
0X79CCAED9E51AB16.avi,119,1097,755,342,45.29801324503311,morphological_dilation,3,2
0X79CDCC08F41F94D8.avi,37,2179,1720,459,26.686046511627907,morphological_dilation,3,2
0X79CDCC08F41F94D8.avi,51,1209,791,418,52.84450063211125,morphological_dilation,3,2
0X79D202AB0932C8A8.avi,46,1781,1393,388,27.85355348169419,morphological_dilation,3,2
0X79D202AB0932C8A8.avi,61,1115,783,332,42.40102171136654,morphological_dilation,3,2
0X79D21EF8F7119A68.avi,44,1776,1392,384,27.586206896551722,morphological_dilation,3,2
0X79D21EF8F7119A68.avi,63,1451,1107,344,31.07497741644083,morphological_dilation,3,2
0X79D327865853B75E.avi,67,2578,2110,468,22.180094786729857,morphological_dilation,3,2
0X79D327865853B75E.avi,84,1599,1207,392,32.47721623860812,morphological_dilation,3,2
0X79D4284DDF83A529.avi,2,1478,1110,368,33.153153153153156,morphological_dilation,3,2
0X79D4284DDF83A529.avi,19,891,607,284,46.787479406919275,morphological_dilation,3,2
0X79DB58E266AEB979.avi,50,1995,1591,404,25.39283469516028,morphological_dilation,3,2
0X79DB58E266AEB979.avi,59,1631,1251,380,30.37569944044764,morphological_dilation,3,2
0X79DC993B122D6A82.avi,82,2823,2327,496,21.3149978513107,morphological_dilation,3,2
0X79DC993B122D6A82.avi,93,1612,1224,388,31.699346405228756,morphological_dilation,3,2
0X79DD4F3B7A13EEA2.avi,63,1598,1222,376,30.76923076923077,morphological_dilation,3,2
0X79DD4F3B7A13EEA2.avi,79,1498,1138,360,31.63444639718805,morphological_dilation,3,2
0X79DFA3F8C5BD03E1.avi,49,1791,1411,380,26.93125442948264,morphological_dilation,3,2
0X79DFA3F8C5BD03E1.avi,65,1599,1247,352,28.22774659182037,morphological_dilation,3,2
0X79DFCFF4867CB797.avi,78,1411,1055,356,33.74407582938389,morphological_dilation,3,2
0X79DFCFF4867CB797.avi,100,1040,740,300,40.54054054054054,morphological_dilation,3,2
0X79E1574A83CD787C.avi,97,1104,788,316,40.10152284263959,morphological_dilation,3,2
0X79E1574A83CD787C.avi,118,705,453,252,55.62913907284768,morphological_dilation,3,2
0X79E1F33063F55D0.avi,90,2612,2172,440,20.257826887661142,morphological_dilation,3,2
0X79E1F33063F55D0.avi,107,1801,1425,376,26.385964912280702,morphological_dilation,3,2
0X79E246BD39A8835E.avi,86,1580,1212,368,30.363036303630363,morphological_dilation,3,2
0X79E246BD39A8835E.avi,104,955,651,304,46.6973886328725,morphological_dilation,3,2
0X79E2DE8393F31357.avi,24,1535,1187,348,29.31760741364785,morphological_dilation,3,2
0X79E2DE8393F31357.avi,41,1305,936,369,39.42307692307692,morphological_dilation,3,2
0X79E5E594E59FA593.avi,96,1500,1128,372,32.97872340425532,morphological_dilation,3,2
0X79E5E594E59FA593.avi,114,957,645,312,48.372093023255815,morphological_dilation,3,2
0X79E5EFBA02DBE63D.avi,43,1496,1132,364,32.15547703180212,morphological_dilation,3,2
0X79E5EFBA02DBE63D.avi,60,964,664,300,45.18072289156627,morphological_dilation,3,2
0X79E6261DF5CE752C.avi,104,1517,1161,356,30.663221360895783,morphological_dilation,3,2
0X79E6261DF5CE752C.avi,115,940,646,294,45.51083591331269,morphological_dilation,3,2
0X79E68FC6793DC38D.avi,82,1891,1491,400,26.82763246143528,morphological_dilation,3,2
0X79E68FC6793DC38D.avi,97,1084,768,316,41.14583333333333,morphological_dilation,3,2
0X79EC6D48771F2C16.avi,32,1821,1409,412,29.240596167494676,morphological_dilation,3,2
0X79EC6D48771F2C16.avi,38,1155,825,330,40.0,morphological_dilation,3,2
0X79EEEACC28A079B3.avi,126,1755,1359,396,29.13907284768212,morphological_dilation,3,2
0X79EEEACC28A079B3.avi,142,1066,742,324,43.66576819407008,morphological_dilation,3,2
0X79EF2E23A698C2B1.avi,46,4058,3458,600,17.35106998264893,morphological_dilation,3,2
0X79EF2E23A698C2B1.avi,58,2804,2284,520,22.76707530647986,morphological_dilation,3,2
0X79F1B78EF230D0C.avi,108,1999,1599,400,25.01563477173233,morphological_dilation,3,2
0X79F1B78EF230D0C.avi,128,1284,948,336,35.44303797468354,morphological_dilation,3,2
0X79F95870BD482C00.avi,68,2750,2271,479,21.092029942756497,morphological_dilation,3,2
0X79F95870BD482C00.avi,89,1681,1255,426,33.94422310756972,morphological_dilation,3,2
0X79FD74BD1C6B18A1.avi,77,1936,1527,409,26.78454485920105,morphological_dilation,3,2
0X79FD74BD1C6B18A1.avi,95,1256,904,352,38.93805309734513,morphological_dilation,3,2
0X79FEA7283354A6D4.avi,90,1564,1220,344,28.196721311475407,morphological_dilation,3,2
0X79FEA7283354A6D4.avi,104,1061,755,306,40.52980132450331,morphological_dilation,3,2
0X7A0010EC59FC1A1C.avi,47,2544,2088,456,21.839080459770116,morphological_dilation,3,2
0X7A0010EC59FC1A1C.avi,59,1616,1236,380,30.74433656957929,morphological_dilation,3,2
0X7A0139AECBC02A88.avi,89,1586,1215,371,30.534979423868315,morphological_dilation,3,2
0X7A0139AECBC02A88.avi,107,961,667,294,44.07796101949025,morphological_dilation,3,2
0X7A0224D0CBD322D0.avi,39,1071,755,316,41.85430463576159,morphological_dilation,3,2
0X7A0224D0CBD322D0.avi,54,766,494,272,55.06072874493927,morphological_dilation,3,2
0X7A060E2FFC1A750C.avi,42,2904,2416,488,20.198675496688743,morphological_dilation,3,2
0X7A060E2FFC1A750C.avi,60,1975,1579,396,25.079164027865737,morphological_dilation,3,2
0X7A0A019AFB36B515.avi,59,1757,1397,360,25.769506084466716,morphological_dilation,3,2
0X7A0A019AFB36B515.avi,76,1614,1262,352,27.892234548335974,morphological_dilation,3,2
0X7A0D58570271FED5.avi,41,1566,1218,348,28.57142857142857,morphological_dilation,3,2
0X7A0D58570271FED5.avi,57,1204,900,304,33.77777777777778,morphological_dilation,3,2
0X7A0E6F5825AEC419.avi,105,1465,1125,340,30.22222222222222,morphological_dilation,3,2
0X7A0E6F5825AEC419.avi,137,905,621,284,45.73268921095008,morphological_dilation,3,2
0X7A0F2BE6B7655842.avi,96,1864,1484,380,25.60646900269542,morphological_dilation,3,2
0X7A0F2BE6B7655842.avi,114,1538,1182,356,30.118443316412858,morphological_dilation,3,2
0X7A10F6BCBD21FFD6.avi,77,1843,1463,380,25.97402597402597,morphological_dilation,3,2
0X7A10F6BCBD21FFD6.avi,95,1508,1168,340,29.10958904109589,morphological_dilation,3,2
0X7A12F53BAAE9016C.avi,4,2434,1978,456,23.053589484327603,morphological_dilation,3,2
0X7A12F53BAAE9016C.avi,21,1380,1020,360,35.294117647058826,morphological_dilation,3,2
0X7A153F772A883CA0.avi,33,1516,1148,368,32.05574912891986,morphological_dilation,3,2
0X7A153F772A883CA0.avi,47,915,627,288,45.933014354066984,morphological_dilation,3,2
0X7A18EB9388515AC6.avi,43,2930,2422,508,20.974401321222132,morphological_dilation,3,2
0X7A18EB9388515AC6.avi,56,2158,1694,464,27.390791027154666,morphological_dilation,3,2
0X7A19E0EBE51B99AD.avi,56,2228,1813,415,22.890237175951462,morphological_dilation,3,2
0X7A19E0EBE51B99AD.avi,73,1929,1533,396,25.83170254403131,morphological_dilation,3,2
0X7A1EF125CAECF905.avi,64,2504,2049,455,22.205954123962908,morphological_dilation,3,2
0X7A1EF125CAECF905.avi,85,1417,1061,356,33.55325164938737,morphological_dilation,3,2
0X7A21DE7A58B915DD.avi,1,1168,864,304,35.18518518518518,morphological_dilation,3,2
0X7A21DE7A58B915DD.avi,24,755,499,256,51.302605210420836,morphological_dilation,3,2
0X7A2F23DE3B4A8543.avi,52,2263,1823,440,24.136039495337354,morphological_dilation,3,2
0X7A2F23DE3B4A8543.avi,76,1764,1368,396,28.947368421052634,morphological_dilation,3,2
0X7A32FE05734D3EC6.avi,41,1853,1449,404,27.881297446514836,morphological_dilation,3,2
0X7A32FE05734D3EC6.avi,52,1142,830,312,37.59036144578313,morphological_dilation,3,2
0X7A36F71B6647D596.avi,63,1189,881,308,34.96027241770715,morphological_dilation,3,2
0X7A36F71B6647D596.avi,84,829,553,276,49.90958408679928,morphological_dilation,3,2
0X7A3ACD77CBDBB65.avi,42,2056,1644,412,25.060827250608277,morphological_dilation,3,2
0X7A3ACD77CBDBB65.avi,55,1166,854,312,36.53395784543326,morphological_dilation,3,2
0X7A3D3EC1A0D798F0.avi,1,5111,4455,656,14.725028058361392,morphological_dilation,3,2
0X7A3D3EC1A0D798F0.avi,16,3773,3193,580,18.164735358596932,morphological_dilation,3,2
0X7A3DFD0BC51267F8.avi,101,1733,1355,378,27.89667896678967,morphological_dilation,3,2
0X7A3DFD0BC51267F8.avi,116,1032,730,302,41.369863013698634,morphological_dilation,3,2
0X7A489C593ADEDF80.avi,95,1399,1051,348,33.111322549952426,morphological_dilation,3,2
0X7A489C593ADEDF80.avi,114,1024,728,296,40.65934065934066,morphological_dilation,3,2
0X7A49B980EAACB689.avi,148,1521,1177,344,29.226847918436704,morphological_dilation,3,2
0X7A49B980EAACB689.avi,163,1005,694,311,44.81268011527377,morphological_dilation,3,2
0X7A4ABCBDD9D9F33A.avi,36,1896,1483,413,27.84895482130816,morphological_dilation,3,2
0X7A4ABCBDD9D9F33A.avi,55,1131,799,332,41.55193992490614,morphological_dilation,3,2
0X7A4FD5194E7FAFF6.avi,45,1745,1365,380,27.83882783882784,morphological_dilation,3,2
0X7A4FD5194E7FAFF6.avi,61,1011,711,300,42.19409282700422,morphological_dilation,3,2
0X7A50108623519FF8.avi,86,1739,1343,396,29.486224869694716,morphological_dilation,3,2
0X7A50108623519FF8.avi,100,1066,746,320,42.89544235924933,morphological_dilation,3,2
0X7A5DA8496F2DF4B0.avi,45,2587,2119,468,22.085889570552148,morphological_dilation,3,2
0X7A5DA8496F2DF4B0.avi,56,1704,1316,388,29.48328267477204,morphological_dilation,3,2
0X7A616EA9F1DD0684.avi,60,1472,1124,348,30.96085409252669,morphological_dilation,3,2
0X7A616EA9F1DD0684.avi,76,911,627,284,45.29505582137161,morphological_dilation,3,2
0X7A61928840F41939.avi,69,735,495,240,48.484848484848484,morphological_dilation,3,2
0X7A61928840F41939.avi,84,444,243,201,82.71604938271605,morphological_dilation,3,2
0X7A61CC6DF656DB9E.avi,5,2118,1698,420,24.73498233215548,morphological_dilation,3,2
0X7A61CC6DF656DB9E.avi,19,1757,1377,380,27.596223674655047,morphological_dilation,3,2
0X7A620C5C256333CF.avi,164,2804,2316,488,21.070811744386873,morphological_dilation,3,2
0X7A620C5C256333CF.avi,189,1691,1307,384,29.380260137719972,morphological_dilation,3,2
0X7A66617547DFC6A9.avi,39,1235,911,324,35.56531284302964,morphological_dilation,3,2
0X7A66617547DFC6A9.avi,49,805,533,272,51.031894934333955,morphological_dilation,3,2
0X7A67867B96A7DB62.avi,88,1524,1160,364,31.379310344827587,morphological_dilation,3,2
0X7A67867B96A7DB62.avi,102,946,650,296,45.53846153846154,morphological_dilation,3,2
0X7A6EEE9D2CC4DDD8.avi,46,1506,1154,352,30.502599653379548,morphological_dilation,3,2
0X7A6EEE9D2CC4DDD8.avi,62,915,635,280,44.09448818897638,morphological_dilation,3,2
0X7A70F384131D3E87.avi,164,2421,1961,460,23.45741968383478,morphological_dilation,3,2
0X7A70F384131D3E87.avi,181,1694,1288,406,31.521739130434785,morphological_dilation,3,2
0X7A7323714436A96A.avi,45,1848,1464,384,26.229508196721312,morphological_dilation,3,2
0X7A7323714436A96A.avi,63,1060,764,296,38.7434554973822,morphological_dilation,3,2
0X7A753FB6A09BB7E7.avi,40,2457,2009,448,22.299651567944252,morphological_dilation,3,2
0X7A753FB6A09BB7E7.avi,55,1400,1048,352,33.587786259541986,morphological_dilation,3,2
0X7A75982F479C21BD.avi,54,2220,1780,440,24.719101123595504,morphological_dilation,3,2
0X7A75982F479C21BD.avi,71,1473,1089,384,35.26170798898072,morphological_dilation,3,2
0X7A761FAB53996A17.avi,102,1723,1343,380,28.294862248696944,morphological_dilation,3,2
0X7A761FAB53996A17.avi,118,974,686,288,41.98250728862974,morphological_dilation,3,2
0X7A764AEB1EEFFBE9.avi,1,1244,908,336,37.00440528634361,morphological_dilation,3,2
0X7A764AEB1EEFFBE9.avi,20,800,526,274,52.09125475285171,morphological_dilation,3,2
0X7A77DF8AACD6E023.avi,116,1430,1066,364,34.146341463414636,morphological_dilation,3,2
0X7A77DF8AACD6E023.avi,132,910,602,308,51.162790697674424,morphological_dilation,3,2
0X7A7D9FE81266344B.avi,166,1535,1163,372,31.986242476354253,morphological_dilation,3,2
0X7A7D9FE81266344B.avi,180,966,674,292,43.32344213649852,morphological_dilation,3,2
0X7A7FFFEB3BB8FACF.avi,58,1121,805,316,39.254658385093165,morphological_dilation,3,2
0X7A7FFFEB3BB8FACF.avi,73,656,408,248,60.78431372549019,morphological_dilation,3,2
0X7A801758B1E2422D.avi,41,1493,1129,364,32.24092116917626,morphological_dilation,3,2
0X7A801758B1E2422D.avi,53,879,590,289,48.983050847457626,morphological_dilation,3,2
0X7A85506EE6948707.avi,73,3116,2581,535,20.728399845021308,morphological_dilation,3,2
0X7A85506EE6948707.avi,88,2182,1719,463,26.934264107038974,morphological_dilation,3,2
0X7A85BE2A483D2B3F.avi,82,1434,1086,348,32.04419889502763,morphological_dilation,3,2
0X7A85BE2A483D2B3F.avi,98,800,536,264,49.25373134328358,morphological_dilation,3,2
0X7A878CE8EF95A413.avi,2,2291,1843,448,24.308193163320674,morphological_dilation,3,2
0X7A878CE8EF95A413.avi,18,1614,1223,391,31.97056418642682,morphological_dilation,3,2
0X7A8B5F7B228E4737.avi,35,2035,1611,424,26.31905648665425,morphological_dilation,3,2
0X7A8B5F7B228E4737.avi,46,1376,1020,356,34.90196078431372,morphological_dilation,3,2
0X7A8E80694D4485A8.avi,101,1821,1437,384,26.722338204592898,morphological_dilation,3,2
0X7A8E80694D4485A8.avi,118,1138,826,312,37.77239709443099,morphological_dilation,3,2
0X7A94BF20F663B054.avi,44,1995,1575,420,26.666666666666668,morphological_dilation,3,2
0X7A94BF20F663B054.avi,60,1216,872,344,39.44954128440367,morphological_dilation,3,2
0X7A97FAB0F842279A.avi,66,1074,770,304,39.48051948051948,morphological_dilation,3,2
0X7A97FAB0F842279A.avi,79,764,492,272,55.28455284552846,morphological_dilation,3,2
0X7A981DF5E84D198C.avi,95,3353,2814,539,19.154228855721392,morphological_dilation,3,2
0X7A981DF5E84D198C.avi,108,2108,1656,452,27.294685990338163,morphological_dilation,3,2
0X7A9F05D78B1F4919.avi,44,2777,2282,495,21.691498685363715,morphological_dilation,3,2
0X7A9F05D78B1F4919.avi,60,1834,1417,417,29.428369795342274,morphological_dilation,3,2
0X7AA24540A6E405A1.avi,52,2915,2419,496,20.504340636626704,morphological_dilation,3,2
0X7AA24540A6E405A1.avi,69,2455,1999,456,22.811405702851424,morphological_dilation,3,2
0X7AA34F9FBA7212D6.avi,42,1744,1388,356,25.64841498559078,morphological_dilation,3,2
0X7AA34F9FBA7212D6.avi,56,1139,831,308,37.063778580024064,morphological_dilation,3,2
0X7AAB12A381313F99.avi,39,1549,1197,352,29.406850459482037,morphological_dilation,3,2
0X7AAB12A381313F99.avi,55,909,637,272,42.700156985871274,morphological_dilation,3,2
0X7AB103757B8047FC.avi,60,1904,1484,420,28.30188679245283,morphological_dilation,3,2
0X7AB103757B8047FC.avi,76,1024,724,300,41.43646408839779,morphological_dilation,3,2
0X7AB1F1372A66F7FB.avi,124,1790,1407,383,27.221037668798864,morphological_dilation,3,2
0X7AB1F1372A66F7FB.avi,137,1208,884,324,36.65158371040724,morphological_dilation,3,2
0X7AB1FC4869E885A.avi,51,2622,2182,440,20.164986251145738,morphological_dilation,3,2
0X7AB1FC4869E885A.avi,71,2331,1919,412,21.46951537258989,morphological_dilation,3,2
0X7AB682A3B8DEC28A.avi,72,1719,1351,368,27.239082161361956,morphological_dilation,3,2
0X7AB682A3B8DEC28A.avi,96,1463,1123,340,30.27604630454141,morphological_dilation,3,2
0X7AB6F8E417D8840B.avi,50,1786,1406,380,27.027027027027028,morphological_dilation,3,2
0X7AB6F8E417D8840B.avi,72,1147,819,328,40.04884004884005,morphological_dilation,3,2
0X7ABDE075D44C8588.avi,37,1550,1190,360,30.252100840336134,morphological_dilation,3,2
0X7ABDE075D44C8588.avi,57,1129,809,320,39.55500618046972,morphological_dilation,3,2
0X7ABE255108B5D960.avi,55,2305,1877,428,22.802344166222696,morphological_dilation,3,2
0X7ABE255108B5D960.avi,67,1781,1409,372,26.40170333569908,morphological_dilation,3,2
0X7ABF95CFB129BA92.avi,41,1386,1050,336,32.0,morphological_dilation,3,2
0X7ABF95CFB129BA92.avi,54,1022,730,292,40.0,morphological_dilation,3,2
0X7AC4DF00D0AADA44.avi,139,1546,1174,372,31.686541737649065,morphological_dilation,3,2
0X7AC4DF00D0AADA44.avi,157,925,633,292,46.12954186413902,morphological_dilation,3,2
0X7AC5B09AD65C17DB.avi,0,3457,2929,528,18.026630249231822,morphological_dilation,3,2
0X7AC5B09AD65C17DB.avi,17,1957,1557,400,25.690430314707775,morphological_dilation,3,2
0X7ACA82C5A670004C.avi,59,1006,730,276,37.80821917808219,morphological_dilation,3,2
0X7ACA82C5A670004C.avi,70,632,408,224,54.90196078431373,morphological_dilation,3,2
0X7ACDCFB7A4056641.avi,150,1531,1187,344,28.98062342038753,morphological_dilation,3,2
0X7ACDCFB7A4056641.avi,165,1258,942,316,33.54564755838641,morphological_dilation,3,2
0X7AD378073EC75A33.avi,287,1725,1337,388,29.020194465220644,morphological_dilation,3,2
0X7AD378073EC75A33.avi,307,1144,820,324,39.51219512195122,morphological_dilation,3,2
0X7AD45F74C08CFE5C.avi,39,2190,1746,444,25.42955326460481,morphological_dilation,3,2
0X7AD45F74C08CFE5C.avi,58,1368,1000,368,36.8,morphological_dilation,3,2
0X7ADCFA2C3BD93CB2.avi,69,2718,2230,488,21.883408071748878,morphological_dilation,3,2
0X7ADCFA2C3BD93CB2.avi,95,1680,1273,407,31.97172034564022,morphological_dilation,3,2
0X7AE76966D714CE68.avi,1,1941,1537,404,26.284970722186074,morphological_dilation,3,2
0X7AE76966D714CE68.avi,18,1277,941,336,35.7066950053135,morphological_dilation,3,2
0X7AE9B88968450BB7.avi,160,1855,1479,376,25.422582826233942,morphological_dilation,3,2
0X7AE9B88968450BB7.avi,183,1346,1018,328,32.220039292730846,morphological_dilation,3,2
0X7AEB162B3A45EAA9.avi,42,1778,1410,368,26.099290780141843,morphological_dilation,3,2
0X7AEB162B3A45EAA9.avi,58,1178,866,312,36.027713625866056,morphological_dilation,3,2
0X7AEFC179509EEEA6.avi,35,3050,2510,540,21.51394422310757,morphological_dilation,3,2
0X7AEFC179509EEEA6.avi,51,1743,1323,420,31.746031746031743,morphological_dilation,3,2
0X7AF2DF90B850F22C.avi,3,766,514,252,49.0272373540856,morphological_dilation,3,2
0X7AF2DF90B850F22C.avi,22,541,325,216,66.46153846153847,morphological_dilation,3,2
0X7AF5420EB5D8A0D3.avi,151,1469,1109,360,32.46167718665464,morphological_dilation,3,2
0X7AF5420EB5D8A0D3.avi,167,990,670,320,47.76119402985074,morphological_dilation,3,2
0X7AF69DD2E26966D7.avi,3,1709,1333,376,28.207051762940733,morphological_dilation,3,2
0X7AF69DD2E26966D7.avi,15,1106,794,312,39.29471032745592,morphological_dilation,3,2
0X7AFA36E0847EEF8A.avi,37,1426,1070,356,33.271028037383175,morphological_dilation,3,2
0X7AFA36E0847EEF8A.avi,52,860,564,296,52.4822695035461,morphological_dilation,3,2
0X7AFF447DBE3CC46.avi,2,1540,1188,352,29.629629629629626,morphological_dilation,3,2
0X7AFF447DBE3CC46.avi,18,945,647,298,46.05873261205564,morphological_dilation,3,2
0X7AFF5B2DEEE839B9.avi,35,785,537,248,46.18249534450652,morphological_dilation,3,2
0X7AFF5B2DEEE839B9.avi,47,525,286,239,83.56643356643356,morphological_dilation,3,2
0X7B07C72D814BF24A.avi,90,1493,1153,340,29.488291413703383,morphological_dilation,3,2
0X7B07C72D814BF24A.avi,99,1010,718,292,40.66852367688023,morphological_dilation,3,2
0X7B11085407253356.avi,3,2625,2161,464,21.471540953262377,morphological_dilation,3,2
0X7B11085407253356.avi,15,2085,1673,412,24.626419605499102,morphological_dilation,3,2
0X7B1F112049D754D9.avi,41,2352,1694,658,38.84297520661157,morphological_dilation,3,2
0X7B1F112049D754D9.avi,58,1340,1012,328,32.41106719367589,morphological_dilation,3,2
0X7B2564212B59E8BD.avi,77,1815,1410,405,28.723404255319153,morphological_dilation,3,2
0X7B2564212B59E8BD.avi,90,1070,744,326,43.81720430107527,morphological_dilation,3,2
0X7B2E8A51DCBBA0DE.avi,116,2339,1897,442,23.299947285187137,morphological_dilation,3,2
0X7B2E8A51DCBBA0DE.avi,135,1648,1264,384,30.37974683544304,morphological_dilation,3,2
0X7B361D8604999C29.avi,108,2668,2192,476,21.715328467153284,morphological_dilation,3,2
0X7B361D8604999C29.avi,122,1641,1245,396,31.807228915662648,morphological_dilation,3,2
0X7B36CA7499CCB34D.avi,46,1569,1229,340,27.66476810414972,morphological_dilation,3,2
0X7B36CA7499CCB34D.avi,64,973,693,280,40.4040404040404,morphological_dilation,3,2
0X7B4062501918819C.avi,40,2335,1907,428,22.443628736234924,morphological_dilation,3,2
0X7B4062501918819C.avi,57,2112,1692,420,24.822695035460992,morphological_dilation,3,2
0X7B5573AAB7FF0B.avi,51,1673,1305,368,28.199233716475096,morphological_dilation,3,2
0X7B5573AAB7FF0B.avi,67,961,675,286,42.37037037037037,morphological_dilation,3,2
0X7B58E92EA5E26F04.avi,29,1537,1169,368,31.479897348160822,morphological_dilation,3,2
0X7B58E92EA5E26F04.avi,43,983,695,288,41.43884892086331,morphological_dilation,3,2
0X7B594349510CCAE4.avi,104,1663,1271,392,30.84185680566483,morphological_dilation,3,2
0X7B594349510CCAE4.avi,122,1147,799,348,43.55444305381727,morphological_dilation,3,2
0X7B5A055AF729EDF2.avi,40,2357,1909,448,23.467784180199057,morphological_dilation,3,2
0X7B5A055AF729EDF2.avi,55,1513,1129,384,34.012400354295835,morphological_dilation,3,2
0X7B5A83BBE8DB9B19.avi,57,1696,1312,384,29.268292682926827,morphological_dilation,3,2
0X7B5A83BBE8DB9B19.avi,76,1047,737,310,42.06241519674355,morphological_dilation,3,2
0X7B5BD31A9B927EA9.avi,54,2707,2215,492,22.21218961625282,morphological_dilation,3,2
0X7B5BD31A9B927EA9.avi,71,2045,1617,428,26.468769325912184,morphological_dilation,3,2
0X7B64C66425F826C9.avi,47,1532,1146,386,33.682373472949386,morphological_dilation,3,2
0X7B64C66425F826C9.avi,66,1031,667,364,54.5727136431784,morphological_dilation,3,2
0X7B67867A2E9C59E9.avi,100,1731,1348,383,28.41246290801187,morphological_dilation,3,2
0X7B67867A2E9C59E9.avi,119,1084,754,330,43.76657824933687,morphological_dilation,3,2
0X7B6C5217AFE9F3C1.avi,36,1441,1101,340,30.881017257039055,morphological_dilation,3,2
0X7B6C5217AFE9F3C1.avi,47,855,579,276,47.66839378238342,morphological_dilation,3,2
0X7B6F98E0BA891F6D.avi,50,2033,1641,392,23.8878732480195,morphological_dilation,3,2
0X7B6F98E0BA891F6D.avi,68,1297,973,324,33.29907502569373,morphological_dilation,3,2
0X7B73DF444BEF7269.avi,50,2090,1686,404,23.962040332147094,morphological_dilation,3,2
0X7B73DF444BEF7269.avi,68,1633,1273,360,28.27965435978005,morphological_dilation,3,2
0X7B75B05FC679E58E.avi,48,1903,1519,384,25.279789335088875,morphological_dilation,3,2
0X7B75B05FC679E58E.avi,67,1199,895,304,33.96648044692737,morphological_dilation,3,2
0X7B76CB1D495CDC4A.avi,134,2586,2138,448,20.95416276894294,morphological_dilation,3,2
0X7B76CB1D495CDC4A.avi,150,1783,1411,372,26.364280652019843,morphological_dilation,3,2
0X7B782548CD60DD17.avi,49,2033,1589,444,27.942101950912523,morphological_dilation,3,2
0X7B782548CD60DD17.avi,64,1395,1000,395,39.5,morphological_dilation,3,2
0X7B7DCCB4D78CD5BD.avi,79,1232,924,308,33.33333333333333,morphological_dilation,3,2
0X7B7DCCB4D78CD5BD.avi,90,773,507,266,52.46548323471401,morphological_dilation,3,2
0X7B7ECB319911B032.avi,61,2075,1683,392,23.291740938799762,morphological_dilation,3,2
0X7B7ECB319911B032.avi,83,1477,1133,344,30.36187113857017,morphological_dilation,3,2
0X7B82FDB13CF2CE3.avi,56,1384,1044,340,32.56704980842912,morphological_dilation,3,2
0X7B82FDB13CF2CE3.avi,74,843,571,272,47.635726795096325,morphological_dilation,3,2
0X7B8526A405DEB964.avi,58,2204,1788,416,23.2662192393736,morphological_dilation,3,2
0X7B8526A405DEB964.avi,79,1775,1387,388,27.974044700793076,morphological_dilation,3,2
0X7B8F542F991D908F.avi,86,2043,1627,416,25.568531038721577,morphological_dilation,3,2
0X7B8F542F991D908F.avi,99,1350,998,352,35.27054108216433,morphological_dilation,3,2
0X7B91BB399D1EF0E0.avi,72,3287,2711,576,21.246772408705276,morphological_dilation,3,2
0X7B91BB399D1EF0E0.avi,80,1811,1375,436,31.70909090909091,morphological_dilation,3,2
0X7B93FAE7841C1826.avi,164,1324,992,332,33.46774193548387,morphological_dilation,3,2
0X7B93FAE7841C1826.avi,184,770,506,264,52.17391304347826,morphological_dilation,3,2
0X7B96EB2565E5E0F7.avi,2,1068,751,317,42.2103861517976,morphological_dilation,3,2
0X7B96EB2565E5E0F7.avi,13,639,397,242,60.957178841309826,morphological_dilation,3,2
0X7B982CE3A8C024F4.avi,88,2184,1768,416,23.52941176470588,morphological_dilation,3,2
0X7B982CE3A8C024F4.avi,104,1400,1040,360,34.61538461538461,morphological_dilation,3,2
0X7B9A154FC4B9A975.avi,46,4401,3851,550,14.28200467411062,morphological_dilation,3,2
0X7B9A154FC4B9A975.avi,71,2850,2310,540,23.376623376623375,morphological_dilation,3,2
0X7B9BCBCF1AC67C22.avi,28,1467,1111,356,32.04320432043205,morphological_dilation,3,2
0X7B9BCBCF1AC67C22.avi,48,944,644,300,46.58385093167702,morphological_dilation,3,2
0X7B9D5C68AB322E27.avi,78,1404,1084,320,29.520295202952028,morphological_dilation,3,2
0X7B9D5C68AB322E27.avi,97,870,593,277,46.711635750421586,morphological_dilation,3,2
0X7BA1B13AB4EC602D.avi,40,2711,2263,448,19.796730004418915,morphological_dilation,3,2
0X7BA1B13AB4EC602D.avi,55,2419,1987,432,21.741318570709613,morphological_dilation,3,2
0X7BA58229FCBA50B3.avi,53,1811,1435,376,26.202090592334493,morphological_dilation,3,2
0X7BA58229FCBA50B3.avi,66,1179,863,316,36.616454229432215,morphological_dilation,3,2
0X7BA58F095A0EDE7E.avi,58,1377,1025,352,34.34146341463415,morphological_dilation,3,2
0X7BA58F095A0EDE7E.avi,79,853,548,305,55.65693430656934,morphological_dilation,3,2
0X7BA9FD251A48D45B.avi,96,1707,1327,380,28.636021100226074,morphological_dilation,3,2
0X7BA9FD251A48D45B.avi,112,1324,984,340,34.552845528455286,morphological_dilation,3,2
0X7BB1CB83B94EB317.avi,133,1904,1460,444,30.41095890410959,morphological_dilation,3,2
0X7BB1CB83B94EB317.avi,152,1271,907,364,40.132304299889746,morphological_dilation,3,2
0X7BC38D46D3D3750C.avi,61,2163,1719,444,25.82897033158813,morphological_dilation,3,2
0X7BC38D46D3D3750C.avi,77,1906,1486,420,28.263795423956932,morphological_dilation,3,2
0X7BC3BD3B6AA3AFD.avi,51,1778,1394,384,27.546628407460545,morphological_dilation,3,2
0X7BC3BD3B6AA3AFD.avi,68,1060,738,322,43.63143631436314,morphological_dilation,3,2
0X7BC5E5DDF9DBE9F1.avi,54,1856,1464,392,26.775956284153008,morphological_dilation,3,2
0X7BC5E5DDF9DBE9F1.avi,67,1575,1215,360,29.629629629629626,morphological_dilation,3,2
0X7BC611E29496FD3E.avi,38,1903,1523,380,24.95075508864084,morphological_dilation,3,2
0X7BC611E29496FD3E.avi,54,1298,986,312,31.643002028397564,morphological_dilation,3,2
0X7BC859C176E9E6DB.avi,73,2237,1801,436,24.208772903942254,morphological_dilation,3,2
0X7BC859C176E9E6DB.avi,95,1323,969,354,36.53250773993808,morphological_dilation,3,2
0X7BC908B49BFFD76D.avi,56,914,642,272,42.36760124610592,morphological_dilation,3,2
0X7BC908B49BFFD76D.avi,69,643,411,232,56.447688564476884,morphological_dilation,3,2
0X7BCC548D2F2EEEE5.avi,58,1472,1120,352,31.428571428571427,morphological_dilation,3,2
0X7BCC548D2F2EEEE5.avi,73,914,629,285,45.310015898251194,morphological_dilation,3,2
0X7BCDD67EB4F5945E.avi,59,1424,1084,340,31.365313653136536,morphological_dilation,3,2
0X7BCDD67EB4F5945E.avi,82,963,667,296,44.377811094452774,morphological_dilation,3,2
0X7BCEF24F83447FFE.avi,3,3324,2785,539,19.353680430879713,morphological_dilation,3,2
0X7BCEF24F83447FFE.avi,21,2374,1894,480,25.343189017951424,morphological_dilation,3,2
0X7BCEF35CEC8302A4.avi,3,2438,1974,464,23.505572441742654,morphological_dilation,3,2
0X7BCEF35CEC8302A4.avi,16,1560,1184,376,31.756756756756754,morphological_dilation,3,2
0X7BD00517B6ED440D.avi,68,1730,1344,386,28.720238095238095,morphological_dilation,3,2
0X7BD00517B6ED440D.avi,96,1038,722,316,43.76731301939058,morphological_dilation,3,2
0X7BD009AA7B30A5D8.avi,112,1811,1419,392,27.62508809020437,morphological_dilation,3,2
0X7BD009AA7B30A5D8.avi,131,1209,885,324,36.610169491525426,morphological_dilation,3,2
0X7BD1EFE780ACD70B.avi,54,1193,869,324,37.284234752589185,morphological_dilation,3,2
0X7BD1EFE780ACD70B.avi,69,734,460,274,59.56521739130435,morphological_dilation,3,2
0X7BD38A944FB7D285.avi,34,1060,750,310,41.333333333333336,morphological_dilation,3,2
0X7BD38A944FB7D285.avi,46,750,494,256,51.821862348178136,morphological_dilation,3,2
0X7BD3D2A65C18A4CA.avi,146,1084,769,315,40.96228868660598,morphological_dilation,3,2
0X7BD3D2A65C18A4CA.avi,161,756,460,296,64.34782608695652,morphological_dilation,3,2
0X7BD51A04F3D1AF7.avi,52,2307,1859,448,24.098977945131793,morphological_dilation,3,2
0X7BD51A04F3D1AF7.avi,72,1909,1505,404,26.843853820598007,morphological_dilation,3,2
0X7BD6977487C29ECF.avi,114,1594,1234,360,29.17341977309562,morphological_dilation,3,2
0X7BD6977487C29ECF.avi,136,1254,942,312,33.12101910828025,morphological_dilation,3,2
0X7BD7893522AEAB1E.avi,95,1968,1572,396,25.190839694656486,morphological_dilation,3,2
0X7BD7893522AEAB1E.avi,110,1115,794,321,40.42821158690176,morphological_dilation,3,2
0X7BE4A633CA420375.avi,45,2061,1649,412,24.98483929654336,morphological_dilation,3,2
0X7BE4A633CA420375.avi,65,1667,1295,372,28.725868725868725,morphological_dilation,3,2
0X7BE6BA90FB9BC4C6.avi,36,1381,1049,332,31.649189704480456,morphological_dilation,3,2
0X7BE6BA90FB9BC4C6.avi,48,885,617,268,43.43598055105348,morphological_dilation,3,2
0X7BE93FB0FD83D91D.avi,101,2409,1977,432,21.851289833080425,morphological_dilation,3,2
0X7BE93FB0FD83D91D.avi,117,1605,1230,375,30.48780487804878,morphological_dilation,3,2
0X7BECA917CA87A9DA.avi,111,1588,1184,404,34.12162162162162,morphological_dilation,3,2
0X7BECA917CA87A9DA.avi,129,1101,759,342,45.059288537549406,morphological_dilation,3,2
0X7BED18C482386E18.avi,40,1137,821,316,38.489646772228994,morphological_dilation,3,2
0X7BED18C482386E18.avi,56,657,409,248,60.63569682151589,morphological_dilation,3,2
0X7BF746EB936C65BE.avi,25,1875,1487,388,26.09280430396772,morphological_dilation,3,2
0X7BF746EB936C65BE.avi,35,1204,876,328,37.44292237442922,morphological_dilation,3,2
0X7BFEEBCCC38DB440.avi,115,1548,1184,364,30.743243243243246,morphological_dilation,3,2
0X7BFEEBCCC38DB440.avi,130,1246,907,339,37.37596471885336,morphological_dilation,3,2
0X7BFFFB7899AF3782.avi,35,2040,1620,420,25.925925925925924,morphological_dilation,3,2
0X7BFFFB7899AF3782.avi,53,1475,1115,360,32.28699551569507,morphological_dilation,3,2
0X7C053B5DB5BAEB83.avi,105,2112,1708,404,23.653395784543328,morphological_dilation,3,2
0X7C053B5DB5BAEB83.avi,122,1357,1036,321,30.984555984555982,morphological_dilation,3,2
0X7C076CFBDD1CB990.avi,40,2116,1700,416,24.47058823529412,morphological_dilation,3,2
0X7C076CFBDD1CB990.avi,56,1201,869,332,38.204833141542004,morphological_dilation,3,2
0X7C084027BD7966B9.avi,0,1072,772,300,38.860103626943,morphological_dilation,3,2
0X7C084027BD7966B9.avi,15,671,431,240,55.68445475638051,morphological_dilation,3,2
0X7C0C60C983B89520.avi,136,1445,1113,332,29.829290206648697,morphological_dilation,3,2
0X7C0C60C983B89520.avi,156,952,668,284,42.51497005988024,morphological_dilation,3,2
0X7C1078ADB86F63B2.avi,40,1171,859,312,36.32130384167637,morphological_dilation,3,2
0X7C1078ADB86F63B2.avi,55,883,623,260,41.73354735152488,morphological_dilation,3,2
0X7C10D53910F69D61.avi,51,2890,2430,460,18.930041152263374,morphological_dilation,3,2
0X7C10D53910F69D61.avi,71,1832,1456,376,25.82417582417583,morphological_dilation,3,2
0X7C11A719A3C02AD3.avi,0,2217,1789,428,23.923979877026273,morphological_dilation,3,2
0X7C11A719A3C02AD3.avi,16,1310,978,332,33.94683026584867,morphological_dilation,3,2
0X7C11CAFF545777DC.avi,38,1405,1034,371,35.88007736943907,morphological_dilation,3,2
0X7C11CAFF545777DC.avi,52,1052,722,330,45.70637119113574,morphological_dilation,3,2
0X7C1277ADCD83E8BA.avi,84,1501,1149,352,30.63533507397737,morphological_dilation,3,2
0X7C1277ADCD83E8BA.avi,98,976,680,296,43.529411764705884,morphological_dilation,3,2
0X7C1A4682049A9C62.avi,52,1792,1412,380,26.912181303116146,morphological_dilation,3,2
0X7C1A4682049A9C62.avi,69,1316,1000,316,31.6,morphological_dilation,3,2
0X7C1B2513F22715C8.avi,75,2941,2445,496,20.286298568507156,morphological_dilation,3,2
0X7C1B2513F22715C8.avi,87,1728,1340,388,28.955223880597014,morphological_dilation,3,2
0X7C1B6369CCFFBDDF.avi,95,1559,1191,368,30.89840470193115,morphological_dilation,3,2
0X7C1B6369CCFFBDDF.avi,110,984,700,284,40.57142857142857,morphological_dilation,3,2
0X7C1E9F9F4993DFFC.avi,56,1911,1515,396,26.13861386138614,morphological_dilation,3,2
0X7C1E9F9F4993DFFC.avi,70,1224,896,328,36.607142857142854,morphological_dilation,3,2
0X7C202E81AFCC7010.avi,37,1677,1302,375,28.80184331797235,morphological_dilation,3,2
0X7C202E81AFCC7010.avi,52,1077,769,308,40.05201560468141,morphological_dilation,3,2
0X7C2086652C808B3D.avi,122,1659,1271,388,30.527143981117234,morphological_dilation,3,2
0X7C2086652C808B3D.avi,147,1044,732,312,42.62295081967213,morphological_dilation,3,2
0X7C23C2D126878C83.avi,42,1801,1419,382,26.92036645525018,morphological_dilation,3,2
0X7C23C2D126878C83.avi,55,1220,890,330,37.07865168539326,morphological_dilation,3,2
0X7C2B6DE932E8EB4D.avi,107,1617,1261,356,28.231562252180808,morphological_dilation,3,2
0X7C2B6DE932E8EB4D.avi,124,1145,833,312,37.45498199279712,morphological_dilation,3,2
0X7C371BCB4ACF8CFD.avi,132,1707,1307,400,30.604437643458297,morphological_dilation,3,2
0X7C371BCB4ACF8CFD.avi,145,1089,761,328,43.1011826544021,morphological_dilation,3,2
0X7C3724DE3C2BBEA6.avi,53,1503,1151,352,30.582102519548222,morphological_dilation,3,2
0X7C3724DE3C2BBEA6.avi,71,699,384,315,82.03125,morphological_dilation,3,2
0X7C39285C0277DBB5.avi,78,2064,1624,440,27.093596059113302,morphological_dilation,3,2
0X7C39285C0277DBB5.avi,93,1435,1055,380,36.018957345971565,morphological_dilation,3,2
0X7C39483D6FC66806.avi,39,1752,1360,392,28.823529411764703,morphological_dilation,3,2
0X7C39483D6FC66806.avi,55,1066,750,316,42.13333333333333,morphological_dilation,3,2
0X7C3A04F6182C79D6.avi,60,2751,2268,483,21.296296296296298,morphological_dilation,3,2
0X7C3A04F6182C79D6.avi,80,1472,1104,368,33.33333333333333,morphological_dilation,3,2
0X7C3A0715974A7250.avi,49,1570,1206,364,30.18242122719735,morphological_dilation,3,2
0X7C3A0715974A7250.avi,67,903,603,300,49.75124378109453,morphological_dilation,3,2
0X7C3C3EE6582C429A.avi,153,2052,1653,399,24.137931034482758,morphological_dilation,3,2
0X7C3C3EE6582C429A.avi,173,1139,838,301,35.91885441527447,morphological_dilation,3,2
0X7C3CA2BC6A6EE986.avi,83,1546,1198,348,29.04841402337229,morphological_dilation,3,2
0X7C3CA2BC6A6EE986.avi,109,998,706,292,41.359773371104815,morphological_dilation,3,2
0X7C47EF804F3367E8.avi,52,2543,2059,484,23.506556580864498,morphological_dilation,3,2
0X7C47EF804F3367E8.avi,67,1493,1106,387,34.99095840867993,morphological_dilation,3,2
0X7C499024B4A4DA1A.avi,62,2718,2234,484,21.665174574753802,morphological_dilation,3,2
0X7C499024B4A4DA1A.avi,80,1792,1388,404,29.106628242074926,morphological_dilation,3,2
0X7C54E0438C0F6AB5.avi,42,1185,858,327,38.111888111888106,morphological_dilation,3,2
0X7C54E0438C0F6AB5.avi,65,828,533,295,55.34709193245778,morphological_dilation,3,2
0X7C567D0F1DAB3620.avi,86,2165,1745,420,24.068767908309454,morphological_dilation,3,2
0X7C567D0F1DAB3620.avi,100,1466,1106,360,32.5497287522604,morphological_dilation,3,2
0X7C5C65685D6ABC7A.avi,49,1794,1398,396,28.32618025751073,morphological_dilation,3,2
0X7C5C65685D6ABC7A.avi,66,1116,771,345,44.74708171206226,morphological_dilation,3,2
0X7C5CE94A1B662182.avi,46,1807,1411,396,28.065201984408223,morphological_dilation,3,2
0X7C5CE94A1B662182.avi,62,1217,881,336,38.138479001135074,morphological_dilation,3,2
0X7C65DA147A4EA7E1.avi,50,2101,1677,424,25.28324388789505,morphological_dilation,3,2
0X7C65DA147A4EA7E1.avi,72,1311,983,328,33.36724313326551,morphological_dilation,3,2
0X7C6A6F5AE74EB074.avi,37,2396,1912,484,25.313807531380757,morphological_dilation,3,2
0X7C6A6F5AE74EB074.avi,54,1618,1218,400,32.84072249589491,morphological_dilation,3,2
0X7C6D2CA9F2B482CF.avi,57,1500,1152,348,30.208333333333332,morphological_dilation,3,2
0X7C6D2CA9F2B482CF.avi,77,943,619,324,52.34248788368336,morphological_dilation,3,2
0X7C6D449DEDF42EE8.avi,74,2489,2037,452,22.189494354442807,morphological_dilation,3,2
0X7C6D449DEDF42EE8.avi,94,1657,1273,384,30.16496465043205,morphological_dilation,3,2
0X7C6FB8F7CE82D404.avi,0,2357,1933,424,21.934816347646148,morphological_dilation,3,2
0X7C6FB8F7CE82D404.avi,14,1841,1458,383,26.26886145404664,morphological_dilation,3,2
0X7C6FC9FFABD5BC8D.avi,40,1691,1335,356,26.666666666666668,morphological_dilation,3,2
0X7C6FC9FFABD5BC8D.avi,50,1119,819,300,36.63003663003663,morphological_dilation,3,2
0X7C6FEF42346665BB.avi,116,2019,1607,412,25.63783447417548,morphological_dilation,3,2
0X7C6FEF42346665BB.avi,135,1584,1232,352,28.57142857142857,morphological_dilation,3,2
0X7C7BD92BD4602CAA.avi,88,1676,1312,364,27.743902439024392,morphological_dilation,3,2
0X7C7BD92BD4602CAA.avi,104,1225,913,312,34.17305585980285,morphological_dilation,3,2
0X7C7CB880947C5C5C.avi,46,1606,1262,344,27.258320126782888,morphological_dilation,3,2
0X7C7CB880947C5C5C.avi,67,1343,1023,320,31.28054740957967,morphological_dilation,3,2
0X7C7D65DB11064625.avi,102,2153,1709,444,25.980105324751317,morphological_dilation,3,2
0X7C7D65DB11064625.avi,119,1245,903,342,37.87375415282392,morphological_dilation,3,2
0X7C7EB193BEC5D926.avi,33,2914,2362,552,23.370025402201524,morphological_dilation,3,2
0X7C7EB193BEC5D926.avi,49,1627,1192,435,36.49328859060403,morphological_dilation,3,2
0X7C7F2E7816DBE8C1.avi,134,2576,2100,476,22.666666666666664,morphological_dilation,3,2
0X7C7F2E7816DBE8C1.avi,149,1518,1138,380,33.391915641476274,morphological_dilation,3,2
0X7C883F8B60AF5C02.avi,44,1962,1528,434,28.403141361256544,morphological_dilation,3,2
0X7C883F8B60AF5C02.avi,60,1266,905,361,39.889502762430936,morphological_dilation,3,2
0X7C88FB0DAAC98643.avi,36,1472,1124,348,30.96085409252669,morphological_dilation,3,2
0X7C88FB0DAAC98643.avi,50,952,660,292,44.24242424242424,morphological_dilation,3,2
0X7C8C939686F0D276.avi,95,2814,2330,484,20.772532188841204,morphological_dilation,3,2
0X7C8C939686F0D276.avi,106,2351,1911,440,23.024594453165882,morphological_dilation,3,2
0X7C939BD6B4574A80.avi,43,1845,1466,379,25.852660300136428,morphological_dilation,3,2
0X7C939BD6B4574A80.avi,58,1410,1082,328,30.31423290203327,morphological_dilation,3,2
0X7C9F6CBD094B0359.avi,21,1283,943,340,36.05514316012725,morphological_dilation,3,2
0X7C9F6CBD094B0359.avi,50,1986,1568,418,26.658163265306122,morphological_dilation,3,2
0X7CA0A2B5B1F8A134.avi,42,1744,1361,383,28.14107274063189,morphological_dilation,3,2
0X7CA0A2B5B1F8A134.avi,57,1055,739,316,42.760487144790254,morphological_dilation,3,2
0X7CA10684E319705F.avi,92,1636,1276,360,28.213166144200624,morphological_dilation,3,2
0X7CA10684E319705F.avi,108,1186,874,312,35.6979405034325,morphological_dilation,3,2
0X7CA133BB031E0FFD.avi,39,2199,1795,404,22.506963788300833,morphological_dilation,3,2
0X7CA133BB031E0FFD.avi,60,1329,988,341,34.51417004048583,morphological_dilation,3,2
0X7CA15DC6A1C6DA13.avi,78,1933,1527,406,26.588081204977076,morphological_dilation,3,2
0X7CA15DC6A1C6DA13.avi,95,1147,811,336,41.43033292231812,morphological_dilation,3,2
0X7CA9A912598CA322.avi,108,4663,4122,541,13.124696749150896,morphological_dilation,3,2
0X7CA9A912598CA322.avi,128,3208,2640,568,21.515151515151516,morphological_dilation,3,2
0X7CA9F39E5042977C.avi,45,949,669,280,41.85351270553064,morphological_dilation,3,2
0X7CA9F39E5042977C.avi,65,606,382,224,58.63874345549738,morphological_dilation,3,2
0X7CAE371CDC897CE6.avi,42,1722,1343,379,28.22040208488459,morphological_dilation,3,2
0X7CAE371CDC897CE6.avi,48,1074,773,301,38.939197930142306,morphological_dilation,3,2
0X7CAE69437044224A.avi,56,2587,2128,459,21.56954887218045,morphological_dilation,3,2
0X7CAE69437044224A.avi,78,1704,1312,392,29.878048780487802,morphological_dilation,3,2
0X7CB071721715D80F.avi,71,2687,2231,456,20.439264903630658,morphological_dilation,3,2
0X7CB071721715D80F.avi,78,2341,1909,432,22.629649030906236,morphological_dilation,3,2
0X7CB28DF1B556246B.avi,107,5068,4406,662,15.024965955515206,morphological_dilation,3,2
0X7CB28DF1B556246B.avi,123,2966,2422,544,22.46077621800165,morphological_dilation,3,2
0X7CB7207DB5849348.avi,44,1455,1119,336,30.02680965147453,morphological_dilation,3,2
0X7CB7207DB5849348.avi,59,960,660,300,45.45454545454545,morphological_dilation,3,2
0X7CB7C518E22849C0.avi,39,1430,1058,372,35.16068052930057,morphological_dilation,3,2
0X7CB7C518E22849C0.avi,54,790,498,292,58.63453815261044,morphological_dilation,3,2
0X7CBAA73896DCFDB9.avi,53,2082,1690,392,23.19526627218935,morphological_dilation,3,2
0X7CBAA73896DCFDB9.avi,70,1723,1359,364,26.78440029433407,morphological_dilation,3,2
0X7CBDDB20A1855D5B.avi,130,1425,1081,344,31.822386679000925,morphological_dilation,3,2
0X7CBDDB20A1855D5B.avi,147,1039,747,292,39.08969210174029,morphological_dilation,3,2
0X7CC04BF5B6684CEE.avi,2,1433,1093,340,31.10704483074108,morphological_dilation,3,2
0X7CC04BF5B6684CEE.avi,18,899,615,284,46.17886178861789,morphological_dilation,3,2
0X7CCAC8AD825CB21A.avi,30,1499,1151,348,30.234578627280627,morphological_dilation,3,2
0X7CCAC8AD825CB21A.avi,46,952,668,284,42.51497005988024,morphological_dilation,3,2
0X7CCD7AEC19D4AFE8.avi,43,2331,1895,436,23.00791556728232,morphological_dilation,3,2
0X7CCD7AEC19D4AFE8.avi,61,1415,1034,381,36.847195357833655,morphological_dilation,3,2
0X7CD73F9F79E1F4DE.avi,50,3048,2540,508,20.0,morphological_dilation,3,2
0X7CD73F9F79E1F4DE.avi,70,1802,1410,392,27.801418439716315,morphological_dilation,3,2
0X7CDAB7D00122C00F.avi,36,1590,1222,368,30.11456628477905,morphological_dilation,3,2
0X7CDAB7D00122C00F.avi,55,1344,992,352,35.483870967741936,morphological_dilation,3,2
0X7CDC48EE66ABB915.avi,62,1908,1516,392,25.857519788918204,morphological_dilation,3,2
0X7CDC48EE66ABB915.avi,78,1156,824,332,40.29126213592233,morphological_dilation,3,2
0X7CDF036B61A17CC3.avi,53,1879,1495,384,25.685618729096987,morphological_dilation,3,2
0X7CDF036B61A17CC3.avi,73,1184,860,324,37.67441860465116,morphological_dilation,3,2
0X7CE0D85A16659110.avi,39,1473,1125,348,30.933333333333334,morphological_dilation,3,2
0X7CE0D85A16659110.avi,54,936,648,288,44.44444444444444,morphological_dilation,3,2
0X7CE3B7D2F8976E7D.avi,44,1757,1369,388,28.341855368882396,morphological_dilation,3,2
0X7CE3B7D2F8976E7D.avi,62,1073,761,312,40.99868593955322,morphological_dilation,3,2
0X7CE6275BC5A013A0.avi,54,2946,2451,495,20.195838433292536,morphological_dilation,3,2
0X7CE6275BC5A013A0.avi,71,2249,1805,444,24.598337950138504,morphological_dilation,3,2
0X7CE6AFF52A6B8670.avi,70,2252,1836,416,22.657952069716774,morphological_dilation,3,2
0X7CE6AFF52A6B8670.avi,82,1385,1029,356,34.59669582118562,morphological_dilation,3,2
0X7CE7F41BF99545F6.avi,72,1691,1323,368,27.81557067271353,morphological_dilation,3,2
0X7CE7F41BF99545F6.avi,81,1210,873,337,38.60252004581902,morphological_dilation,3,2
0X7CE9AAE0242EF73D.avi,87,2457,1993,464,23.28148519819368,morphological_dilation,3,2
0X7CE9AAE0242EF73D.avi,104,1492,1120,372,33.214285714285715,morphological_dilation,3,2
0X7CEA8E5FA8F3FB3F.avi,152,2201,1773,428,24.139875916525664,morphological_dilation,3,2
0X7CEA8E5FA8F3FB3F.avi,166,1745,1341,404,30.12677106636838,morphological_dilation,3,2
0X7CEB5315352C1FC9.avi,96,2939,2451,488,19.910240718074252,morphological_dilation,3,2
0X7CEB5315352C1FC9.avi,119,2370,1930,440,22.797927461139896,morphological_dilation,3,2
0X7CEF57328013C8B6.avi,4,1360,1012,348,34.387351778656125,morphological_dilation,3,2
0X7CEF57328013C8B6.avi,10,900,604,296,49.00662251655629,morphological_dilation,3,2
0X7CF265240EBC0648.avi,125,1606,1226,380,30.99510603588907,morphological_dilation,3,2
0X7CF265240EBC0648.avi,142,969,665,304,45.714285714285715,morphological_dilation,3,2
0X7CF70061E3B47DE6.avi,84,1749,1377,372,27.01525054466231,morphological_dilation,3,2
0X7CF70061E3B47DE6.avi,97,1066,756,310,41.00529100529101,morphological_dilation,3,2
0X7CFF2E1311F09165.avi,1,1536,1188,348,29.292929292929294,morphological_dilation,3,2
0X7CFF2E1311F09165.avi,14,961,673,288,42.79346210995542,morphological_dilation,3,2
0X7D011309F536A7E0.avi,76,1639,1287,352,27.350427350427353,morphological_dilation,3,2
0X7D011309F536A7E0.avi,90,1034,738,296,40.10840108401084,morphological_dilation,3,2
0X7D01D8A3BF2A3A46.avi,41,2181,1729,452,26.14227877385772,morphological_dilation,3,2
0X7D01D8A3BF2A3A46.avi,57,1377,1005,372,37.014925373134325,morphological_dilation,3,2
0X7D0223AF4A3B9955.avi,57,3464,2913,551,18.91520768966701,morphological_dilation,3,2
0X7D0223AF4A3B9955.avi,77,2050,1619,431,26.621371216800494,morphological_dilation,3,2
0X7D06F10AF881B055.avi,90,1589,1233,356,28.872668288726683,morphological_dilation,3,2
0X7D06F10AF881B055.avi,105,1082,774,308,39.79328165374677,morphological_dilation,3,2
0X7D0AC305541BEEAA.avi,97,1883,1487,396,26.630800268997984,morphological_dilation,3,2
0X7D0AC305541BEEAA.avi,111,1150,818,332,40.58679706601467,morphological_dilation,3,2
0X7D0FC6E69A6AD15A.avi,68,2253,1801,452,25.09716823986674,morphological_dilation,3,2
0X7D0FC6E69A6AD15A.avi,84,1541,1165,376,32.27467811158798,morphological_dilation,3,2
0X7D1234DED3EAC45.avi,75,1348,996,352,35.34136546184739,morphological_dilation,3,2
0X7D1234DED3EAC45.avi,89,782,491,291,59.26680244399185,morphological_dilation,3,2
0X7D129213628239FA.avi,144,2600,2120,480,22.641509433962266,morphological_dilation,3,2
0X7D129213628239FA.avi,161,1708,1304,404,30.981595092024538,morphological_dilation,3,2
0X7D131134E996F284.avi,43,3212,2688,524,19.49404761904762,morphological_dilation,3,2
0X7D131134E996F284.avi,58,1780,1384,396,28.61271676300578,morphological_dilation,3,2
0X7D1BEA2D8E1CF02E.avi,48,1266,946,320,33.82663847780127,morphological_dilation,3,2
0X7D1BEA2D8E1CF02E.avi,66,798,546,252,46.15384615384615,morphological_dilation,3,2
0X7D1E11429C92D9FB.avi,55,1645,1289,356,27.61830876648565,morphological_dilation,3,2
0X7D1E11429C92D9FB.avi,74,1060,756,304,40.21164021164021,morphological_dilation,3,2
0X7D1F59C70EC5E749.avi,64,1312,984,328,33.33333333333333,morphological_dilation,3,2
0X7D1F59C70EC5E749.avi,87,877,601,276,45.92346089850249,morphological_dilation,3,2
0X7D2089086EF49B62.avi,32,3310,2810,500,17.793594306049823,morphological_dilation,3,2
0X7D2089086EF49B62.avi,45,2877,2409,468,19.42714819427148,morphological_dilation,3,2
0X7D2478A652A3B024.avi,46,2606,2134,472,22.118088097469542,morphological_dilation,3,2
0X7D2478A652A3B024.avi,68,1748,1337,411,30.740463724756918,morphological_dilation,3,2
0X7D24D09D4B66FB12.avi,63,2984,2485,499,20.080482897384304,morphological_dilation,3,2
0X7D24D09D4B66FB12.avi,81,1712,1320,392,29.6969696969697,morphological_dilation,3,2
0X7D25EEAD9C236D01.avi,55,1616,1256,360,28.662420382165603,morphological_dilation,3,2
0X7D25EEAD9C236D01.avi,74,998,702,296,42.16524216524217,morphological_dilation,3,2
0X7D263C90CF9FCAB7.avi,41,1576,1209,367,30.355665839536805,morphological_dilation,3,2
0X7D263C90CF9FCAB7.avi,62,1062,743,319,42.934051144010766,morphological_dilation,3,2
0X7D2C9FE972A828D3.avi,111,1421,1065,356,33.42723004694836,morphological_dilation,3,2
0X7D2C9FE972A828D3.avi,125,907,603,304,50.41459369817579,morphological_dilation,3,2
0X7D32BEF617ED61E9.avi,39,1531,1183,348,29.4167371090448,morphological_dilation,3,2
0X7D32BEF617ED61E9.avi,55,1022,738,284,38.482384823848236,morphological_dilation,3,2
0X7D34DA638DFF03C6.avi,76,1625,1285,340,26.459143968871597,morphological_dilation,3,2
0X7D34DA638DFF03C6.avi,93,1044,752,292,38.82978723404255,morphological_dilation,3,2
0X7D37F4AEEDA7A721.avi,49,1568,1208,360,29.80132450331126,morphological_dilation,3,2
0X7D37F4AEEDA7A721.avi,64,920,648,272,41.9753086419753,morphological_dilation,3,2
0X7D39012AC4B412BE.avi,95,1582,1198,384,32.053422370617696,morphological_dilation,3,2
0X7D39012AC4B412BE.avi,112,1024,712,312,43.82022471910113,morphological_dilation,3,2
0X7D39A36B39114D.avi,3,1388,1040,348,33.46153846153846,morphological_dilation,3,2
0X7D39A36B39114D.avi,15,865,577,288,49.91334488734835,morphological_dilation,3,2
0X7D3A348B868CFCB2.avi,60,4526,3922,604,15.400305966343703,morphological_dilation,3,2
0X7D3A348B868CFCB2.avi,74,2753,2265,488,21.545253863134658,morphological_dilation,3,2
0X7D3AA96EF70A00D5.avi,0,1940,1516,424,27.96833773087071,morphological_dilation,3,2
0X7D3AA96EF70A00D5.avi,17,1110,770,340,44.15584415584416,morphological_dilation,3,2
0X7D3CE6662D2113FA.avi,53,1271,955,316,33.089005235602095,morphological_dilation,3,2
0X7D3CE6662D2113FA.avi,63,821,561,260,46.3458110516934,morphological_dilation,3,2
0X7D41714643A4524D.avi,81,1530,1186,344,29.00505902192243,morphological_dilation,3,2
0X7D41714643A4524D.avi,101,971,683,288,42.16691068814056,morphological_dilation,3,2
0X7D466FE3AC012BBB.avi,56,1913,1446,467,32.29598893499308,morphological_dilation,3,2
0X7D466FE3AC012BBB.avi,77,1269,890,379,42.58426966292135,morphological_dilation,3,2
0X7D469692EDE2EF91.avi,35,2361,1904,457,24.002100840336134,morphological_dilation,3,2
0X7D469692EDE2EF91.avi,45,1268,863,405,46.929316338354575,morphological_dilation,3,2
0X7D47E45DC22458A.avi,2,1615,1243,372,29.92759452936444,morphological_dilation,3,2
0X7D47E45DC22458A.avi,16,1095,763,332,43.51245085190039,morphological_dilation,3,2
0X7D4C42BDA9299A46.avi,77,1937,1537,400,26.024723487312944,morphological_dilation,3,2
0X7D4C42BDA9299A46.avi,95,1272,944,328,34.74576271186441,morphological_dilation,3,2
0X7D4E031123DA9E4F.avi,66,1035,751,284,37.81624500665779,morphological_dilation,3,2
0X7D4E031123DA9E4F.avi,79,652,410,242,59.02439024390244,morphological_dilation,3,2
0X7D4E2B016F111A25.avi,94,1202,884,318,35.97285067873303,morphological_dilation,3,2
0X7D4E2B016F111A25.avi,110,989,689,300,43.54136429608128,morphological_dilation,3,2
0X7D52513975CDE18F.avi,32,1786,1394,392,28.120516499282637,morphological_dilation,3,2
0X7D52513975CDE18F.avi,42,1147,819,328,40.04884004884005,morphological_dilation,3,2
0X7D52A5663195DC72.avi,81,1860,1476,384,26.01626016260163,morphological_dilation,3,2
0X7D52A5663195DC72.avi,98,1109,797,312,39.146800501882055,morphological_dilation,3,2
0X7D537B2C2CDCB140.avi,171,1437,1081,356,32.932469935245145,morphological_dilation,3,2
0X7D537B2C2CDCB140.avi,184,929,633,296,46.76145339652449,morphological_dilation,3,2
0X7D567F2A870FD8F0.avi,102,1605,1253,352,28.092577813248205,morphological_dilation,3,2
0X7D567F2A870FD8F0.avi,117,1386,1054,332,31.499051233396585,morphological_dilation,3,2
0X7D57150EFE76C557.avi,60,1260,946,314,33.192389006342495,morphological_dilation,3,2
0X7D57150EFE76C557.avi,71,809,549,260,47.35883424408014,morphological_dilation,3,2
0X7D5A835A93B83445.avi,1,2805,2329,476,20.437956204379564,morphological_dilation,3,2
0X7D5A835A93B83445.avi,20,1714,1310,404,30.839694656488547,morphological_dilation,3,2
0X7D5C2B6F2A436FA1.avi,53,2031,1631,400,24.524831391784183,morphological_dilation,3,2
0X7D5C2B6F2A436FA1.avi,70,1594,1223,371,30.335241210139003,morphological_dilation,3,2
0X7D61161FC3365FF8.avi,72,2759,2288,471,20.585664335664337,morphological_dilation,3,2
0X7D61161FC3365FF8.avi,86,2596,2140,456,21.30841121495327,morphological_dilation,3,2
0X7D63A7259A3897D0.avi,79,2253,1825,428,23.45205479452055,morphological_dilation,3,2
0X7D63A7259A3897D0.avi,105,1892,1500,392,26.13333333333333,morphological_dilation,3,2
0X7D687BF5AC8C33FF.avi,26,990,706,284,40.226628895184135,morphological_dilation,3,2
0X7D687BF5AC8C33FF.avi,31,580,356,224,62.92134831460674,morphological_dilation,3,2
0X7D6FE68C1C17A7C6.avi,77,1537,1173,364,31.031543052003407,morphological_dilation,3,2
0X7D6FE68C1C17A7C6.avi,99,1055,751,304,40.47936085219707,morphological_dilation,3,2
0X7D714831754A6554.avi,38,1599,1231,368,29.894394800974815,morphological_dilation,3,2
0X7D714831754A6554.avi,48,1027,715,312,43.63636363636363,morphological_dilation,3,2
0X7D73E6E86837FFD9.avi,69,1981,1581,400,25.30044275774826,morphological_dilation,3,2
0X7D73E6E86837FFD9.avi,89,1362,1030,332,32.23300970873787,morphological_dilation,3,2
0X7D74FC40A9B3DEFE.avi,75,1820,1420,400,28.169014084507044,morphological_dilation,3,2
0X7D74FC40A9B3DEFE.avi,94,1120,800,320,40.0,morphological_dilation,3,2
0X7D759A4FA9F2837.avi,21,2667,2187,480,21.947873799725652,morphological_dilation,3,2
0X7D759A4FA9F2837.avi,41,1529,1153,376,32.61058109280139,morphological_dilation,3,2
0X7D75B913B4E1EA73.avi,44,4489,3885,604,15.546975546975547,morphological_dilation,3,2
0X7D75B913B4E1EA73.avi,62,2275,1843,432,23.440043407487792,morphological_dilation,3,2
0X7D78994E4A3FCC6D.avi,5,2681,2213,468,21.14776321735201,morphological_dilation,3,2
0X7D78994E4A3FCC6D.avi,20,2316,1888,428,22.66949152542373,morphological_dilation,3,2
0X7D78F3613852C759.avi,46,1890,1494,396,26.506024096385545,morphological_dilation,3,2
0X7D78F3613852C759.avi,63,1280,948,332,35.0210970464135,morphological_dilation,3,2
0X7D7C468C359E3E07.avi,117,1319,999,320,32.032032032032035,morphological_dilation,3,2
0X7D7C468C359E3E07.avi,134,957,681,276,40.52863436123348,morphological_dilation,3,2
0X7D8600F1074A1731.avi,57,2602,2130,472,22.15962441314554,morphological_dilation,3,2
0X7D8600F1074A1731.avi,78,1620,1236,384,31.06796116504854,morphological_dilation,3,2
0X7D8896D7ABA514A8.avi,105,2679,2143,536,25.011665888940737,morphological_dilation,3,2
0X7D8896D7ABA514A8.avi,130,2056,1584,472,29.797979797979796,morphological_dilation,3,2
0X7D88E00C316BF203.avi,50,1742,1362,380,27.900146842878122,morphological_dilation,3,2
0X7D88E00C316BF203.avi,64,1165,845,320,37.8698224852071,morphological_dilation,3,2
0X7D8ABCFB75E1ADBB.avi,38,2152,1748,404,23.112128146453088,morphological_dilation,3,2
0X7D8ABCFB75E1ADBB.avi,57,1760,1388,372,26.801152737752158,morphological_dilation,3,2
0X7D8D06DE42E09937.avi,94,1994,1590,404,25.40880503144654,morphological_dilation,3,2
0X7D8D06DE42E09937.avi,109,1250,934,316,33.83297644539615,morphological_dilation,3,2
0X7D919A10DD368B11.avi,37,2485,2037,448,21.993127147766323,morphological_dilation,3,2
0X7D919A10DD368B11.avi,55,1763,1359,404,29.72774098601913,morphological_dilation,3,2
0X7D94F81C5387DFB9.avi,73,1788,1404,384,27.350427350427353,morphological_dilation,3,2
0X7D94F81C5387DFB9.avi,82,1009,697,312,44.76327116212339,morphological_dilation,3,2
0X7D99736023C684B0.avi,155,1657,1294,363,28.052550231839255,morphological_dilation,3,2
0X7D99736023C684B0.avi,166,1086,784,302,38.52040816326531,morphological_dilation,3,2
0X7D9F7769029B6B6C.avi,32,1461,1107,354,31.978319783197833,morphological_dilation,3,2
0X7D9F7769029B6B6C.avi,42,1078,762,316,41.46981627296588,morphological_dilation,3,2
0X7DA2B79E3C7E5531.avi,77,3038,2516,522,20.747217806041334,morphological_dilation,3,2
0X7DA2B79E3C7E5531.avi,94,1662,1217,445,36.56532456861134,morphological_dilation,3,2
0X7DA74EAC9DFC2D5B.avi,54,1937,1541,396,25.697598961713176,morphological_dilation,3,2
0X7DA74EAC9DFC2D5B.avi,70,1238,906,332,36.64459161147903,morphological_dilation,3,2
0X7DA7FE6D7C38E348.avi,50,1554,1194,360,30.15075376884422,morphological_dilation,3,2
0X7DA7FE6D7C38E348.avi,68,913,625,288,46.08,morphological_dilation,3,2
0X7DAE3C83E62D7300.avi,49,1907,1515,392,25.874587458745875,morphological_dilation,3,2
0X7DAE3C83E62D7300.avi,65,1182,850,332,39.05882352941176,morphological_dilation,3,2
0X7DBCD32E64B1AB22.avi,129,1847,1459,388,26.593557230980124,morphological_dilation,3,2
0X7DBCD32E64B1AB22.avi,146,1151,839,312,37.18712753277711,morphological_dilation,3,2
0X7DBD9306566CBD10.avi,37,1744,1352,392,28.994082840236686,morphological_dilation,3,2
0X7DBD9306566CBD10.avi,54,1055,747,308,41.231593038821956,morphological_dilation,3,2
0X7DBEF3FB9A0BCA64.avi,132,1774,1378,396,28.737300435413644,morphological_dilation,3,2
0X7DBEF3FB9A0BCA64.avi,149,1009,713,296,41.51472650771388,morphological_dilation,3,2
0X7DBEFBE8095593DB.avi,54,1872,1488,384,25.806451612903224,morphological_dilation,3,2
0X7DBEFBE8095593DB.avi,69,1298,969,329,33.952528379772964,morphological_dilation,3,2
0X7DC0B4B357668325.avi,88,2039,1651,388,23.50090854027862,morphological_dilation,3,2
0X7DC0B4B357668325.avi,104,1170,862,308,35.730858468677496,morphological_dilation,3,2
0X7DC3724BF02AC1D0.avi,84,2303,1859,444,23.883808499193115,morphological_dilation,3,2
0X7DC3724BF02AC1D0.avi,104,1540,1176,364,30.952380952380953,morphological_dilation,3,2
0X7DC3F04A5A3EA2FB.avi,71,1972,1548,424,27.39018087855297,morphological_dilation,3,2
0X7DC3F04A5A3EA2FB.avi,84,1168,848,320,37.735849056603776,morphological_dilation,3,2
0X7DC7546F7690E198.avi,41,1205,877,328,37.40022805017104,morphological_dilation,3,2
0X7DC7546F7690E198.avi,56,806,522,284,54.406130268199234,morphological_dilation,3,2
0X7DD0CDE4F55D32BF.avi,0,4299,3683,616,16.725495519956556,morphological_dilation,3,2
0X7DD0CDE4F55D32BF.avi,16,2787,2273,514,22.613286405631325,morphological_dilation,3,2
0X7DD29CE777E65CEC.avi,49,1911,1543,368,23.849643551523005,morphological_dilation,3,2
0X7DD29CE777E65CEC.avi,62,1682,1342,340,25.335320417287633,morphological_dilation,3,2
0X7DD583CBA190CCCA.avi,51,1793,1390,403,28.992805755395683,morphological_dilation,3,2
0X7DD583CBA190CCCA.avi,72,1100,757,343,45.310435931307794,morphological_dilation,3,2
0X7DDD45D433603256.avi,52,1477,1141,336,29.447852760736197,morphological_dilation,3,2
0X7DDD45D433603256.avi,67,925,649,276,42.526964560862865,morphological_dilation,3,2
0X7DDDD231EBB796C1.avi,3,1386,1062,324,30.508474576271187,morphological_dilation,3,2
0X7DDDD231EBB796C1.avi,17,846,570,276,48.421052631578945,morphological_dilation,3,2
0X7DDF0EC1E66C7415.avi,3,1427,1063,364,34.24270931326435,morphological_dilation,3,2
0X7DDF0EC1E66C7415.avi,15,855,555,300,54.054054054054056,morphological_dilation,3,2
0X7DE5F4D17C87F518.avi,52,1912,1500,412,27.46666666666667,morphological_dilation,3,2
0X7DE5F4D17C87F518.avi,69,1172,832,340,40.86538461538461,morphological_dilation,3,2
0X7DE76E1393920C4C.avi,63,3134,2630,504,19.163498098859318,morphological_dilation,3,2
0X7DE76E1393920C4C.avi,78,2465,2011,454,22.5758329189458,morphological_dilation,3,2
0X7DE8489883F940C7.avi,60,2514,2074,440,21.215043394406944,morphological_dilation,3,2
0X7DE8489883F940C7.avi,77,2009,1613,396,24.5505269683819,morphological_dilation,3,2
0X7DE8BF9416439516.avi,49,1216,892,324,36.32286995515695,morphological_dilation,3,2
0X7DE8BF9416439516.avi,66,662,373,289,77.4798927613941,morphological_dilation,3,2
0X7DE8E63672D26C40.avi,108,1694,1282,412,32.13728549141966,morphological_dilation,3,2
0X7DE8E63672D26C40.avi,125,1104,768,336,43.75,morphological_dilation,3,2
0X7DED63697C8793C1.avi,60,1758,1382,376,27.206946454413895,morphological_dilation,3,2
0X7DED63697C8793C1.avi,75,1205,893,312,34.93840985442329,morphological_dilation,3,2
0X7DEDA8CF84A3A406.avi,3,1578,1202,376,31.281198003327788,morphological_dilation,3,2
0X7DEDA8CF84A3A406.avi,18,954,647,307,47.44976816074188,morphological_dilation,3,2
0X7DEF57A51BC30923.avi,97,2079,1675,404,24.119402985074625,morphological_dilation,3,2
0X7DEF57A51BC30923.avi,116,1601,1234,367,29.740680713128036,morphological_dilation,3,2
0X7DF4117F27AA3D96.avi,106,2378,1942,436,22.451081359423274,morphological_dilation,3,2
0X7DF4117F27AA3D96.avi,118,1520,1160,360,31.03448275862069,morphological_dilation,3,2
0X7DF4CD457E50176D.avi,71,1653,1293,360,27.842227378190255,morphological_dilation,3,2
0X7DF4CD457E50176D.avi,87,989,693,296,42.712842712842715,morphological_dilation,3,2
0X7DF4F29C9FA848A4.avi,54,2704,2240,464,20.714285714285715,morphological_dilation,3,2
0X7DF4F29C9FA848A4.avi,71,1857,1457,400,27.453671928620455,morphological_dilation,3,2
0X7DF5817CCA22438E.avi,110,1141,849,292,34.39340400471143,morphological_dilation,3,2
0X7DF5817CCA22438E.avi,129,705,461,244,52.92841648590022,morphological_dilation,3,2
0X7DF5D27D4C9EAD89.avi,33,2138,1738,400,23.014959723820482,morphological_dilation,3,2
0X7DF5D27D4C9EAD89.avi,48,1209,889,320,35.9955005624297,morphological_dilation,3,2
0X7DF70019168CB29B.avi,40,1548,1180,368,31.186440677966104,morphological_dilation,3,2
0X7DF70019168CB29B.avi,56,1055,738,317,42.953929539295395,morphological_dilation,3,2
0X7DFAE6F2089B2594.avi,72,1611,1235,376,30.44534412955466,morphological_dilation,3,2
0X7DFAE6F2089B2594.avi,86,1067,727,340,46.76753782668501,morphological_dilation,3,2
0X7DFF7BAA1B2E4700.avi,69,3299,2799,500,17.863522686673814,morphological_dilation,3,2
0X7DFF7BAA1B2E4700.avi,84,2829,2361,468,19.82210927573062,morphological_dilation,3,2
0X7E0135356970C1A1.avi,79,1834,1434,400,27.89400278940028,morphological_dilation,3,2
0X7E0135356970C1A1.avi,95,1163,833,330,39.61584633853541,morphological_dilation,3,2
0X7E03DC0DBBD76FFE.avi,26,2140,1716,424,24.708624708624708,morphological_dilation,3,2
0X7E03DC0DBBD76FFE.avi,44,1468,1096,372,33.941605839416056,morphological_dilation,3,2
0X7E0565C38530F24C.avi,59,2083,1651,432,26.16596002422774,morphological_dilation,3,2
0X7E0565C38530F24C.avi,73,1293,936,357,38.141025641025635,morphological_dilation,3,2
0X7E06DB07314DEC7.avi,39,5529,4885,644,13.183213920163766,morphological_dilation,3,2
0X7E06DB07314DEC7.avi,58,3629,3073,556,18.093068662544745,morphological_dilation,3,2
0X7E08C6E04DE8DB0F.avi,0,1546,1205,341,28.29875518672199,morphological_dilation,3,2
0X7E08C6E04DE8DB0F.avi,17,1284,964,320,33.19502074688796,morphological_dilation,3,2
0X7E09E67C095EA7C0.avi,71,982,701,281,40.08559201141227,morphological_dilation,3,2
0X7E09E67C095EA7C0.avi,92,586,366,220,60.10928961748634,morphological_dilation,3,2
0X7E0ACE153EE2260F.avi,24,1515,1175,340,28.936170212765955,morphological_dilation,3,2
0X7E0ACE153EE2260F.avi,34,864,600,264,44.0,morphological_dilation,3,2
0X7E1023DC25D3B318.avi,85,3245,2733,512,18.733991950237833,morphological_dilation,3,2
0X7E1023DC25D3B318.avi,101,2435,2011,424,21.084037792143214,morphological_dilation,3,2
0X7E12D3121940CDF6.avi,42,1795,1403,392,27.94012829650748,morphological_dilation,3,2
0X7E12D3121940CDF6.avi,62,1215,883,332,37.599093997735,morphological_dilation,3,2
0X7E15A2E78B07ADE2.avi,42,1853,1461,392,26.830937713894592,morphological_dilation,3,2
0X7E15A2E78B07ADE2.avi,55,1404,1040,364,35.0,morphological_dilation,3,2
0X7E1703D6C05CEE3F.avi,24,1424,1092,332,30.4029304029304,morphological_dilation,3,2
0X7E1703D6C05CEE3F.avi,35,940,664,276,41.566265060240966,morphological_dilation,3,2
0X7E17E85D21D4D683.avi,101,2081,1661,420,25.285972305839856,morphological_dilation,3,2
0X7E17E85D21D4D683.avi,120,1241,897,344,38.35005574136009,morphological_dilation,3,2
0X7E1B29A2BE138FC.avi,0,1953,1585,368,23.217665615141954,morphological_dilation,3,2
0X7E1B29A2BE138FC.avi,16,1472,1136,336,29.577464788732392,morphological_dilation,3,2
0X7E1ED32C166D83A8.avi,34,1946,1554,392,25.225225225225223,morphological_dilation,3,2
0X7E1ED32C166D83A8.avi,49,1628,1276,352,27.586206896551722,morphological_dilation,3,2
0X7E22E4FE22BE624B.avi,19,1463,1119,344,30.741733690795353,morphological_dilation,3,2
0X7E22E4FE22BE624B.avi,30,913,633,280,44.23380726698262,morphological_dilation,3,2
0X7E236CD4C4C6A4A7.avi,67,2176,1752,424,24.200913242009133,morphological_dilation,3,2
0X7E236CD4C4C6A4A7.avi,86,1408,1038,370,35.64547206165704,morphological_dilation,3,2
0X7E23FFF51EDA2FA7.avi,150,2648,2184,464,21.245421245421245,morphological_dilation,3,2
0X7E23FFF51EDA2FA7.avi,166,1904,1500,404,26.93333333333333,morphological_dilation,3,2
0X7E2437FA9BB9A9BE.avi,3,2427,1936,491,25.361570247933884,morphological_dilation,3,2
0X7E2437FA9BB9A9BE.avi,17,1403,962,441,45.84199584199584,morphological_dilation,3,2
0X7E245EA8FCB5B13.avi,128,1392,1068,324,30.337078651685395,morphological_dilation,3,2
0X7E245EA8FCB5B13.avi,143,966,694,272,39.19308357348703,morphological_dilation,3,2
0X7E2898BDFAEEFE47.avi,42,2395,1971,424,21.511922881785893,morphological_dilation,3,2
0X7E2898BDFAEEFE47.avi,60,1610,1254,356,28.38915470494418,morphological_dilation,3,2
0X7E2A6FAF7D5669F0.avi,60,1454,1106,348,31.464737793851715,morphological_dilation,3,2
0X7E2A6FAF7D5669F0.avi,70,990,678,312,46.017699115044245,morphological_dilation,3,2
0X7E2CCCD26033DD2A.avi,126,1889,1505,384,25.514950166112953,morphological_dilation,3,2
0X7E2CCCD26033DD2A.avi,147,1335,1007,328,32.57199602780536,morphological_dilation,3,2
0X7E2D179960B03654.avi,50,1641,1277,364,28.50430696945967,morphological_dilation,3,2
0X7E2D179960B03654.avi,65,947,663,284,42.835595776772244,morphological_dilation,3,2
0X7E2E682CAF764E00.avi,104,2871,2379,492,20.68095838587642,morphological_dilation,3,2
0X7E2E682CAF764E00.avi,119,2060,1624,436,26.84729064039409,morphological_dilation,3,2
0X7E2E832595076130.avi,58,1789,1389,400,28.797696184305256,morphological_dilation,3,2
0X7E2E832595076130.avi,75,1098,770,328,42.59740259740259,morphological_dilation,3,2
0X7E2E8534D07DDBE.avi,42,1722,1334,388,29.08545727136432,morphological_dilation,3,2
0X7E2E8534D07DDBE.avi,55,1035,713,322,45.16129032258064,morphological_dilation,3,2
0X7E2F6A8A773EBE57.avi,77,2568,2108,460,21.821631878557877,morphological_dilation,3,2
0X7E2F6A8A773EBE57.avi,96,1776,1376,400,29.069767441860467,morphological_dilation,3,2
0X7E2FF5B9369E2E51.avi,50,1280,927,353,38.07982740021575,morphological_dilation,3,2
0X7E2FF5B9369E2E51.avi,65,828,473,355,75.05285412262155,morphological_dilation,3,2
0X7E32DC733A9F4C7.avi,40,2115,1659,456,27.48643761301989,morphological_dilation,3,2
0X7E32DC733A9F4C7.avi,53,1317,936,381,40.705128205128204,morphological_dilation,3,2
0X7E338DE86354DFBB.avi,1,1811,1403,408,29.080541696364932,morphological_dilation,3,2
0X7E338DE86354DFBB.avi,15,1117,781,336,43.02176696542894,morphological_dilation,3,2
0X7E379B92108E37EF.avi,43,1571,1215,356,29.300411522633745,morphological_dilation,3,2
0X7E379B92108E37EF.avi,59,1015,726,289,39.807162534435264,morphological_dilation,3,2
0X7E37D63514270905.avi,55,2966,2458,508,20.667209113100082,morphological_dilation,3,2
0X7E37D63514270905.avi,81,2122,1686,436,25.86002372479241,morphological_dilation,3,2
0X7E420105768FD9FE.avi,54,1342,1006,336,33.39960238568588,morphological_dilation,3,2
0X7E420105768FD9FE.avi,73,832,550,282,51.272727272727266,morphological_dilation,3,2
0X7E429DC3AED5BE34.avi,107,1932,1540,392,25.454545454545453,morphological_dilation,3,2
0X7E429DC3AED5BE34.avi,114,1770,1390,380,27.33812949640288,morphological_dilation,3,2
0X7E43798B43C11709.avi,55,1657,1297,360,27.756360832690824,morphological_dilation,3,2
0X7E43798B43C11709.avi,68,1177,853,324,37.98358733880422,morphological_dilation,3,2
0X7E45FF332B9BE28E.avi,44,1770,1383,387,27.9826464208243,morphological_dilation,3,2
0X7E45FF332B9BE28E.avi,59,1408,1076,332,30.855018587360593,morphological_dilation,3,2
0X7E4639354A0AF043.avi,58,2390,1966,424,21.566632756866735,morphological_dilation,3,2
0X7E4639354A0AF043.avi,74,2092,1700,392,23.058823529411764,morphological_dilation,3,2
0X7E46A5FDB773F2FC.avi,37,2268,1852,416,22.4622030237581,morphological_dilation,3,2
0X7E46A5FDB773F2FC.avi,55,2098,1710,388,22.690058479532162,morphological_dilation,3,2
0X7E4D98875A3BF1AB.avi,93,1749,1373,376,27.385287691187184,morphological_dilation,3,2
0X7E4D98875A3BF1AB.avi,106,1025,741,284,38.32658569500675,morphological_dilation,3,2
0X7E4F89B98A52555F.avi,46,1880,1488,392,26.344086021505376,morphological_dilation,3,2
0X7E4F89B98A52555F.avi,60,1124,820,304,37.073170731707314,morphological_dilation,3,2
0X7E51B1F0EBC1BD6C.avi,52,1386,1042,344,33.01343570057582,morphological_dilation,3,2
0X7E51B1F0EBC1BD6C.avi,73,941,639,302,47.26134585289515,morphological_dilation,3,2
0X7E53AE264125B7F9.avi,68,1964,1576,388,24.61928934010152,morphological_dilation,3,2
0X7E53AE264125B7F9.avi,83,1383,1045,338,32.344497607655505,morphological_dilation,3,2
0X7E5F7C851AE9AF55.avi,52,2468,2004,464,23.15369261477046,morphological_dilation,3,2
0X7E5F7C851AE9AF55.avi,72,1612,1224,388,31.699346405228756,morphological_dilation,3,2
0X7E654BC9652802D5.avi,56,1575,1223,352,28.781684382665578,morphological_dilation,3,2
0X7E654BC9652802D5.avi,65,1123,827,296,35.79201934703748,morphological_dilation,3,2
0X7E655DBE953C1A73.avi,95,1477,1117,360,32.22918531781558,morphological_dilation,3,2
0X7E655DBE953C1A73.avi,106,888,600,288,48.0,morphological_dilation,3,2
0X7E673A7B6123F76C.avi,99,1533,1197,336,28.07017543859649,morphological_dilation,3,2
0X7E673A7B6123F76C.avi,114,1000,720,280,38.88888888888889,morphological_dilation,3,2
0X7E6AA3C86277C4E.avi,135,1635,1275,360,28.235294117647058,morphological_dilation,3,2
0X7E6AA3C86277C4E.avi,157,1241,925,316,34.16216216216216,morphological_dilation,3,2
0X7E6CEE047BF80FF6.avi,2,1879,1479,400,27.045300878972277,morphological_dilation,3,2
0X7E6CEE047BF80FF6.avi,14,1045,733,312,42.56480218281037,morphological_dilation,3,2
0X7E6E3C03C2A05522.avi,45,3111,2635,476,18.064516129032256,morphological_dilation,3,2
0X7E6E3C03C2A05522.avi,62,2098,1666,432,25.930372148859544,morphological_dilation,3,2
0X7E6E452DB3269A4F.avi,95,1787,1407,380,27.007818052594175,morphological_dilation,3,2
0X7E6E452DB3269A4F.avi,114,1184,860,324,37.67441860465116,morphological_dilation,3,2
0X7E72FD13490DB722.avi,33,1723,1355,368,27.158671586715865,morphological_dilation,3,2
0X7E72FD13490DB722.avi,50,1085,777,308,39.63963963963964,morphological_dilation,3,2
0X7E731D5758FB247F.avi,80,1702,1334,368,27.586206896551722,morphological_dilation,3,2
0X7E731D5758FB247F.avi,109,1352,1020,332,32.549019607843135,morphological_dilation,3,2
0X7E773DD1C25D761.avi,57,2166,1738,428,24.62600690448792,morphological_dilation,3,2
0X7E773DD1C25D761.avi,76,1273,937,336,35.859124866595515,morphological_dilation,3,2
0X7E7BC8F597A191C6.avi,46,2438,2006,432,21.535393818544364,morphological_dilation,3,2
0X7E7BC8F597A191C6.avi,63,1736,1364,372,27.27272727272727,morphological_dilation,3,2
0X7E7C1BDAFEBB61FA.avi,48,2115,1691,424,25.073920756948553,morphological_dilation,3,2
0X7E7C1BDAFEBB61FA.avi,64,1406,1042,364,34.93282149712092,morphological_dilation,3,2
0X7E7D546F8D68F445.avi,59,2389,1929,460,23.846552617936755,morphological_dilation,3,2
0X7E7D546F8D68F445.avi,73,1293,941,352,37.40701381509033,morphological_dilation,3,2
0X7E83551D8C9C79BD.avi,124,2007,1611,396,24.581005586592177,morphological_dilation,3,2
0X7E83551D8C9C79BD.avi,142,1193,877,316,36.03192702394527,morphological_dilation,3,2
0X7E8632AE4089326E.avi,44,2590,2134,456,21.368322399250232,morphological_dilation,3,2
0X7E8632AE4089326E.avi,68,2345,1905,440,23.097112860892388,morphological_dilation,3,2
0X7E870E21566FC34B.avi,52,1263,963,300,31.15264797507788,morphological_dilation,3,2
0X7E870E21566FC34B.avi,69,978,698,280,40.114613180515754,morphological_dilation,3,2
0X7E8800EA8C40DF0C.avi,24,2436,1993,443,22.22779729051681,morphological_dilation,3,2
0X7E8800EA8C40DF0C.avi,38,1481,1125,356,31.644444444444442,morphological_dilation,3,2
0X7E8CCD93D8EA9D7.avi,38,1574,1206,368,30.514096185737976,morphological_dilation,3,2
0X7E8CCD93D8EA9D7.avi,53,1195,862,333,38.63109048723898,morphological_dilation,3,2
0X7E9560406E173927.avi,67,2643,2187,456,20.85048010973937,morphological_dilation,3,2
0X7E9560406E173927.avi,83,1567,1192,375,31.45973154362416,morphological_dilation,3,2
0X7E97922390602019.avi,43,2232,1816,416,22.90748898678414,morphological_dilation,3,2
0X7E97922390602019.avi,62,1353,983,370,37.639877924720246,morphological_dilation,3,2
0X7E991F3C31F6C17.avi,48,2117,1697,420,24.749558043606363,morphological_dilation,3,2
0X7E991F3C31F6C17.avi,67,1439,1099,340,30.937215650591448,morphological_dilation,3,2
0X7E9BC4EAB9EEA7F9.avi,33,2067,1663,404,24.29344558027661,morphological_dilation,3,2
0X7E9BC4EAB9EEA7F9.avi,48,1819,1439,380,26.40722724113968,morphological_dilation,3,2
0X7EA59EE03F02C35B.avi,99,2498,2058,440,21.379980563654033,morphological_dilation,3,2
0X7EA59EE03F02C35B.avi,114,1620,1228,392,31.921824104234524,morphological_dilation,3,2
0X7EA8D9C268C16137.avi,42,2004,1592,412,25.879396984924625,morphological_dilation,3,2
0X7EA8D9C268C16137.avi,56,1173,845,328,38.81656804733728,morphological_dilation,3,2
0X7EB2FC6CD65F86D2.avi,161,1367,1031,336,32.58971871968962,morphological_dilation,3,2
0X7EB2FC6CD65F86D2.avi,178,832,564,268,47.5177304964539,morphological_dilation,3,2
0X7EB4493502BE6170.avi,68,2024,1600,424,26.5,morphological_dilation,3,2
0X7EB4493502BE6170.avi,87,1724,1336,388,29.041916167664674,morphological_dilation,3,2
0X7EB490F7C2A158D8.avi,149,2694,2198,496,22.56596906278435,morphological_dilation,3,2
0X7EB490F7C2A158D8.avi,162,1779,1355,424,31.29151291512915,morphological_dilation,3,2
0X7EB6CE7A0EE060B0.avi,41,2118,1718,400,23.28288707799767,morphological_dilation,3,2
0X7EB6CE7A0EE060B0.avi,58,1314,990,324,32.72727272727273,morphological_dilation,3,2
0X7EBA049982BB9A40.avi,96,2786,2298,488,21.23585726718886,morphological_dilation,3,2
0X7EBA049982BB9A40.avi,115,1665,1257,408,32.4582338902148,morphological_dilation,3,2
0X7EBB0C21B95DA27D.avi,128,1827,1431,396,27.67295597484277,morphological_dilation,3,2
0X7EBB0C21B95DA27D.avi,153,1291,959,332,34.61939520333681,morphological_dilation,3,2
0X7EBF7E6F42E75FC3.avi,72,1344,1028,316,30.739299610894943,morphological_dilation,3,2
0X7EBF7E6F42E75FC3.avi,98,889,625,264,42.24,morphological_dilation,3,2
0X7EC12AC2BF084B28.avi,93,2169,1753,416,23.730747290359382,morphological_dilation,3,2
0X7EC12AC2BF084B28.avi,108,1746,1366,380,27.81844802342606,morphological_dilation,3,2
0X7EC4B89BCFA4841D.avi,44,1349,1001,348,34.765234765234766,morphological_dilation,3,2
0X7EC4B89BCFA4841D.avi,54,922,622,300,48.231511254019296,morphological_dilation,3,2
0X7EC67D9015EF4B0D.avi,116,1751,1379,372,26.976069615663523,morphological_dilation,3,2
0X7EC67D9015EF4B0D.avi,135,1563,1203,360,29.925187032418954,morphological_dilation,3,2
0X7EC841CC6F0DC078.avi,122,1057,777,280,36.03603603603604,morphological_dilation,3,2
0X7EC841CC6F0DC078.avi,136,703,471,232,49.25690021231423,morphological_dilation,3,2
0X7EC96F4D9167A448.avi,113,2137,1725,412,23.884057971014492,morphological_dilation,3,2
0X7EC96F4D9167A448.avi,128,1853,1473,380,25.797691785471827,morphological_dilation,3,2
0X7ECD0FC05155C51A.avi,84,3594,3042,552,18.14595660749507,morphological_dilation,3,2
0X7ECD0FC05155C51A.avi,101,1982,1542,440,28.534370946822307,morphological_dilation,3,2
0X7ECD208BCBDB30FF.avi,179,1517,1157,360,31.11495246326707,morphological_dilation,3,2
0X7ECD208BCBDB30FF.avi,202,971,672,299,44.49404761904761,morphological_dilation,3,2
0X7ECF02812DE8EFCE.avi,25,2115,1699,416,24.48499117127722,morphological_dilation,3,2
0X7ECF02812DE8EFCE.avi,37,1375,1023,352,34.40860215053764,morphological_dilation,3,2
0X7ED073E0F80E43D3.avi,56,2097,1689,408,24.156305506216697,morphological_dilation,3,2
0X7ED073E0F80E43D3.avi,76,1276,952,324,34.03361344537815,morphological_dilation,3,2
0X7ED1E92FFFD1AF5C.avi,3,1229,925,304,32.86486486486486,morphological_dilation,3,2
0X7ED1E92FFFD1AF5C.avi,17,835,583,252,43.22469982847341,morphological_dilation,3,2
0X7ED2FA1C9CE297BF.avi,29,1022,738,284,38.482384823848236,morphological_dilation,3,2
0X7ED2FA1C9CE297BF.avi,46,666,430,236,54.88372093023256,morphological_dilation,3,2
0X7ED3009A9CD8ADB5.avi,116,1601,1237,364,29.426030719482622,morphological_dilation,3,2
0X7ED3009A9CD8ADB5.avi,131,955,671,284,42.32488822652757,morphological_dilation,3,2
0X7ED560E44F1FA0C4.avi,195,1562,1194,368,30.82077051926298,morphological_dilation,3,2
0X7ED560E44F1FA0C4.avi,215,1022,718,304,42.33983286908078,morphological_dilation,3,2
0X7ED6C6FC729A391B.avi,57,3482,2958,524,17.714672075726842,morphological_dilation,3,2
0X7ED6C6FC729A391B.avi,77,2084,1656,428,25.845410628019323,morphological_dilation,3,2
0X7ED87AB27BE161FF.avi,38,1483,1135,348,30.66079295154185,morphological_dilation,3,2
0X7ED87AB27BE161FF.avi,50,989,701,288,41.08416547788873,morphological_dilation,3,2
0X7EDFA78D3FB002B0.avi,67,1478,1118,360,32.200357781753134,morphological_dilation,3,2
0X7EDFA78D3FB002B0.avi,84,955,651,304,46.6973886328725,morphological_dilation,3,2
0X7EE27209D0508B79.avi,49,2050,1630,420,25.766871165644172,morphological_dilation,3,2
0X7EE27209D0508B79.avi,65,1410,1055,355,33.649289099526065,morphological_dilation,3,2
0X7EE47A0A4ABB0115.avi,314,3248,2724,524,19.23641703377386,morphological_dilation,3,2
0X7EE47A0A4ABB0115.avi,361,2755,2295,460,20.043572984749456,morphological_dilation,3,2
0X7EE64D322158B13F.avi,123,1676,1292,384,29.721362229102166,morphological_dilation,3,2
0X7EE64D322158B13F.avi,138,993,685,308,44.96350364963504,morphological_dilation,3,2
0X7EE933A1912A146.avi,111,1326,978,348,35.58282208588957,morphological_dilation,3,2
0X7EE933A1912A146.avi,128,895,591,304,51.438240270727576,morphological_dilation,3,2
0X7EEA66DBE251854B.avi,100,2304,1860,444,23.870967741935484,morphological_dilation,3,2
0X7EEA66DBE251854B.avi,121,1879,1471,408,27.736233854520737,morphological_dilation,3,2
0X7EEEA16525CC87E5.avi,84,3100,2592,508,19.598765432098766,morphological_dilation,3,2
0X7EEEA16525CC87E5.avi,98,1671,1287,384,29.836829836829835,morphological_dilation,3,2
0X7EEFE2B06DC5E7D1.avi,78,2278,1858,420,22.604951560818083,morphological_dilation,3,2
0X7EEFE2B06DC5E7D1.avi,92,1492,1144,348,30.419580419580424,morphological_dilation,3,2
0X7EF7C12373EF33BD.avi,3,2018,1618,400,24.721878862793574,morphological_dilation,3,2
0X7EF7C12373EF33BD.avi,21,1355,1012,343,33.89328063241106,morphological_dilation,3,2
0X7EFDA5A4CDF6C678.avi,45,2176,1748,428,24.485125858123567,morphological_dilation,3,2
0X7EFDA5A4CDF6C678.avi,61,1425,1073,352,32.805219012115565,morphological_dilation,3,2
0X7EFE15741DE591F6.avi,51,1509,1149,360,31.33159268929504,morphological_dilation,3,2
0X7EFE15741DE591F6.avi,65,865,565,300,53.09734513274337,morphological_dilation,3,2
0X7EFE1E76A839FA63.avi,93,1396,1060,336,31.69811320754717,morphological_dilation,3,2
0X7EFE1E76A839FA63.avi,110,829,553,276,49.90958408679928,morphological_dilation,3,2
0X7F048295BF84C41B.avi,112,1741,1361,380,27.920646583394564,morphological_dilation,3,2
0X7F048295BF84C41B.avi,141,1178,862,316,36.65893271461717,morphological_dilation,3,2
0X7F058A3503090EC8.avi,6,1665,1273,392,30.793401413982718,morphological_dilation,3,2
0X7F058A3503090EC8.avi,17,1028,716,312,43.575418994413404,morphological_dilation,3,2
0X7F1E35093F4B437E.avi,81,1915,1515,400,26.4026402640264,morphological_dilation,3,2
0X7F1E35093F4B437E.avi,99,1160,840,320,38.095238095238095,morphological_dilation,3,2
0X7F1E7ABCC62403A0.avi,150,1570,1202,368,30.615640599001665,morphological_dilation,3,2
0X7F1E7ABCC62403A0.avi,168,936,644,292,45.3416149068323,morphological_dilation,3,2
0X7F20614AB09F7092.avi,76,1491,1147,344,29.991281604184827,morphological_dilation,3,2
0X7F20614AB09F7092.avi,95,1083,775,308,39.74193548387097,morphological_dilation,3,2
0X7F2326218F61FEDE.avi,139,1831,1435,396,27.595818815331008,morphological_dilation,3,2
0X7F2326218F61FEDE.avi,158,1006,694,312,44.95677233429395,morphological_dilation,3,2
0X7F271243B0FAAA2D.avi,30,2720,2252,468,20.781527531083483,morphological_dilation,3,2
0X7F271243B0FAAA2D.avi,36,2523,2071,452,21.825205214872042,morphological_dilation,3,2
0X7F27475CB49B8FE.avi,102,1888,1460,428,29.315068493150687,morphological_dilation,3,2
0X7F27475CB49B8FE.avi,121,1126,770,356,46.23376623376623,morphological_dilation,3,2
0X7F2BC02FB5C2AFBC.avi,68,1537,1153,384,33.30442324371206,morphological_dilation,3,2
0X7F2BC02FB5C2AFBC.avi,83,1030,705,325,46.09929078014184,morphological_dilation,3,2
0X7F2CD5493EA12EBE.avi,2,1703,1312,391,29.801829268292686,morphological_dilation,3,2
0X7F2CD5493EA12EBE.avi,15,1047,731,316,43.22845417236662,morphological_dilation,3,2
0X7F33CFDB31ADCD6A.avi,40,1623,1251,372,29.73621103117506,morphological_dilation,3,2
0X7F33CFDB31ADCD6A.avi,95,1928,1422,506,35.58368495077356,morphological_dilation,3,2
0X7F3ABE82B6992583.avi,97,1248,924,324,35.064935064935064,morphological_dilation,3,2
0X7F3ABE82B6992583.avi,107,724,452,272,60.17699115044248,morphological_dilation,3,2
0X7F3F1029C810EC0C.avi,44,3354,2837,517,18.22347550229115,morphological_dilation,3,2
0X7F3F1029C810EC0C.avi,60,2210,1742,468,26.865671641791046,morphological_dilation,3,2
0X7F44B26015459155.avi,35,2384,1920,464,24.166666666666668,morphological_dilation,3,2
0X7F44B26015459155.avi,49,1602,1198,404,33.7228714524207,morphological_dilation,3,2
0X7F49972656B12401.avi,99,1611,1247,364,29.190056134723335,morphological_dilation,3,2
0X7F49972656B12401.avi,119,1019,713,306,42.91725105189341,morphological_dilation,3,2
0X7F4A99BDBFC2182F.avi,124,2447,1991,456,22.903063787041688,morphological_dilation,3,2
0X7F4A99BDBFC2182F.avi,143,1609,1217,392,32.21035332785539,morphological_dilation,3,2
0X7F4C057216F1A154.avi,118,2152,1740,412,23.678160919540232,morphological_dilation,3,2
0X7F4C057216F1A154.avi,134,1292,968,324,33.47107438016529,morphological_dilation,3,2
0X7F50F813F8D25B5B.avi,83,1444,1080,364,33.7037037037037,morphological_dilation,3,2
0X7F50F813F8D25B5B.avi,93,1127,797,330,41.40526976160602,morphological_dilation,3,2
0X7F59661D773B332C.avi,128,3534,2974,560,18.82985877605918,morphological_dilation,3,2
0X7F59661D773B332C.avi,146,3123,2593,530,20.439645198611647,morphological_dilation,3,2
0X7F5987A4C2EE04A.avi,109,1945,1529,416,27.20732504905167,morphological_dilation,3,2
0X7F5987A4C2EE04A.avi,124,1487,1123,364,32.41317898486198,morphological_dilation,3,2
0X7F5CB71A507DF8D1.avi,37,1423,1092,331,30.31135531135531,morphological_dilation,3,2
0X7F5CB71A507DF8D1.avi,54,939,655,284,43.358778625954194,morphological_dilation,3,2
0X7F5FDD0D4BE306D8.avi,62,1728,1356,372,27.43362831858407,morphological_dilation,3,2
0X7F5FDD0D4BE306D8.avi,76,1518,1166,352,30.18867924528302,morphological_dilation,3,2
0X7F626207A5FD5189.avi,51,2127,1715,412,24.02332361516035,morphological_dilation,3,2
0X7F626207A5FD5189.avi,70,1267,937,330,35.2187833511206,morphological_dilation,3,2
0X7F65556BA84EBBCB.avi,33,1378,1038,340,32.75529865125241,morphological_dilation,3,2
0X7F65556BA84EBBCB.avi,45,1318,857,461,53.79229871645275,morphological_dilation,3,2
0X7F666F93B086F12C.avi,89,1496,1148,348,30.313588850174217,morphological_dilation,3,2
0X7F666F93B086F12C.avi,103,959,659,300,45.52352048558422,morphological_dilation,3,2
0X7F6828554FDAF24.avi,79,1429,1069,360,33.67633302151544,morphological_dilation,3,2
0X7F6828554FDAF24.avi,97,883,545,338,62.018348623853214,morphological_dilation,3,2
0X7F6B899860079B54.avi,87,4363,3767,596,15.821608707194054,morphological_dilation,3,2
0X7F6B899860079B54.avi,102,3823,3267,556,17.01867156412611,morphological_dilation,3,2
0X7F6D009D54D33E63.avi,38,1922,1510,412,27.28476821192053,morphological_dilation,3,2
0X7F6D009D54D33E63.avi,53,1222,871,351,40.298507462686565,morphological_dilation,3,2
0X7F6DB8B3D4E8B55.avi,49,1604,1252,352,28.115015974440894,morphological_dilation,3,2
0X7F6DB8B3D4E8B55.avi,67,1032,736,296,40.21739130434783,morphological_dilation,3,2
0X7F6E0885BC9B860B.avi,49,1432,1100,332,30.181818181818183,morphological_dilation,3,2
0X7F6E0885BC9B860B.avi,68,896,602,294,48.837209302325576,morphological_dilation,3,2
0X7F7068CC85CAA239.avi,37,1163,859,304,35.389988358556465,morphological_dilation,3,2
0X7F7068CC85CAA239.avi,48,766,502,264,52.589641434262944,morphological_dilation,3,2
0X7F729CDC1F8A8FB2.avi,65,2510,2047,463,22.61846604787494,morphological_dilation,3,2
0X7F729CDC1F8A8FB2.avi,83,1366,998,368,36.87374749498998,morphological_dilation,3,2
0X7F76F93FC067F40D.avi,113,1497,1157,340,29.386343993085568,morphological_dilation,3,2
0X7F76F93FC067F40D.avi,128,1189,889,300,33.74578177727784,morphological_dilation,3,2
0X7F83AF45B348B1D9.avi,33,2684,2208,476,21.557971014492754,morphological_dilation,3,2
0X7F83AF45B348B1D9.avi,45,1646,1266,380,30.01579778830964,morphological_dilation,3,2
0X7F888CA2AE13003C.avi,136,1525,1157,368,31.80639585133967,morphological_dilation,3,2
0X7F888CA2AE13003C.avi,154,953,637,316,49.60753532182103,morphological_dilation,3,2
0X7F8C1AE16F2BE812.avi,108,2573,2093,480,22.933588150979457,morphological_dilation,3,2
0X7F8C1AE16F2BE812.avi,123,1795,1376,419,30.450581395348834,morphological_dilation,3,2
0X7F8E427A8C0CAA8.avi,73,1277,953,324,33.997901364113325,morphological_dilation,3,2
0X7F8E427A8C0CAA8.avi,90,870,601,269,44.75873544093178,morphological_dilation,3,2
0X7F9D0256F9D9B44F.avi,56,2882,2390,492,20.585774058577407,morphological_dilation,3,2
0X7F9D0256F9D9B44F.avi,81,1801,1352,449,33.210059171597635,morphological_dilation,3,2
0X7F9E684F7BD8FF64.avi,1,1069,767,302,39.374185136897,morphological_dilation,3,2
0X7F9E684F7BD8FF64.avi,13,625,385,240,62.33766233766234,morphological_dilation,3,2
0X7F9ED6D9B7543E46.avi,86,1470,1103,367,33.27289211242067,morphological_dilation,3,2
0X7F9ED6D9B7543E46.avi,106,977,660,317,48.03030303030303,morphological_dilation,3,2
0X7FA12212C7887EC7.avi,31,2073,1645,428,26.018237082066868,morphological_dilation,3,2
0X7FA12212C7887EC7.avi,45,1134,813,321,39.48339483394834,morphological_dilation,3,2
0X7FA1AACC44E2B13D.avi,42,1817,1405,412,29.323843416370103,morphological_dilation,3,2
0X7FA1AACC44E2B13D.avi,58,1144,787,357,45.36213468869123,morphological_dilation,3,2
0X7FA1DE5F5006E04B.avi,98,1635,1259,376,29.864972200158856,morphological_dilation,3,2
0X7FA1DE5F5006E04B.avi,116,1050,742,308,41.509433962264154,morphological_dilation,3,2
0X7FA40A4991567843.avi,71,1241,909,332,36.52365236523652,morphological_dilation,3,2
0X7FA40A4991567843.avi,85,823,547,276,50.45703839122486,morphological_dilation,3,2
0X7FA84CF03DD99FD3.avi,96,1704,1304,400,30.67484662576687,morphological_dilation,3,2
0X7FA84CF03DD99FD3.avi,112,904,584,320,54.794520547945204,morphological_dilation,3,2
0X7FACBF00899A8ACF.avi,43,901,621,280,45.088566827697264,morphological_dilation,3,2
0X7FACBF00899A8ACF.avi,58,579,341,238,69.79472140762464,morphological_dilation,3,2
0X7FADA6C7AC45A389.avi,0,1397,1049,348,33.17445185891325,morphological_dilation,3,2
0X7FADA6C7AC45A389.avi,17,910,606,304,50.165016501650165,morphological_dilation,3,2
0X7FB15C9CF30544A4.avi,1,984,704,280,39.77272727272727,morphological_dilation,3,2
0X7FB15C9CF30544A4.avi,16,671,427,244,57.14285714285714,morphological_dilation,3,2
0X7FB52DF47D58D5EF.avi,40,1421,1089,332,30.486685032139576,morphological_dilation,3,2
0X7FB52DF47D58D5EF.avi,58,943,655,288,43.969465648854964,morphological_dilation,3,2
0X7FB86702C128C3E7.avi,108,2082,1678,404,24.076281287246722,morphological_dilation,3,2
0X7FB86702C128C3E7.avi,125,1481,1125,356,31.644444444444442,morphological_dilation,3,2
0X7FBA0A353972E8CE.avi,37,2696,2232,464,20.78853046594982,morphological_dilation,3,2
0X7FBA0A353972E8CE.avi,54,1874,1462,412,28.18057455540356,morphological_dilation,3,2
0X7FBBFD75F86988E1.avi,62,1522,1154,368,31.88908145580589,morphological_dilation,3,2
0X7FBBFD75F86988E1.avi,82,983,691,292,42.2575976845152,morphological_dilation,3,2
0X7FBE933AD38C3009.avi,98,2644,2157,487,22.577654149281408,morphological_dilation,3,2
0X7FBE933AD38C3009.avi,110,1561,1153,408,35.38594969644406,morphological_dilation,3,2
0X7FCC13D41D507C64.avi,42,3956,3392,564,16.62735849056604,morphological_dilation,3,2
0X7FCC13D41D507C64.avi,56,3355,2835,520,18.342151675485006,morphological_dilation,3,2
0X7FCE5D1FB46D6BDE.avi,71,1285,961,324,33.714880332986475,morphological_dilation,3,2
0X7FCE5D1FB46D6BDE.avi,92,772,528,244,46.21212121212121,morphological_dilation,3,2
0X7FCF556C166C571.avi,7,1857,1489,368,24.71457353928811,morphological_dilation,3,2
0X7FCF556C166C571.avi,17,1308,992,316,31.85483870967742,morphological_dilation,3,2
0X7FD042711B0E1D27.avi,72,1539,1199,340,28.35696413678065,morphological_dilation,3,2
0X7FD042711B0E1D27.avi,88,996,720,276,38.333333333333336,morphological_dilation,3,2
0X7FD058A6306C7EF8.avi,37,2519,2067,452,21.867440735365264,morphological_dilation,3,2
0X7FD058A6306C7EF8.avi,52,1444,1076,368,34.20074349442379,morphological_dilation,3,2
0X7FD0FEBD1D0CB00C.avi,94,2503,2053,450,21.919142717973696,morphological_dilation,3,2
0X7FD0FEBD1D0CB00C.avi,115,2046,1626,420,25.830258302583026,morphological_dilation,3,2
0X7FDE5F6E1091C024.avi,0,1726,1338,388,28.998505231689087,morphological_dilation,3,2
0X7FDE5F6E1091C024.avi,14,1552,1188,364,30.63973063973064,morphological_dilation,3,2
0X7FDEEB42B822AABC.avi,53,1443,1087,356,32.750689972401105,morphological_dilation,3,2
0X7FDEEB42B822AABC.avi,69,817,541,276,51.01663585951941,morphological_dilation,3,2
0X7FE0B07EC190E77D.avi,54,2034,1634,400,24.479804161566708,morphological_dilation,3,2
0X7FE0B07EC190E77D.avi,66,1586,1210,376,31.074380165289256,morphological_dilation,3,2
0X7FE0C465A0251BAE.avi,35,1824,1440,384,26.666666666666668,morphological_dilation,3,2
0X7FE0C465A0251BAE.avi,53,1087,783,304,38.8250319284802,morphological_dilation,3,2
0X7FE18A8EC2E2E11A.avi,78,1761,1381,380,27.516292541636496,morphological_dilation,3,2
0X7FE18A8EC2E2E11A.avi,93,1130,818,312,38.141809290953546,morphological_dilation,3,2
0X7FE1C56B8173D76B.avi,91,1733,1326,407,30.693815987933636,morphological_dilation,3,2
0X7FE1C56B8173D76B.avi,107,1065,728,337,46.291208791208796,morphological_dilation,3,2
0X7FE309A386708568.avi,114,2124,1708,416,24.355971896955502,morphological_dilation,3,2
0X7FE309A386708568.avi,139,1571,1213,358,29.513602638087388,morphological_dilation,3,2
0X7FE48E5475ADE2E3.avi,94,1966,1566,400,25.54278416347382,morphological_dilation,3,2
0X7FE48E5475ADE2E3.avi,119,2368,1932,436,22.56728778467909,morphological_dilation,3,2
0X7FE620885816A032.avi,79,3001,2533,468,18.4761152783261,morphological_dilation,3,2
0X7FE620885816A032.avi,94,2534,2090,444,21.24401913875598,morphological_dilation,3,2
0X7FE6224B4AC49B7E.avi,54,2859,2383,476,19.974821653378093,morphological_dilation,3,2
0X7FE6224B4AC49B7E.avi,72,2158,1742,416,23.88059701492537,morphological_dilation,3,2
0X7FE8D1F8E0376B88.avi,52,1813,1413,400,28.308563340410476,morphological_dilation,3,2
0X7FE8D1F8E0376B88.avi,74,1235,899,336,37.37486095661847,morphological_dilation,3,2
0X7FE97EB98940401D.avi,74,1646,1276,370,28.996865203761757,morphological_dilation,3,2
0X7FE97EB98940401D.avi,95,1058,738,320,43.360433604336045,morphological_dilation,3,2
0X7FE9B2FFC96B60E6.avi,50,2924,2452,472,19.249592169657422,morphological_dilation,3,2
0X7FE9B2FFC96B60E6.avi,67,2548,2120,428,20.18867924528302,morphological_dilation,3,2
0X7FEC2CF1EBF472C6.avi,171,1613,1221,392,32.104832104832106,morphological_dilation,3,2
0X7FEC2CF1EBF472C6.avi,190,988,676,312,46.15384615384615,morphological_dilation,3,2
0X7FF2092E3F8724DC.avi,47,2003,1603,400,24.953212726138492,morphological_dilation,3,2
0X7FF2092E3F8724DC.avi,64,1278,946,332,35.095137420718814,morphological_dilation,3,2
0X7FF6111130FB1E5E.avi,44,2607,2135,472,22.107728337236534,morphological_dilation,3,2
0X7FF6111130FB1E5E.avi,62,1935,1531,404,26.3879817112998,morphological_dilation,3,2
0X7FF6AF6E2EAF781.avi,54,1516,1180,336,28.474576271186443,morphological_dilation,3,2
0X7FF6AF6E2EAF781.avi,68,1271,967,304,31.437435367114787,morphological_dilation,3,2
0X7FFB6106C779A974.avi,61,2279,1863,416,22.32957595276436,morphological_dilation,3,2
0X7FFB6106C779A974.avi,77,1377,1017,360,35.39823008849557,morphological_dilation,3,2
0X7FFE47211BD0EA01.avi,95,1562,1198,364,30.38397328881469,morphological_dilation,3,2
0X7FFE47211BD0EA01.avi,112,1162,858,304,35.43123543123543,morphological_dilation,3,2
0X7FFE99C52C424E9A.avi,105,2035,1591,444,27.906976744186046,morphological_dilation,3,2
0X7FFE99C52C424E9A.avi,126,1219,867,352,40.5997693194925,morphological_dilation,3,2
0X800ACAD85B587B0.avi,3,1360,1024,336,32.8125,morphological_dilation,3,2
0X800ACAD85B587B0.avi,28,839,571,268,46.93520140105078,morphological_dilation,3,2
0X803C3B563A14E1F.avi,225,3235,2711,524,19.32866101069716,morphological_dilation,3,2
0X803C3B563A14E1F.avi,254,1831,1407,424,30.13503909026297,morphological_dilation,3,2
0X8054AB409CF3EB.avi,133,1771,1375,396,28.799999999999997,morphological_dilation,3,2
0X8054AB409CF3EB.avi,155,964,660,304,46.06060606060606,morphological_dilation,3,2
0X808E84C059F2E12.avi,39,2300,1872,428,22.863247863247864,morphological_dilation,3,2
0X808E84C059F2E12.avi,57,1534,1166,368,31.56089193825043,morphological_dilation,3,2
0X809DF9732C992B1.avi,47,2231,1799,432,24.013340744858255,morphological_dilation,3,2
0X809DF9732C992B1.avi,63,1254,910,344,37.8021978021978,morphological_dilation,3,2
0X80BB507E25E9051.avi,40,2214,1770,444,25.08474576271186,morphological_dilation,3,2
0X80BB507E25E9051.avi,56,1341,969,372,38.39009287925697,morphological_dilation,3,2
0X810938B35377D16.avi,64,1810,1434,376,26.220362622036262,morphological_dilation,3,2
0X810938B35377D16.avi,83,1108,792,316,39.8989898989899,morphological_dilation,3,2
0X812DBE8706E91E5.avi,173,2532,2060,472,22.9126213592233,morphological_dilation,3,2
0X812DBE8706E91E5.avi,195,1410,1050,360,34.285714285714285,morphological_dilation,3,2
0X814D190DF9A8A2D.avi,79,1651,1272,379,29.79559748427673,morphological_dilation,3,2
0X814D190DF9A8A2D.avi,101,1094,766,328,42.81984334203655,morphological_dilation,3,2
0X818765E8E170C5.avi,93,1374,1050,324,30.857142857142854,morphological_dilation,3,2
0X818765E8E170C5.avi,107,964,692,272,39.30635838150289,morphological_dilation,3,2
0X81C37C9513EF69.avi,46,5045,4405,640,14.52894438138479,morphological_dilation,3,2
0X81C37C9513EF69.avi,63,3304,2764,540,19.536903039073806,morphological_dilation,3,2
0X81E84BB3D703367.avi,56,3117,2597,520,20.023103581055064,morphological_dilation,3,2
0X81E84BB3D703367.avi,82,2601,2097,504,24.034334763948497,morphological_dilation,3,2
0X8216721E18CBC00.avi,2,1774,1402,372,26.533523537803138,morphological_dilation,3,2
0X8216721E18CBC00.avi,15,1452,1112,340,30.575539568345324,morphological_dilation,3,2
0X821F08A571C0618.avi,44,1754,1346,408,30.312035661218424,morphological_dilation,3,2
0X821F08A571C0618.avi,65,967,588,379,64.45578231292517,morphological_dilation,3,2
0X823D7223765294E.avi,113,1997,1597,400,25.046963055729492,morphological_dilation,3,2
0X823D7223765294E.avi,130,1223,900,323,35.888888888888886,morphological_dilation,3,2
0X825E3913D0D68F2.avi,5,2113,1697,416,24.51384796700059,morphological_dilation,3,2
0X825E3913D0D68F2.avi,14,1300,968,332,34.29752066115703,morphological_dilation,3,2
0X827ECF66833BBA2.avi,106,2284,1812,472,26.048565121412803,morphological_dilation,3,2
0X827ECF66833BBA2.avi,121,1231,891,340,38.15937149270482,morphological_dilation,3,2
0X8288BB1A5DA12FF.avi,56,1346,1026,320,31.189083820662766,morphological_dilation,3,2
0X8288BB1A5DA12FF.avi,79,953,681,272,39.94126284875183,morphological_dilation,3,2
0X8306A6BD55A19F5.avi,59,2315,1871,444,23.730625334045964,morphological_dilation,3,2
0X8306A6BD55A19F5.avi,77,1445,1085,360,33.17972350230415,morphological_dilation,3,2
0X8325F4E34DD910D.avi,57,1868,1472,396,26.902173913043477,morphological_dilation,3,2
0X8325F4E34DD910D.avi,73,875,567,308,54.32098765432099,morphological_dilation,3,2
0X834EF864ED0A453.avi,121,2810,2314,496,21.43474503025065,morphological_dilation,3,2
0X834EF864ED0A453.avi,140,1989,1561,428,27.418321588725174,morphological_dilation,3,2
0X837EE8D6BDBD824.avi,141,1666,1278,388,30.359937402190923,morphological_dilation,3,2
0X837EE8D6BDBD824.avi,153,1067,747,320,42.8380187416332,morphological_dilation,3,2
0X838581B4AEFA558.avi,83,2923,2427,496,20.436753193242687,morphological_dilation,3,2
0X838581B4AEFA558.avi,100,1686,1278,408,31.92488262910798,morphological_dilation,3,2
0X8398A447D95E31.avi,74,2256,1828,428,23.413566739606125,morphological_dilation,3,2
0X8398A447D95E31.avi,90,1608,1236,372,30.097087378640776,morphological_dilation,3,2
0X83C6343E938255C.avi,93,1464,1116,348,31.182795698924732,morphological_dilation,3,2
0X83C6343E938255C.avi,107,883,603,280,46.434494195688224,morphological_dilation,3,2
0X83FBE3781C4F828.avi,31,1758,1386,372,26.83982683982684,morphological_dilation,3,2
0X83FBE3781C4F828.avi,47,1063,763,300,39.31847968545216,morphological_dilation,3,2
0X8429581F984C6A4.avi,41,1380,1052,328,31.1787072243346,morphological_dilation,3,2
0X8429581F984C6A4.avi,53,940,656,284,43.292682926829265,morphological_dilation,3,2
0X843AD4240FB0AD6.avi,115,2136,1721,415,24.11388727484021,morphological_dilation,3,2
0X843AD4240FB0AD6.avi,131,1406,1072,334,31.156716417910445,morphological_dilation,3,2
0X848378E4CE0BD88.avi,23,1634,1246,388,31.13964686998395,morphological_dilation,3,2
0X848378E4CE0BD88.avi,29,1058,746,312,41.8230563002681,morphological_dilation,3,2
0X84DF2CB5BBD3A91.avi,66,1552,1184,368,31.08108108108108,morphological_dilation,3,2
0X84DF2CB5BBD3A91.avi,87,894,622,272,43.729903536977496,morphological_dilation,3,2
0X8558D35ED09F890.avi,96,2402,1978,424,21.435793731041457,morphological_dilation,3,2
0X8558D35ED09F890.avi,116,1782,1414,368,26.025459688826025,morphological_dilation,3,2
0X85DEC5C015AA094.avi,77,1143,838,305,36.39618138424821,morphological_dilation,3,2
0X85DEC5C015AA094.avi,93,768,508,260,51.181102362204726,morphological_dilation,3,2
0X862D8340FB0AB5D.avi,64,1656,1312,344,26.21951219512195,morphological_dilation,3,2
0X862D8340FB0AB5D.avi,75,954,678,276,40.707964601769916,morphological_dilation,3,2
0X86643606EDB99E8.avi,155,1452,1104,348,31.521739130434785,morphological_dilation,3,2
0X86643606EDB99E8.avi,170,1047,736,311,42.255434782608695,morphological_dilation,3,2
0X868028466F66DE2.avi,4,1936,1548,388,25.064599483204137,morphological_dilation,3,2
0X868028466F66DE2.avi,18,1357,1021,336,32.90891283055827,morphological_dilation,3,2
0X86C408DFC3FF659.avi,36,1943,1530,413,26.99346405228758,morphological_dilation,3,2
0X86C408DFC3FF659.avi,49,1302,950,352,37.05263157894737,morphological_dilation,3,2
0X871CEFF60C7274C.avi,35,1971,1559,412,26.427196921103267,morphological_dilation,3,2
0X871CEFF60C7274C.avi,53,1363,1011,352,34.817012858555884,morphological_dilation,3,2
0X875E7FCD5A76D74.avi,0,2204,1776,428,24.0990990990991,morphological_dilation,3,2
0X875E7FCD5A76D74.avi,14,2023,1585,438,27.634069400630917,morphological_dilation,3,2
0X876E335B4AF534E.avi,63,1479,1127,352,31.233362910381544,morphological_dilation,3,2
0X876E335B4AF534E.avi,76,985,689,296,42.96081277213353,morphological_dilation,3,2
0X87A60AE9795E5C3.avi,63,1917,1513,404,26.70191672174488,morphological_dilation,3,2
0X87A60AE9795E5C3.avi,80,1158,838,320,38.18615751789976,morphological_dilation,3,2
0X87D7BC7C27ADD3C.avi,83,2200,1665,535,32.13213213213213,morphological_dilation,3,2
0X87D7BC7C27ADD3C.avi,98,1353,903,450,49.83388704318937,morphological_dilation,3,2
0X87EDBD72DA6B2D3.avi,41,2101,1697,404,23.806717737183263,morphological_dilation,3,2
0X87EDBD72DA6B2D3.avi,59,1658,1286,372,28.92690513219285,morphological_dilation,3,2
0X881AA416D8AB418.avi,71,1656,1304,352,26.993865030674847,morphological_dilation,3,2
0X881AA416D8AB418.avi,85,1360,1042,318,30.518234165067177,morphological_dilation,3,2
0X8877F8DEB7D6CC0.avi,92,3276,2765,511,18.48101265822785,morphological_dilation,3,2
0X8877F8DEB7D6CC0.avi,111,1498,1130,368,32.56637168141593,morphological_dilation,3,2
0X88C42FCA83FB0A7.avi,109,1720,1336,384,28.74251497005988,morphological_dilation,3,2
0X88C42FCA83FB0A7.avi,125,963,679,284,41.82621502209131,morphological_dilation,3,2
0X88CCC8BE9FDF7EA.avi,51,3861,3301,560,16.964556195092396,morphological_dilation,3,2
0X88CCC8BE9FDF7EA.avi,68,2384,1940,444,22.88659793814433,morphological_dilation,3,2
0X88D256E56DDCF23.avi,94,4139,3583,556,15.517722578844545,morphological_dilation,3,2
0X88D256E56DDCF23.avi,111,3537,3021,516,17.08043694141013,morphological_dilation,3,2
0X88D6A14569716D2.avi,70,1611,1235,376,30.44534412955466,morphological_dilation,3,2
0X88D6A14569716D2.avi,82,1063,727,336,46.217331499312245,morphological_dilation,3,2
0X88E1A4DDF09741A.avi,45,1890,1499,391,26.084056037358238,morphological_dilation,3,2
0X88E1A4DDF09741A.avi,63,1487,1141,346,30.32427695004382,morphological_dilation,3,2
0X88E54370A17E06F.avi,125,2158,1710,448,26.198830409356727,morphological_dilation,3,2
0X88E54370A17E06F.avi,136,1570,1178,392,33.276740237691,morphological_dilation,3,2
0X88F47DF3EAB4624.avi,37,2717,2245,472,21.024498886414253,morphological_dilation,3,2
0X88F47DF3EAB4624.avi,55,1775,1363,412,30.227439471753488,morphological_dilation,3,2
0X890D3BA23D088E7.avi,47,1321,993,328,33.03121852970796,morphological_dilation,3,2
0X890D3BA23D088E7.avi,62,812,540,272,50.37037037037037,morphological_dilation,3,2
0X8956CF90AA24E85.avi,35,2133,1701,432,25.396825396825395,morphological_dilation,3,2
0X8956CF90AA24E85.avi,48,1250,910,340,37.362637362637365,morphological_dilation,3,2
0X897DC95F2BA7FDD.avi,56,1652,1281,371,28.96174863387978,morphological_dilation,3,2
0X897DC95F2BA7FDD.avi,78,997,701,296,42.22539229671897,morphological_dilation,3,2
0X89931CCA2CA8FEB.avi,56,1557,1205,352,29.211618257261414,morphological_dilation,3,2
0X89931CCA2CA8FEB.avi,69,1307,975,332,34.05128205128205,morphological_dilation,3,2
0X899CFAA2241B41A.avi,69,1691,1327,364,27.43029389600603,morphological_dilation,3,2
0X899CFAA2241B41A.avi,84,1144,836,308,36.84210526315789,morphological_dilation,3,2
0X89C66B02F23463.avi,112,1395,1047,348,33.2378223495702,morphological_dilation,3,2
0X89C66B02F23463.avi,126,725,449,276,61.46993318485523,morphological_dilation,3,2
0X89F6E4E6E71311E.avi,77,1455,1107,348,31.43631436314363,morphological_dilation,3,2
0X89F6E4E6E71311E.avi,102,962,670,292,43.582089552238806,morphological_dilation,3,2
0X8A00B604D26DE91.avi,41,1288,960,328,34.166666666666664,morphological_dilation,3,2
0X8A00B604D26DE91.avi,52,785,513,272,53.021442495126706,morphological_dilation,3,2
0X8A02C375D49B3A0.avi,57,1473,1141,332,29.09728308501315,morphological_dilation,3,2
0X8A02C375D49B3A0.avi,71,994,706,288,40.79320113314447,morphological_dilation,3,2
0X8A609D00A0FAB1E.avi,86,1989,1569,420,26.76864244741874,morphological_dilation,3,2
0X8A609D00A0FAB1E.avi,97,1311,967,344,35.57394002068252,morphological_dilation,3,2
0X8AD33565052D9C0.avi,38,1711,1335,376,28.164794007490634,morphological_dilation,3,2
0X8AD33565052D9C0.avi,56,1113,801,312,38.951310861423224,morphological_dilation,3,2
0X8ADB8A9EE8822FD.avi,120,2045,1618,427,26.39060568603214,morphological_dilation,3,2
0X8ADB8A9EE8822FD.avi,142,1246,905,341,37.67955801104972,morphological_dilation,3,2
0X8AE11CBC0A5D3E0.avi,37,1759,1356,403,29.71976401179941,morphological_dilation,3,2
0X8AE11CBC0A5D3E0.avi,52,1047,719,328,45.618915159944365,morphological_dilation,3,2
0X8AE76DB8D580220.avi,55,2106,1698,408,24.02826855123675,morphological_dilation,3,2
0X8AE76DB8D580220.avi,74,1369,1025,344,33.5609756097561,morphological_dilation,3,2
0X8B81181EDD9DDFE.avi,105,1187,867,320,36.90888119953864,morphological_dilation,3,2
0X8B81181EDD9DDFE.avi,129,713,445,268,60.22471910112359,morphological_dilation,3,2
0X8C4EE7B7BDD0AE9.avi,45,1225,877,348,39.68072976054732,morphological_dilation,3,2
0X8C4EE7B7BDD0AE9.avi,73,787,515,272,52.81553398058253,morphological_dilation,3,2
0X8C79A779F8014F8.avi,48,1716,1352,364,26.923076923076923,morphological_dilation,3,2
0X8C79A779F8014F8.avi,65,1055,755,300,39.735099337748345,morphological_dilation,3,2
0X8CC92C116365C7B.avi,112,1849,1461,388,26.55715263518138,morphological_dilation,3,2
0X8CC92C116365C7B.avi,126,1505,1149,356,30.983463881636204,morphological_dilation,3,2
0X8D4753B7DADB6A6.avi,26,1415,1063,352,33.11382878645344,morphological_dilation,3,2
0X8D4753B7DADB6A6.avi,38,942,646,296,45.82043343653251,morphological_dilation,3,2
0X8D6808AE8CCE022.avi,95,2643,2175,468,21.517241379310345,morphological_dilation,3,2
0X8D6808AE8CCE022.avi,112,1518,1150,368,32.0,morphological_dilation,3,2
0X8D771490D0E2E2E.avi,90,1256,924,332,35.93073593073593,morphological_dilation,3,2
0X8D771490D0E2E2E.avi,102,805,529,276,52.17391304347826,morphological_dilation,3,2
0X8D9EBA5A4173367.avi,56,1994,1574,420,26.683608640406607,morphological_dilation,3,2
0X8D9EBA5A4173367.avi,74,1497,1121,376,33.54148082069581,morphological_dilation,3,2
0X8DB48002F8F408D.avi,53,1954,1547,407,26.308985132514547,morphological_dilation,3,2
0X8DB48002F8F408D.avi,70,1355,1021,334,32.7130264446621,morphological_dilation,3,2
0X8DD547AAAF4577C.avi,91,1778,1375,403,29.309090909090905,morphological_dilation,3,2
0X8DD547AAAF4577C.avi,106,1091,758,333,43.931398416886545,morphological_dilation,3,2
0X8DDBA56BBEDA587.avi,0,1924,1528,396,25.916230366492147,morphological_dilation,3,2
0X8DDBA56BBEDA587.avi,17,1153,834,319,38.249400479616305,morphological_dilation,3,2
0X8E0549DB1C1180F.avi,48,1241,897,344,38.35005574136009,morphological_dilation,3,2
0X8E0549DB1C1180F.avi,65,794,522,272,52.10727969348659,morphological_dilation,3,2
0X8E0D26B4A4C7F9C.avi,43,1346,998,348,34.86973947895792,morphological_dilation,3,2
0X8E0D26B4A4C7F9C.avi,68,730,462,268,58.00865800865801,morphological_dilation,3,2
0X8E2FCF5187C4872.avi,127,1782,1418,364,25.66995768688293,morphological_dilation,3,2
0X8E2FCF5187C4872.avi,144,1130,822,308,37.469586374695865,morphological_dilation,3,2
0X8E4C0881B1F460D.avi,64,1681,1305,376,28.812260536398465,morphological_dilation,3,2
0X8E4C0881B1F460D.avi,78,1075,763,312,40.89121887287025,morphological_dilation,3,2
0X8E7B765866B0CA7.avi,105,2428,1972,456,23.123732251521297,morphological_dilation,3,2
0X8E7B765866B0CA7.avi,125,1862,1470,392,26.666666666666668,morphological_dilation,3,2
0X8F03E72D159789D.avi,105,1950,1546,404,26.13195342820181,morphological_dilation,3,2
0X8F03E72D159789D.avi,131,1239,899,340,37.81979977753059,morphological_dilation,3,2
0X8F5D6CCBFC12DDD.avi,86,2648,2176,472,21.691176470588236,morphological_dilation,3,2
0X8F5D6CCBFC12DDD.avi,105,1743,1347,396,29.398663697104677,morphological_dilation,3,2
0X8F75381F3CD39C3.avi,44,1268,960,308,32.083333333333336,morphological_dilation,3,2
0X8F75381F3CD39C3.avi,57,1047,759,288,37.94466403162055,morphological_dilation,3,2
0X9044899961C94FF.avi,63,1296,968,328,33.88429752066116,morphological_dilation,3,2
0X9044899961C94FF.avi,78,968,676,292,43.19526627218935,morphological_dilation,3,2
0X90500B5A7C0E6C0.avi,0,2243,1827,416,22.769567597153802,morphological_dilation,3,2
0X90500B5A7C0E6C0.avi,17,1370,1046,324,30.975143403441685,morphological_dilation,3,2
0X9061772F56FB80F.avi,85,1695,1307,388,29.686304514154553,morphological_dilation,3,2
0X9061772F56FB80F.avi,103,1255,915,340,37.15846994535519,morphological_dilation,3,2
0X90825C9FEC5E29B.avi,5,3643,3087,556,18.011013929381274,morphological_dilation,3,2
0X90825C9FEC5E29B.avi,17,2851,2340,511,21.837606837606838,morphological_dilation,3,2
0X90843A89F2D62D9.avi,69,1446,1086,360,33.14917127071823,morphological_dilation,3,2
0X90843A89F2D62D9.avi,88,981,689,292,42.380261248185775,morphological_dilation,3,2
0X90BE54996D1FE56.avi,119,1576,1220,356,29.18032786885246,morphological_dilation,3,2
0X90BE54996D1FE56.avi,140,891,603,288,47.76119402985074,morphological_dilation,3,2
0X914E962BA46BCAE.avi,151,1596,1216,380,31.25,morphological_dilation,3,2
0X914E962BA46BCAE.avi,167,1072,752,320,42.5531914893617,morphological_dilation,3,2
0X9190B2AF79FD1EF.avi,47,2046,1646,400,24.30133657351154,morphological_dilation,3,2
0X9190B2AF79FD1EF.avi,63,1334,983,351,35.70701932858596,morphological_dilation,3,2
0X91EEBF4F6984C3C.avi,100,2242,1810,432,23.867403314917127,morphological_dilation,3,2
0X91EEBF4F6984C3C.avi,118,1599,1235,364,29.47368421052631,morphological_dilation,3,2
0X920784B3F888823.avi,88,1225,893,332,37.17805151175812,morphological_dilation,3,2
0X920784B3F888823.avi,97,542,322,220,68.32298136645963,morphological_dilation,3,2
0X921B9F8EC62DE20.avi,114,2474,2014,460,22.840119165839127,morphological_dilation,3,2
0X921B9F8EC62DE20.avi,133,1502,1102,400,36.29764065335753,morphological_dilation,3,2
0X922773E4DBD8FDA.avi,76,1286,948,338,35.654008438818565,morphological_dilation,3,2
0X922773E4DBD8FDA.avi,88,725,461,264,57.26681127982647,morphological_dilation,3,2
0X92A69D3CBDD8890.avi,77,1866,1482,384,25.910931174089068,morphological_dilation,3,2
0X92A69D3CBDD8890.avi,93,1655,1295,360,27.7992277992278,morphological_dilation,3,2
0X92E7F82947B0C28.avi,1,991,699,292,41.77396280400572,morphological_dilation,3,2
0X92E7F82947B0C28.avi,13,629,385,244,63.37662337662338,morphological_dilation,3,2
0X932199C4C55B362.avi,72,1749,1315,434,33.00380228136882,morphological_dilation,3,2
0X932199C4C55B362.avi,86,1093,705,388,55.0354609929078,morphological_dilation,3,2
0X936B9FCB68B8F2A.avi,67,2621,2137,484,22.648572765559194,morphological_dilation,3,2
0X936B9FCB68B8F2A.avi,85,1732,1323,409,30.9145880574452,morphological_dilation,3,2
0X93720259E693454.avi,114,2699,2223,476,21.412505623031937,morphological_dilation,3,2
0X93720259E693454.avi,134,1686,1298,388,29.892141756548536,morphological_dilation,3,2
0X93769D5AAF18824.avi,0,1840,1450,390,26.89655172413793,morphological_dilation,3,2
0X93769D5AAF18824.avi,15,1132,804,328,40.79601990049751,morphological_dilation,3,2
0X938895A99199D5E.avi,64,3280,2744,536,19.533527696793,morphological_dilation,3,2
0X938895A99199D5E.avi,92,2489,2029,460,22.671266633809758,morphological_dilation,3,2
0X93C06F6952E14DA.avi,94,1719,1343,376,27.997021593447506,morphological_dilation,3,2
0X93C06F6952E14DA.avi,114,1127,803,324,40.34869240348692,morphological_dilation,3,2
0X93ECC18675FEC51.avi,45,1496,1107,389,35.14001806684733,morphological_dilation,3,2
0X93ECC18675FEC51.avi,64,962,626,336,53.674121405750796,morphological_dilation,3,2
0X93ED1CF2689DBEE.avi,68,2941,2445,496,20.286298568507156,morphological_dilation,3,2
0X93ED1CF2689DBEE.avi,83,1642,1246,396,31.781701444622794,morphological_dilation,3,2
0X93F22EE30533FAD.avi,65,1537,1181,356,30.143945808636747,morphological_dilation,3,2
0X93F22EE30533FAD.avi,82,1376,1036,340,32.818532818532816,morphological_dilation,3,2
0X9408F4FC14DA75D.avi,122,1287,959,328,34.20229405630866,morphological_dilation,3,2
0X9408F4FC14DA75D.avi,132,794,527,267,50.664136622390885,morphological_dilation,3,2
0X9419D068656DB99.avi,84,1749,1389,360,25.917926565874733,morphological_dilation,3,2
0X9419D068656DB99.avi,98,1118,814,304,37.34643734643734,morphological_dilation,3,2
0X94423ABE1D87A82.avi,67,2624,2132,492,23.076923076923077,morphological_dilation,3,2
0X94423ABE1D87A82.avi,79,1458,1090,368,33.76146788990826,morphological_dilation,3,2
0X9581FCED8A0EB28.avi,0,1761,1397,364,26.055833929849676,morphological_dilation,3,2
0X9581FCED8A0EB28.avi,15,1344,1016,328,32.28346456692913,morphological_dilation,3,2
0X966B4698CBD18F6.avi,98,4002,3423,579,16.91498685363716,morphological_dilation,3,2
0X966B4698CBD18F6.avi,121,3487,2963,524,17.684778940263246,morphological_dilation,3,2
0X96ACFF7BE3F559D.avi,91,3189,2657,532,20.022581859239743,morphological_dilation,3,2
0X96ACFF7BE3F559D.avi,108,1852,1424,428,30.0561797752809,morphological_dilation,3,2
0X96CE61C92FAEE43.avi,42,1281,945,336,35.55555555555556,morphological_dilation,3,2
0X96CE61C92FAEE43.avi,57,927,642,285,44.39252336448598,morphological_dilation,3,2
0X97101B235AE00C6.avi,50,1360,1040,320,30.76923076923077,morphological_dilation,3,2
0X97101B235AE00C6.avi,61,829,561,268,47.771836007130126,morphological_dilation,3,2
0X972FF6E2B9B9B1B.avi,150,1512,1168,344,29.45205479452055,morphological_dilation,3,2
0X972FF6E2B9B9B1B.avi,168,985,709,276,38.928067700987306,morphological_dilation,3,2
0X973E4A9DAADDF9F.avi,40,2019,1376,643,46.729651162790695,morphological_dilation,3,2
0X973E4A9DAADDF9F.avi,49,2380,1727,653,37.81123335263462,morphological_dilation,3,2
0X973FF05037F911F.avi,59,1822,1446,376,26.00276625172891,morphological_dilation,3,2
0X973FF05037F911F.avi,80,1028,748,280,37.4331550802139,morphological_dilation,3,2
0X9756BC052F770E5.avi,49,2089,1677,412,24.56768038163387,morphological_dilation,3,2
0X9756BC052F770E5.avi,69,1669,1313,356,27.113480578827115,morphological_dilation,3,2
0X9776C2BDF17D2F.avi,53,2343,1899,444,23.380726698262244,morphological_dilation,3,2
0X9776C2BDF17D2F.avi,71,1484,1100,384,34.909090909090914,morphological_dilation,3,2
0X977FA9B62EA3FD1.avi,81,1147,835,312,37.365269461077844,morphological_dilation,3,2
0X977FA9B62EA3FD1.avi,95,818,540,278,51.48148148148148,morphological_dilation,3,2
0X9790A6812535DA6.avi,36,2118,1722,396,22.99651567944251,morphological_dilation,3,2
0X9790A6812535DA6.avi,52,1730,1374,356,25.90975254730713,morphological_dilation,3,2
0X98217365CE7C868.avi,43,1162,822,340,41.3625304136253,morphological_dilation,3,2
0X98217365CE7C868.avi,53,813,505,308,60.99009900990099,morphological_dilation,3,2
0X983B0EA3147F367.avi,22,1785,1409,376,26.68559261887864,morphological_dilation,3,2
0X983B0EA3147F367.avi,34,966,690,276,40.0,morphological_dilation,3,2
0X989B4D72DC92247.avi,39,1190,894,296,33.1096196868009,morphological_dilation,3,2
0X989B4D72DC92247.avi,47,822,570,252,44.21052631578947,morphological_dilation,3,2
0X98A5CDCC73DC4E9.avi,47,1685,1309,376,28.72421695951108,morphological_dilation,3,2
0X98A5CDCC73DC4E9.avi,67,1250,923,327,35.42795232936078,morphological_dilation,3,2
0X98AE6BD83F02077.avi,68,1874,1482,392,26.450742240215924,morphological_dilation,3,2
0X98AE6BD83F02077.avi,78,1512,1168,344,29.45205479452055,morphological_dilation,3,2
0X98B0C025EC61940.avi,46,3021,2505,516,20.59880239520958,morphological_dilation,3,2
0X98B0C025EC61940.avi,63,1974,1526,448,29.357798165137616,morphological_dilation,3,2
0X98E1CCF5F6CADF5.avi,100,1903,1471,432,29.367777022433717,morphological_dilation,3,2
0X98E1CCF5F6CADF5.avi,118,1227,860,367,42.674418604651166,morphological_dilation,3,2
0X9910641C4636621.avi,41,1682,1334,348,26.08695652173913,morphological_dilation,3,2
0X9910641C4636621.avi,57,1002,723,279,38.589211618257266,morphological_dilation,3,2
0X992CE8E901B6D5D.avi,98,1678,1322,356,26.928895612708022,morphological_dilation,3,2
0X992CE8E901B6D5D.avi,119,1043,759,284,37.417654808959156,morphological_dilation,3,2
0X9949F48CD62C825.avi,70,1585,1197,388,32.414369256474515,morphological_dilation,3,2
0X9949F48CD62C825.avi,83,978,654,324,49.54128440366973,morphological_dilation,3,2
0X996144BA5B06549.avi,2,1566,1210,356,29.421487603305785,morphological_dilation,3,2
0X996144BA5B06549.avi,16,987,699,288,41.201716738197426,morphological_dilation,3,2
0X99779FE7AB6FCB0.avi,53,2269,1817,452,24.87616951018162,morphological_dilation,3,2
0X99779FE7AB6FCB0.avi,66,1407,1032,375,36.337209302325576,morphological_dilation,3,2
0X9986074CBE59786.avi,45,2087,1684,403,23.93111638954869,morphological_dilation,3,2
0X9986074CBE59786.avi,59,1444,1080,364,33.7037037037037,morphological_dilation,3,2
0X999693BACC06F2A.avi,35,2006,1598,408,25.53191489361702,morphological_dilation,3,2
0X999693BACC06F2A.avi,53,1205,889,316,35.54555680539933,morphological_dilation,3,2
0X99E2DE4B1C00277.avi,74,2467,2003,464,23.16525212181727,morphological_dilation,3,2
0X99E2DE4B1C00277.avi,90,1438,1063,375,35.27751646284102,morphological_dilation,3,2
0X9A03DC1334986F3.avi,32,3741,3201,540,16.869728209934394,morphological_dilation,3,2
0X9A03DC1334986F3.avi,44,3452,2928,524,17.89617486338798,morphological_dilation,3,2
0X9A5A7DB7451F0C8.avi,78,2223,1795,428,23.84401114206128,morphological_dilation,3,2
0X9A5A7DB7451F0C8.avi,100,1421,1067,354,33.177132146204315,morphological_dilation,3,2
0X9A5EF4B2212EA30.avi,44,1469,1129,340,30.115146147032775,morphological_dilation,3,2
0X9A5EF4B2212EA30.avi,57,946,662,284,42.90030211480362,morphological_dilation,3,2
0X9A79C9B36D1055C.avi,44,1504,1164,340,29.20962199312715,morphological_dilation,3,2
0X9A79C9B36D1055C.avi,55,1103,795,308,38.742138364779876,morphological_dilation,3,2
0X9A907E25D74AE97.avi,70,1487,1167,320,27.420736932305058,morphological_dilation,3,2
0X9A907E25D74AE97.avi,89,950,682,268,39.29618768328446,morphological_dilation,3,2
0X9AA7B6854969266.avi,45,1677,1297,380,29.298380878951424,morphological_dilation,3,2
0X9AA7B6854969266.avi,63,1085,765,320,41.830065359477125,morphological_dilation,3,2
0X9ABE9D61E4472A8.avi,41,1299,963,336,34.890965732087224,morphological_dilation,3,2
0X9ABE9D61E4472A8.avi,56,858,570,288,50.526315789473685,morphological_dilation,3,2
0X9B0C20331B5EB7F.avi,81,1957,1549,408,26.3395739186572,morphological_dilation,3,2
0X9B0C20331B5EB7F.avi,99,1195,879,316,35.94994311717861,morphological_dilation,3,2
0X9B148571A758952.avi,49,1610,1254,356,28.38915470494418,morphological_dilation,3,2
0X9B148571A758952.avi,73,970,669,301,44.992526158445436,morphological_dilation,3,2
0X9B2BE4C440C107D.avi,41,1610,1250,360,28.799999999999997,morphological_dilation,3,2
0X9B2BE4C440C107D.avi,54,1038,730,308,42.19178082191781,morphological_dilation,3,2
0X9B4420F570F7BA.avi,97,2205,1741,464,26.651349798966113,morphological_dilation,3,2
0X9B4420F570F7BA.avi,111,1619,1199,420,35.029190992493746,morphological_dilation,3,2
0X9B80B7519CEBB0.avi,50,1293,945,348,36.82539682539683,morphological_dilation,3,2
0X9B80B7519CEBB0.avi,73,795,507,288,56.80473372781065,morphological_dilation,3,2
0X9BC2066CD0D816F.avi,102,3293,2785,508,18.240574506283664,morphological_dilation,3,2
0X9BC2066CD0D816F.avi,124,2741,2265,476,21.015452538631347,morphological_dilation,3,2
0X9BC46CA635485B6.avi,129,2165,1761,404,22.941510505394664,morphological_dilation,3,2
0X9BC46CA635485B6.avi,144,1845,1465,380,25.938566552901023,morphological_dilation,3,2
0X9BCA80E40CC5AFF.avi,81,3060,2572,488,18.973561430793158,morphological_dilation,3,2
0X9BCA80E40CC5AFF.avi,95,1862,1454,408,28.060522696011002,morphological_dilation,3,2
0X9BCAF5D4D05D27F.avi,37,2807,2279,528,23.168056164984645,morphological_dilation,3,2
0X9BCAF5D4D05D27F.avi,52,1684,1237,447,36.135812449474535,morphological_dilation,3,2
0X9C07F125C8FC4C1.avi,44,1324,1012,312,30.8300395256917,morphological_dilation,3,2
0X9C07F125C8FC4C1.avi,57,871,619,252,40.7108239095315,morphological_dilation,3,2
0X9C5CFD92158CC11.avi,72,2427,1967,460,23.38586680223691,morphological_dilation,3,2
0X9C5CFD92158CC11.avi,93,2009,1593,416,26.1142498430634,morphological_dilation,3,2
0X9C73FFFD19447AB.avi,57,1530,1174,356,30.3236797274276,morphological_dilation,3,2
0X9C73FFFD19447AB.avi,77,1122,818,304,37.163814180929094,morphological_dilation,3,2
0X9C7E9770B314AE5.avi,42,1533,1161,372,32.041343669250644,morphological_dilation,3,2
0X9C7E9770B314AE5.avi,54,1017,689,328,47.60522496371553,morphological_dilation,3,2
0X9CCD9D64D3CA005.avi,48,2201,1761,440,24.98580352072686,morphological_dilation,3,2
0X9CCD9D64D3CA005.avi,66,1239,891,348,39.05723905723906,morphological_dilation,3,2
0X9D0FC1FDA17491D.avi,64,1913,1501,412,27.448367754830112,morphological_dilation,3,2
0X9D0FC1FDA17491D.avi,85,1320,968,352,36.36363636363637,morphological_dilation,3,2
0X9D40B3B9C178B26.avi,34,1491,1143,348,30.446194225721783,morphological_dilation,3,2
0X9D40B3B9C178B26.avi,47,1062,758,304,40.105540897097626,morphological_dilation,3,2
0X9DB79DF0A269227.avi,127,1705,1301,404,31.053036126056877,morphological_dilation,3,2
0X9DB79DF0A269227.avi,141,1028,728,300,41.208791208791204,morphological_dilation,3,2
0X9DBF850852BB18F.avi,51,2441,1937,504,26.019617965926688,morphological_dilation,3,2
0X9DBF850852BB18F.avi,71,1447,1040,407,39.13461538461539,morphological_dilation,3,2
0X9DE98A203BEC5F2.avi,4,1525,1181,344,29.127857747671467,morphological_dilation,3,2
0X9DE98A203BEC5F2.avi,22,992,684,308,45.02923976608187,morphological_dilation,3,2
0X9E181B942CACADF.avi,0,1684,1320,364,27.575757575757574,morphological_dilation,3,2
0X9E181B942CACADF.avi,18,1007,707,300,42.432814710042436,morphological_dilation,3,2
0X9E37320F33E7ED.avi,187,1665,1291,374,28.969790859798607,morphological_dilation,3,2
0X9E37320F33E7ED.avi,212,1150,830,320,38.55421686746988,morphological_dilation,3,2
0X9E3B3B6B928DA58.avi,262,3154,2620,534,20.381679389312975,morphological_dilation,3,2
0X9E3B3B6B928DA58.avi,291,1975,1543,432,27.997407647440053,morphological_dilation,3,2
0X9E3D09429F6B852.avi,128,2242,1774,468,26.38105975197294,morphological_dilation,3,2
0X9E3D09429F6B852.avi,142,1566,1174,392,33.39011925042589,morphological_dilation,3,2
0X9E6E997496C87CC.avi,44,1589,1241,348,28.041901692183725,morphological_dilation,3,2
0X9E6E997496C87CC.avi,59,1389,1069,320,29.934518241347053,morphological_dilation,3,2
0X9E72E2C8A9536F6.avi,2,1490,1158,332,28.670120898100173,morphological_dilation,3,2
0X9E72E2C8A9536F6.avi,12,942,670,272,40.59701492537313,morphological_dilation,3,2
0X9F2D61012CC7FCA.avi,41,945,653,292,44.716692189892804,morphological_dilation,3,2
0X9F2D61012CC7FCA.avi,59,616,380,236,62.10526315789474,morphological_dilation,3,2
0X9F2E7A05C3B994C.avi,122,2201,1781,420,23.582257158899495,morphological_dilation,3,2
0X9F2E7A05C3B994C.avi,140,1507,1135,372,32.77533039647577,morphological_dilation,3,2
0X9F47D732822A695.avi,47,2042,1623,419,25.816389402341343,morphological_dilation,3,2
0X9F47D732822A695.avi,69,1234,897,337,37.56967670011148,morphological_dilation,3,2
0X9FB2E15488737AA.avi,157,2027,1635,392,23.97553516819572,morphological_dilation,3,2
0X9FB2E15488737AA.avi,173,1317,993,324,32.62839879154079,morphological_dilation,3,2
0X9FBEB56D70FA0B7.avi,65,1811,1423,388,27.266338721011945,morphological_dilation,3,2
0X9FBEB56D70FA0B7.avi,80,1146,822,324,39.416058394160586,morphological_dilation,3,2
0XA05202904A89EAD.avi,0,1486,1142,344,30.122591943957964,morphological_dilation,3,2
0XA05202904A89EAD.avi,21,1138,836,302,36.124401913875595,morphological_dilation,3,2
0XA0FF3E0630F3902.avi,33,1955,1539,416,27.030539311241064,morphological_dilation,3,2
0XA0FF3E0630F3902.avi,43,1624,1252,372,29.712460063897762,morphological_dilation,3,2
0XA14DEADA0918C0C.avi,0,2464,1992,472,23.694779116465863,morphological_dilation,3,2
0XA14DEADA0918C0C.avi,21,1630,1226,404,32.95269168026101,morphological_dilation,3,2
0XA1EC54A2895788E.avi,82,1754,1374,380,27.65647743813683,morphological_dilation,3,2
0XA1EC54A2895788E.avi,95,1182,850,332,39.05882352941176,morphological_dilation,3,2
0XA2092DD4255657B.avi,105,1919,1519,400,26.33311389071758,morphological_dilation,3,2
0XA2092DD4255657B.avi,121,1056,742,314,42.318059299191376,morphological_dilation,3,2
0XA20E92517726A99.avi,55,1771,1379,392,28.426395939086298,morphological_dilation,3,2
0XA20E92517726A99.avi,72,1036,728,308,42.30769230769231,morphological_dilation,3,2
0XA20EE6C5B1F48CB.avi,95,4117,3183,934,29.343386742067235,morphological_dilation,3,2
0XA20EE6C5B1F48CB.avi,116,3967,2976,991,33.299731182795696,morphological_dilation,3,2
0XA238B0B664FDCFE.avi,51,1449,1099,350,31.84713375796178,morphological_dilation,3,2
0XA238B0B664FDCFE.avi,69,938,646,292,45.20123839009288,morphological_dilation,3,2
0XA23DF6B3D64C5A1.avi,88,2694,2234,460,20.590868397493285,morphological_dilation,3,2
0XA23DF6B3D64C5A1.avi,106,1713,1317,396,30.068337129840543,morphological_dilation,3,2
0XA27FDD7A35C6779.avi,116,1688,1316,372,28.267477203647417,morphological_dilation,3,2
0XA27FDD7A35C6779.avi,134,986,694,292,42.07492795389049,morphological_dilation,3,2
0XA28369AAB872CF2.avi,39,1034,718,316,44.01114206128134,morphological_dilation,3,2
0XA28369AAB872CF2.avi,50,678,430,248,57.674418604651166,morphological_dilation,3,2
0XA29BAB8A42F22B5.avi,55,751,503,248,49.30417495029821,morphological_dilation,3,2
0XA29BAB8A42F22B5.avi,77,1111,815,296,36.31901840490798,morphological_dilation,3,2
0XA2CE53842FD45BE.avi,68,1676,1238,438,35.37964458804523,morphological_dilation,3,2
0XA2CE53842FD45BE.avi,81,1006,687,319,46.43377001455604,morphological_dilation,3,2
0XA31E5D703BAE77A.avi,81,1560,1192,368,30.87248322147651,morphological_dilation,3,2
0XA31E5D703BAE77A.avi,95,1160,838,322,38.424821002386636,morphological_dilation,3,2
0XA3372C20EFD8726.avi,188,1783,1403,380,27.084818246614397,morphological_dilation,3,2
0XA3372C20EFD8726.avi,207,1194,862,332,38.51508120649652,morphological_dilation,3,2
0XA3617C5EFEDD2E5.avi,103,2081,1666,415,24.90996398559424,morphological_dilation,3,2
0XA3617C5EFEDD2E5.avi,121,1315,971,344,35.42739443872296,morphological_dilation,3,2
0XA3D91865EC953D9.avi,88,2131,1711,420,24.54704850964348,morphological_dilation,3,2
0XA3D91865EC953D9.avi,103,1190,855,335,39.1812865497076,morphological_dilation,3,2
0XA3DC9C69839F5FA.avi,53,1950,1554,396,25.482625482625483,morphological_dilation,3,2
0XA3DC9C69839F5FA.avi,71,1190,870,320,36.7816091954023,morphological_dilation,3,2
0XA40AEF2A1787260.avi,44,1479,1127,352,31.233362910381544,morphological_dilation,3,2
0XA40AEF2A1787260.avi,63,928,659,269,40.819423368740516,morphological_dilation,3,2
0XA42F2AFCCCD336D.avi,64,3723,3175,548,17.25984251968504,morphological_dilation,3,2
0XA42F2AFCCCD336D.avi,79,2581,2089,492,23.551938726663476,morphological_dilation,3,2
0XA43117B34833F33.avi,48,1485,1149,336,29.242819843342037,morphological_dilation,3,2
0XA43117B34833F33.avi,66,954,674,280,41.54302670623146,morphological_dilation,3,2
0XA45E4E31AD288AB.avi,36,1516,1135,381,33.56828193832599,morphological_dilation,3,2
0XA45E4E31AD288AB.avi,50,911,585,326,55.72649572649573,morphological_dilation,3,2
0XA490B5C1BABF770.avi,43,1766,1378,388,28.156748911465897,morphological_dilation,3,2
0XA490B5C1BABF770.avi,61,1419,1067,352,32.98969072164948,morphological_dilation,3,2
0XA5323DD59E0A869.avi,112,1529,1177,352,29.906542056074763,morphological_dilation,3,2
0XA5323DD59E0A869.avi,132,1035,727,308,42.36588720770289,morphological_dilation,3,2
0XA5BE050BEE27DE1.avi,67,1423,1074,349,32.49534450651769,morphological_dilation,3,2
0XA5BE050BEE27DE1.avi,83,979,675,304,45.03703703703704,morphological_dilation,3,2
0XA5C31C5A0108C30.avi,44,1288,952,336,35.294117647058826,morphological_dilation,3,2
0XA5C31C5A0108C30.avi,59,828,556,272,48.92086330935252,morphological_dilation,3,2
0XA6098BB06A8586A.avi,97,2110,1678,432,25.744934445768774,morphological_dilation,3,2
0XA6098BB06A8586A.avi,113,1211,873,338,38.71706758304697,morphological_dilation,3,2
0XA61A892741BB67A.avi,56,1577,1205,372,30.87136929460581,morphological_dilation,3,2
0XA61A892741BB67A.avi,66,1071,751,320,42.60985352862849,morphological_dilation,3,2
0XA64090D4741F0BD.avi,46,1549,1201,348,28.975853455453787,morphological_dilation,3,2
0XA64090D4741F0BD.avi,62,996,700,296,42.285714285714285,morphological_dilation,3,2
0XA684E725FD761B6.avi,144,1786,1406,380,27.027027027027028,morphological_dilation,3,2
0XA684E725FD761B6.avi,171,1123,819,304,37.11843711843712,morphological_dilation,3,2
0XA69CDEAD15F2E1A.avi,95,2761,2285,476,20.831509846827135,morphological_dilation,3,2
0XA69CDEAD15F2E1A.avi,111,1581,1209,372,30.76923076923077,morphological_dilation,3,2
0XA6A8F7E7AA0F98E.avi,75,1620,1240,380,30.64516129032258,morphological_dilation,3,2
0XA6A8F7E7AA0F98E.avi,90,1076,756,320,42.32804232804233,morphological_dilation,3,2
0XA6BD3BA9AAB064D.avi,36,1074,790,284,35.949367088607595,morphological_dilation,3,2
0XA6BD3BA9AAB064D.avi,51,644,412,232,56.310679611650485,morphological_dilation,3,2
0XA6D71323002CF21.avi,42,1662,1294,368,28.438948995363216,morphological_dilation,3,2
0XA6D71323002CF21.avi,61,1225,909,316,34.763476347634764,morphological_dilation,3,2
0XA6D84E19F2DA13D.avi,36,2371,1923,448,23.29693187727509,morphological_dilation,3,2
0XA6D84E19F2DA13D.avi,52,1417,1061,356,33.55325164938737,morphological_dilation,3,2
0XA6E09CACE38DD02.avi,48,1506,1154,352,30.502599653379548,morphological_dilation,3,2
0XA6E09CACE38DD02.avi,64,1118,800,318,39.75,morphological_dilation,3,2
0XA72DE0C1F32EA64.avi,8,1897,1517,380,25.049439683586026,morphological_dilation,3,2
0XA72DE0C1F32EA64.avi,22,1565,1217,348,28.594905505341,morphological_dilation,3,2
0XA72F656E23C7F53.avi,3,1583,1231,352,28.594638505280262,morphological_dilation,3,2
0XA72F656E23C7F53.avi,17,979,699,280,40.05722460658083,morphological_dilation,3,2
0XA789C0D93B1DF7A.avi,49,1433,1089,344,31.588613406795226,morphological_dilation,3,2
0XA789C0D93B1DF7A.avi,63,844,564,280,49.645390070921984,morphological_dilation,3,2
0XA7F4EE9647DF974.avi,5,2075,1624,451,27.77093596059113,morphological_dilation,3,2
0XA7F4EE9647DF974.avi,26,1315,950,365,38.421052631578945,morphological_dilation,3,2
0XA8324479A861D01.avi,118,2632,2172,460,21.178637200736645,morphological_dilation,3,2
0XA8324479A861D01.avi,131,1708,1340,368,27.46268656716418,morphological_dilation,3,2
0XA837A17982E7335.avi,84,1619,1263,356,28.18685669041964,morphological_dilation,3,2
0XA837A17982E7335.avi,101,1051,763,288,37.745740498034074,morphological_dilation,3,2
0XA84957F45657A67.avi,84,2569,2056,513,24.95136186770428,morphological_dilation,3,2
0XA84957F45657A67.avi,97,1446,989,457,46.20829120323559,morphological_dilation,3,2
0XA86485C87693449.avi,31,1435,1091,344,31.53070577451879,morphological_dilation,3,2
0XA86485C87693449.avi,44,1247,911,336,36.88254665203073,morphological_dilation,3,2
0XA8C2902A686BF34.avi,48,1715,1339,376,28.0806572068708,morphological_dilation,3,2
0XA8C2902A686BF34.avi,67,1188,860,328,38.139534883720934,morphological_dilation,3,2
0XA8EB154B86EAEE7.avi,60,1384,1048,336,32.06106870229007,morphological_dilation,3,2
0XA8EB154B86EAEE7.avi,73,1174,870,304,34.94252873563218,morphological_dilation,3,2
0XA94EE36D10C4D70.avi,42,2877,2397,480,20.02503128911139,morphological_dilation,3,2
0XA94EE36D10C4D70.avi,57,1560,1206,354,29.35323383084577,morphological_dilation,3,2
0XA951AB7646161AE.avi,79,1958,1502,456,30.359520639147803,morphological_dilation,3,2
0XA951AB7646161AE.avi,97,1351,967,384,39.710444674250255,morphological_dilation,3,2
0XA97434292889BC4.avi,61,2328,1852,476,25.70194384449244,morphological_dilation,3,2
0XA97434292889BC4.avi,84,1549,1145,404,35.28384279475982,morphological_dilation,3,2
0XA989DD619F4AB85.avi,38,1591,1211,380,31.37902559867878,morphological_dilation,3,2
0XA989DD619F4AB85.avi,52,943,659,284,43.09559939301973,morphological_dilation,3,2
0XAA023992D00F604.avi,4,1158,854,304,35.597189695550355,morphological_dilation,3,2
0XAA023992D00F604.avi,16,744,488,256,52.459016393442624,morphological_dilation,3,2
0XAA304E75C4EE3E9.avi,91,1981,1553,428,27.559562137797812,morphological_dilation,3,2
0XAA304E75C4EE3E9.avi,99,1262,910,352,38.681318681318686,morphological_dilation,3,2
0XAA3A306D4EC8B69.avi,137,1982,1562,420,26.888604353393085,morphological_dilation,3,2
0XAA3A306D4EC8B69.avi,162,1351,983,368,37.43641912512716,morphological_dilation,3,2
0XAA3E06425E1A23E.avi,73,1478,1126,352,31.261101243339258,morphological_dilation,3,2
0XAA3E06425E1A23E.avi,86,1206,886,320,36.11738148984199,morphological_dilation,3,2
0XAA4741B7E7194A2.avi,51,1390,1050,340,32.38095238095238,morphological_dilation,3,2
0XAA4741B7E7194A2.avi,69,855,575,280,48.69565217391305,morphological_dilation,3,2
0XAA68800871BD1FD.avi,72,2162,1726,436,25.26071842410197,morphological_dilation,3,2
0XAA68800871BD1FD.avi,88,1259,905,354,39.11602209944751,morphological_dilation,3,2
0XAAB25926214E746.avi,93,2432,1965,467,23.76590330788804,morphological_dilation,3,2
0XAAB25926214E746.avi,112,1620,1232,388,31.493506493506494,morphological_dilation,3,2
0XAABEF7BA895A967.avi,80,2025,1627,398,24.46220036877689,morphological_dilation,3,2
0XAABEF7BA895A967.avi,96,1333,997,336,33.70110330992979,morphological_dilation,3,2
0XAAFC07869635B00.avi,76,1790,1418,372,26.234132581100138,morphological_dilation,3,2
0XAAFC07869635B00.avi,92,1102,794,308,38.79093198992443,morphological_dilation,3,2
0XAB497CBE6A93DA1.avi,66,1341,1013,328,32.379072063178675,morphological_dilation,3,2
0XAB497CBE6A93DA1.avi,85,929,621,308,49.59742351046699,morphological_dilation,3,2
0XAB701373CBCF5FC.avi,51,4252,3664,588,16.048034934497817,morphological_dilation,3,2
0XAB701373CBCF5FC.avi,66,2661,2157,504,23.36578581363004,morphological_dilation,3,2
0XAB7D06D7A122D44.avi,81,2155,1711,444,25.94973699590882,morphological_dilation,3,2
0XAB7D06D7A122D44.avi,93,1345,977,368,37.66632548618219,morphological_dilation,3,2
0XAB8C29BE4841CB0.avi,61,2063,1667,396,23.75524895020996,morphological_dilation,3,2
0XAB8C29BE4841CB0.avi,82,1317,985,332,33.70558375634518,morphological_dilation,3,2
0XABA4614974D17D9.avi,54,1607,1223,384,31.398201144726084,morphological_dilation,3,2
0XABA4614974D17D9.avi,71,1002,704,298,42.32954545454545,morphological_dilation,3,2
0XABB712C1939FBC5.avi,0,1600,1220,380,31.147540983606557,morphological_dilation,3,2
0XABB712C1939FBC5.avi,17,1084,776,308,39.69072164948454,morphological_dilation,3,2
0XABB9008CDCF5A14.avi,46,1736,1356,380,28.023598820058996,morphological_dilation,3,2
0XABB9008CDCF5A14.avi,62,1132,812,320,39.40886699507389,morphological_dilation,3,2
0XABBDDF3F072EB3F.avi,87,2352,1932,420,21.73913043478261,morphological_dilation,3,2
0XABBDDF3F072EB3F.avi,100,1960,1564,396,25.31969309462916,morphological_dilation,3,2
0XAC0EAEC877E4011.avi,78,1571,1223,348,28.454619787408014,morphological_dilation,3,2
0XAC0EAEC877E4011.avi,94,1139,831,308,37.063778580024064,morphological_dilation,3,2
0XAC7C3A56AF70470.avi,44,1699,1323,376,28.420256991685562,morphological_dilation,3,2
0XAC7C3A56AF70470.avi,59,1099,803,296,36.86176836861768,morphological_dilation,3,2
0XAC98E4AFBFA863C.avi,106,1578,1206,372,30.845771144278604,morphological_dilation,3,2
0XAC98E4AFBFA863C.avi,118,1050,730,320,43.83561643835616,morphological_dilation,3,2
0XACACEACDB6D7111.avi,35,2745,1914,831,43.41692789968652,morphological_dilation,3,2
0XACACEACDB6D7111.avi,53,1966,1253,713,56.90343176376695,morphological_dilation,3,2
0XAD3A148177CC751.avi,50,2310,1898,412,21.707060063224446,morphological_dilation,3,2
0XAD3A148177CC751.avi,68,1377,1041,336,32.27665706051873,morphological_dilation,3,2
0XADA270671B3E2BD.avi,125,2115,1695,420,24.778761061946902,morphological_dilation,3,2
0XADA270671B3E2BD.avi,144,1429,1069,360,33.67633302151544,morphological_dilation,3,2
0XADC4DD1BE4E66C6.avi,48,3286,2778,508,18.286537077033838,morphological_dilation,3,2
0XADC4DD1BE4E66C6.avi,76,2688,2232,456,20.43010752688172,morphological_dilation,3,2
0XAE20223CD4D01E4.avi,59,1503,1151,352,30.582102519548222,morphological_dilation,3,2
0XAE20223CD4D01E4.avi,77,1118,810,308,38.02469135802469,morphological_dilation,3,2
0XAE25D6E1B0C1D36.avi,41,1673,1293,380,29.389017788089717,morphological_dilation,3,2
0XAE25D6E1B0C1D36.avi,55,928,628,300,47.77070063694268,morphological_dilation,3,2
0XAE64A9D50B9C49E.avi,55,2215,1776,439,24.71846846846847,morphological_dilation,3,2
0XAE64A9D50B9C49E.avi,77,1325,961,364,37.87721123829345,morphological_dilation,3,2
0XAE7CEC16E9165DC.avi,76,1842,1458,384,26.337448559670783,morphological_dilation,3,2
0XAE7CEC16E9165DC.avi,94,1119,815,304,37.30061349693251,morphological_dilation,3,2
0XAE9B1B36D4582AD.avi,3,1968,1552,416,26.804123711340207,morphological_dilation,3,2
0XAE9B1B36D4582AD.avi,18,1076,756,320,42.32804232804233,morphological_dilation,3,2
0XAEA31035D9CAA52.avi,50,958,666,292,43.84384384384384,morphological_dilation,3,2
0XAEA31035D9CAA52.avi,69,1483,1131,352,31.12290008841733,morphological_dilation,3,2
0XAF14E70264D4B68.avi,55,1020,728,292,40.10989010989011,morphological_dilation,3,2
0XAF14E70264D4B68.avi,77,2488,2035,453,22.26044226044226,morphological_dilation,3,2
0XAF2DAA07BEAF65F.avi,182,1803,1435,368,25.64459930313589,morphological_dilation,3,2
0XAF2DAA07BEAF65F.avi,201,1141,829,312,37.635705669481304,morphological_dilation,3,2
0XAF4A04FFB4BBBC8.avi,3,2400,1976,424,21.45748987854251,morphological_dilation,3,2
0XAF4A04FFB4BBBC8.avi,18,1404,1076,328,30.483271375464682,morphological_dilation,3,2
0XAF4B0E083E9D6C2.avi,40,1892,1496,396,26.47058823529412,morphological_dilation,3,2
0XAF4B0E083E9D6C2.avi,54,1151,839,312,37.18712753277711,morphological_dilation,3,2
0XAF8D4A78571AD29.avi,0,1653,1281,372,29.039812646370024,morphological_dilation,3,2
0XAF8D4A78571AD29.avi,21,1044,732,312,42.62295081967213,morphological_dilation,3,2
0XAFBE86F77CEE5A0.avi,46,1148,828,320,38.64734299516908,morphological_dilation,3,2
0XAFBE86F77CEE5A0.avi,67,702,428,274,64.01869158878505,morphological_dilation,3,2
0XAFE17647DB9F842.avi,31,1335,995,340,34.17085427135678,morphological_dilation,3,2
0XAFE17647DB9F842.avi,45,811,555,256,46.126126126126124,morphological_dilation,3,2
0XB01A6602791740C.avi,79,1708,1336,372,27.844311377245507,morphological_dilation,3,2
0XB01A6602791740C.avi,101,1018,714,304,42.57703081232493,morphological_dilation,3,2
0XB047DCB63710E45.avi,3,2501,2029,472,23.262690980778707,morphological_dilation,3,2
0XB047DCB63710E45.avi,21,1420,1064,356,33.45864661654135,morphological_dilation,3,2
0XB0F37929C190A8C.avi,57,1916,1516,400,26.385224274406333,morphological_dilation,3,2
0XB0F37929C190A8C.avi,72,1196,868,328,37.78801843317972,morphological_dilation,3,2
0XB11B61E6027ABCE.avi,21,920,640,280,43.75,morphological_dilation,3,2
0XB11B61E6027ABCE.avi,31,695,456,239,52.41228070175439,morphological_dilation,3,2
0XB11E2FD02BEDD68.avi,34,1673,1289,384,29.79053529868115,morphological_dilation,3,2
0XB11E2FD02BEDD68.avi,54,1112,776,336,43.29896907216495,morphological_dilation,3,2
0XB120E010AF07AC0.avi,3,1888,1492,396,26.541554959785525,morphological_dilation,3,2
0XB120E010AF07AC0.avi,21,1230,902,328,36.36363636363637,morphological_dilation,3,2
0XB2586FF43C881C2.avi,44,2875,2395,480,20.041753653444676,morphological_dilation,3,2
0XB2586FF43C881C2.avi,60,1781,1393,388,27.85355348169419,morphological_dilation,3,2
0XB261623CE7B3E23.avi,113,3098,2578,520,20.17067494181536,morphological_dilation,3,2
0XB261623CE7B3E23.avi,129,1743,1319,424,32.14556482183472,morphological_dilation,3,2
0XB27C7F68A21F79A.avi,43,1617,1265,352,27.82608695652174,morphological_dilation,3,2
0XB27C7F68A21F79A.avi,65,1114,806,308,38.21339950372209,morphological_dilation,3,2
0XB2850929FE8153.avi,161,2459,2007,452,22.521175884404585,morphological_dilation,3,2
0XB2850929FE8153.avi,181,1441,1093,348,31.83897529734675,morphological_dilation,3,2
0XB29658CF38E12F7.avi,147,1042,746,296,39.67828418230563,morphological_dilation,3,2
0XB29658CF38E12F7.avi,160,758,498,260,52.208835341365464,morphological_dilation,3,2
0XB2B0A80A3F2DEF4.avi,62,1796,1384,412,29.76878612716763,morphological_dilation,3,2
0XB2B0A80A3F2DEF4.avi,75,1085,749,336,44.85981308411215,morphological_dilation,3,2
0XB2B1E32A08876DF.avi,94,3023,2535,488,19.25049309664694,morphological_dilation,3,2
0XB2B1E32A08876DF.avi,112,1803,1407,396,28.14498933901919,morphological_dilation,3,2
0XB2D24AC185D2FAE.avi,43,963,679,284,41.82621502209131,morphological_dilation,3,2
0XB2D24AC185D2FAE.avi,55,623,381,242,63.51706036745407,morphological_dilation,3,2
0XB2D73F7CA60D083.avi,106,2305,1877,428,22.802344166222696,morphological_dilation,3,2
0XB2D73F7CA60D083.avi,117,2040,1648,392,23.78640776699029,morphological_dilation,3,2
0XB37983600380DDC.avi,59,2160,1740,420,24.137931034482758,morphological_dilation,3,2
0XB37983600380DDC.avi,74,1383,1027,356,34.66407010710808,morphological_dilation,3,2
0XB3824A90B372B6.avi,48,2156,1744,412,23.623853211009173,morphological_dilation,3,2
0XB3824A90B372B6.avi,67,1348,1000,348,34.8,morphological_dilation,3,2
0XB38FB7A0C821476.avi,105,1341,1013,328,32.379072063178675,morphological_dilation,3,2
0XB38FB7A0C821476.avi,119,848,564,284,50.35460992907801,morphological_dilation,3,2
0XB3B6D8016D3A0EA.avi,40,1909,1488,421,28.293010752688176,morphological_dilation,3,2
0XB3B6D8016D3A0EA.avi,56,1168,822,346,42.092457420924575,morphological_dilation,3,2
0XB3D681E981F28A9.avi,63,1559,1205,354,29.377593360995853,morphological_dilation,3,2
0XB3D681E981F28A9.avi,73,1313,985,328,33.2994923857868,morphological_dilation,3,2
0XB3E3E715D675954.avi,92,1238,918,320,34.85838779956427,morphological_dilation,3,2
0XB3E3E715D675954.avi,115,876,602,274,45.51495016611295,morphological_dilation,3,2
0XB3F6662216A4BF1.avi,119,2204,1776,428,24.0990990990991,morphological_dilation,3,2
0XB3F6662216A4BF1.avi,134,1434,1062,372,35.02824858757062,morphological_dilation,3,2
0XB3FFC4AE334E9F4.avi,4,2027,1616,411,25.433168316831683,morphological_dilation,3,2
0XB3FFC4AE334E9F4.avi,18,1704,1312,392,29.878048780487802,morphological_dilation,3,2
0XB46944CEABE2516.avi,93,1492,1132,360,31.802120141342755,morphological_dilation,3,2
0XB46944CEABE2516.avi,107,1026,702,324,46.15384615384615,morphological_dilation,3,2
0XB4AD1970D00CAB5.avi,88,1878,1450,428,29.517241379310345,morphological_dilation,3,2
0XB4AD1970D00CAB5.avi,101,1087,751,336,44.74034620505992,morphological_dilation,3,2
0XB4CA9F2B3253AA4.avi,83,1105,789,316,40.050697084917616,morphological_dilation,3,2
0XB4CA9F2B3253AA4.avi,93,725,481,244,50.72765072765073,morphological_dilation,3,2
0XB52E6E911CEFDD3.avi,39,1480,1128,352,31.20567375886525,morphological_dilation,3,2
0XB52E6E911CEFDD3.avi,52,858,579,279,48.18652849740933,morphological_dilation,3,2
0XB534B965C394598.avi,87,927,651,276,42.3963133640553,morphological_dilation,3,2
0XB534B965C394598.avi,105,597,365,232,63.561643835616444,morphological_dilation,3,2
0XB5470B070E7F16D.avi,22,1387,1067,320,29.990627928772255,morphological_dilation,3,2
0XB5470B070E7F16D.avi,36,937,665,272,40.902255639097746,morphological_dilation,3,2
0XB5492BEC906F76C.avi,40,2241,1805,436,24.155124653739612,morphological_dilation,3,2
0XB5492BEC906F76C.avi,55,1726,1338,388,28.998505231689087,morphological_dilation,3,2
0XB55FE9464938526.avi,28,2277,1853,424,22.881813275769023,morphological_dilation,3,2
0XB55FE9464938526.avi,41,1836,1464,372,25.40983606557377,morphological_dilation,3,2
0XB57FA9DF1716E76.avi,3,1615,1251,364,29.096722621902476,morphological_dilation,3,2
0XB57FA9DF1716E76.avi,18,1027,735,292,39.72789115646258,morphological_dilation,3,2
0XB5CAEDA2CA09409.avi,37,1409,1065,344,32.30046948356807,morphological_dilation,3,2
0XB5CAEDA2CA09409.avi,51,1089,769,320,41.612483745123534,morphological_dilation,3,2
0XB5CECBD29920B7B.avi,61,1985,1581,404,25.553447185325744,morphological_dilation,3,2
0XB5CECBD29920B7B.avi,76,1772,1380,392,28.405797101449277,morphological_dilation,3,2
0XB60BF6DE9227C68.avi,62,2291,1855,436,23.504043126684635,morphological_dilation,3,2
0XB60BF6DE9227C68.avi,79,1441,1057,384,36.329233680227055,morphological_dilation,3,2
0XB618EF1BD4738C9.avi,47,2114,1671,443,26.511071214841415,morphological_dilation,3,2
0XB618EF1BD4738C9.avi,67,1509,1117,392,35.09400179051029,morphological_dilation,3,2
0XB61F11056573030.avi,33,1084,769,315,40.96228868660598,morphological_dilation,3,2
0XB61F11056573030.avi,69,1714,1320,394,29.848484848484848,morphological_dilation,3,2
0XB674609B23949FD.avi,85,1977,1577,400,25.36461636017755,morphological_dilation,3,2
0XB674609B23949FD.avi,108,1251,927,324,34.95145631067961,morphological_dilation,3,2
0XB6A91D71A5741C2.avi,37,1385,1048,337,32.156488549618324,morphological_dilation,3,2
0XB6A91D71A5741C2.avi,49,795,531,264,49.717514124293785,morphological_dilation,3,2
0XB6BC570A4D3532.avi,86,2350,1902,448,23.55415352260778,morphological_dilation,3,2
0XB6BC570A4D3532.avi,102,1565,1189,376,31.62321278385198,morphological_dilation,3,2
0XB6D8F3BAB7D9415.avi,27,2259,1835,424,23.106267029972752,morphological_dilation,3,2
0XB6D8F3BAB7D9415.avi,38,1615,1239,376,30.347054075867636,morphological_dilation,3,2
0XB72CF150368BAB2.avi,61,1016,709,307,43.30042313117066,morphological_dilation,3,2
0XB72CF150368BAB2.avi,79,866,594,272,45.79124579124579,morphological_dilation,3,2
0XB731B3B5A5E2BF7.avi,95,1701,1321,380,28.766086298258898,morphological_dilation,3,2
0XB731B3B5A5E2BF7.avi,109,1092,776,316,40.72164948453608,morphological_dilation,3,2
0XB790D3227275B82.avi,55,3623,3095,528,17.059773828756057,morphological_dilation,3,2
0XB790D3227275B82.avi,75,2324,1888,436,23.093220338983052,morphological_dilation,3,2
0XB7D37DE2E8CF999.avi,54,1660,1296,364,28.08641975308642,morphological_dilation,3,2
0XB7D37DE2E8CF999.avi,71,1104,796,308,38.69346733668342,morphological_dilation,3,2
0XB7E1867A17EDAD4.avi,37,1258,942,316,33.54564755838641,morphological_dilation,3,2
0XB7E1867A17EDAD4.avi,48,860,584,276,47.26027397260274,morphological_dilation,3,2
0XB816279A0E9E07B.avi,62,1585,1197,388,32.414369256474515,morphological_dilation,3,2
0XB816279A0E9E07B.avi,78,1206,862,344,39.90719257540603,morphological_dilation,3,2
0XB8513240ED5E94.avi,66,1334,1002,332,33.13373253493014,morphological_dilation,3,2
0XB8513240ED5E94.avi,115,2008,1524,484,31.758530183727036,morphological_dilation,3,2
0XB854FB1991CF64E.avi,32,1436,1080,356,32.96296296296296,morphological_dilation,3,2
0XB854FB1991CF64E.avi,48,793,529,264,49.9054820415879,morphological_dilation,3,2
0XB8A42CE677180DB.avi,105,1509,1161,348,29.97416020671835,morphological_dilation,3,2
0XB8A42CE677180DB.avi,119,1158,838,320,38.18615751789976,morphological_dilation,3,2
0XB8DDFCA26AD93E2.avi,42,1946,1562,384,24.583866837387962,morphological_dilation,3,2
0XB8DDFCA26AD93E2.avi,60,1456,1096,360,32.846715328467155,morphological_dilation,3,2
0XB97524F54DE851.avi,60,1691,1343,348,25.912137006701414,morphological_dilation,3,2
0XB97524F54DE851.avi,79,1164,864,300,34.72222222222222,morphological_dilation,3,2
0XB97CDA07C6DD6F4.avi,26,2812,2348,464,19.761499148211243,morphological_dilation,3,2
0XB97CDA07C6DD6F4.avi,42,2592,2148,444,20.670391061452513,morphological_dilation,3,2
0XB9AB54BCD7F3781.avi,44,1729,1337,392,29.31937172774869,morphological_dilation,3,2
0XB9AB54BCD7F3781.avi,55,909,613,296,48.28711256117455,morphological_dilation,3,2
0XB9C19B214A298A0.avi,56,1682,1330,352,26.466165413533833,morphological_dilation,3,2
0XB9C19B214A298A0.avi,81,1247,943,304,32.237539766702014,morphological_dilation,3,2
0XB9DA76703445AFD.avi,42,890,614,276,44.951140065146575,morphological_dilation,3,2
0XB9DA76703445AFD.avi,59,1436,1092,344,31.5018315018315,morphological_dilation,3,2
0XB9DB01A28FD139B.avi,63,1600,1236,364,29.449838187702266,morphological_dilation,3,2
0XB9DB01A28FD139B.avi,79,995,699,296,42.34620886981402,morphological_dilation,3,2
0XB9DF67C20D1A4B7.avi,48,1465,1093,372,34.03476669716377,morphological_dilation,3,2
0XB9DF67C20D1A4B7.avi,62,946,635,311,48.976377952755904,morphological_dilation,3,2
0XB9F42D3E6D02705.avi,58,1749,1345,404,30.03717472118959,morphological_dilation,3,2
0XB9F42D3E6D02705.avi,71,1033,709,324,45.6981664315938,morphological_dilation,3,2
0XBA0869D75B7E754.avi,362,2244,1796,448,24.94432071269488,morphological_dilation,3,2
0XBA0869D75B7E754.avi,391,1376,1014,362,35.700197238658774,morphological_dilation,3,2
0XBA15B40D87218A9.avi,57,1627,1223,404,33.033524121013905,morphological_dilation,3,2
0XBA15B40D87218A9.avi,76,1053,705,348,49.361702127659576,morphological_dilation,3,2
0XBA57FE6C733F574.avi,96,1530,1162,368,31.669535283993117,morphological_dilation,3,2
0XBA57FE6C733F574.avi,113,1053,749,304,40.58744993324432,morphological_dilation,3,2
0XBA908EC80548AD8.avi,75,2507,2068,439,21.228239845261122,morphological_dilation,3,2
0XBA908EC80548AD8.avi,92,2089,1681,408,24.27126710291493,morphological_dilation,3,2
0XBAC49AF78B67E41.avi,26,1930,1522,408,26.806833114323258,morphological_dilation,3,2
0XBAC49AF78B67E41.avi,36,1169,857,312,36.406067677946325,morphological_dilation,3,2
0XBAE445E8B4352C5.avi,29,1416,1076,340,31.59851301115242,morphological_dilation,3,2
0XBAE445E8B4352C5.avi,43,885,601,284,47.25457570715474,morphological_dilation,3,2
0XBB76A78AC119BBB.avi,101,1943,1535,408,26.579804560260584,morphological_dilation,3,2
0XBB76A78AC119BBB.avi,120,1255,903,352,38.9811738648948,morphological_dilation,3,2
0XBB81FA57B45B41E.avi,43,1582,1210,372,30.74380165289256,morphological_dilation,3,2
0XBB81FA57B45B41E.avi,58,889,613,276,45.02446982055465,morphological_dilation,3,2
0XBB9F70A309D39C1.avi,63,1610,1222,388,31.751227495908346,morphological_dilation,3,2
0XBB9F70A309D39C1.avi,83,805,516,289,56.007751937984494,morphological_dilation,3,2
0XBC07D6F8A319F72.avi,83,1761,1389,372,26.78185745140389,morphological_dilation,3,2
0XBC07D6F8A319F72.avi,95,1149,825,324,39.27272727272727,morphological_dilation,3,2
0XBC18C83D7C41A12.avi,91,2934,2434,500,20.542317173377157,morphological_dilation,3,2
0XBC18C83D7C41A12.avi,112,2132,1688,444,26.303317535545023,morphological_dilation,3,2
0XBC881D0528B2788.avi,2,2713,2241,472,21.06202588130299,morphological_dilation,3,2
0XBC881D0528B2788.avi,24,1829,1425,404,28.350877192982455,morphological_dilation,3,2
0XBCA7B3FD3A0699B.avi,41,1937,1529,408,26.68410725964683,morphological_dilation,3,2
0XBCA7B3FD3A0699B.avi,57,1156,832,324,38.94230769230769,morphological_dilation,3,2
0XBCACA2185BF51AB.avi,106,2519,2055,464,22.579075425790755,morphological_dilation,3,2
0XBCACA2185BF51AB.avi,121,1856,1452,404,27.823691460055095,morphological_dilation,3,2
0XBCDE79B59A394B8.avi,73,1883,1467,416,28.3571915473756,morphological_dilation,3,2
0XBCDE79B59A394B8.avi,86,1573,1186,387,32.63069139966273,morphological_dilation,3,2
0XBCEAB22A81A23C1.avi,100,1833,1441,392,27.203331020124917,morphological_dilation,3,2
0XBCEAB22A81A23C1.avi,123,1611,1255,356,28.366533864541832,morphological_dilation,3,2
0XBD39E52A48060D2.avi,36,2262,1838,424,23.06855277475517,morphological_dilation,3,2
0XBD39E52A48060D2.avi,57,1728,1344,384,28.57142857142857,morphological_dilation,3,2
0XBD3C5F14D7E8D1D.avi,184,3316,2748,568,20.66957787481805,morphological_dilation,3,2
0XBD3C5F14D7E8D1D.avi,200,1847,1418,429,30.253878702397742,morphological_dilation,3,2
0XBD557B0BD7E6F38.avi,88,1341,1013,328,32.379072063178675,morphological_dilation,3,2
0XBD557B0BD7E6F38.avi,100,971,679,292,43.004418262150224,morphological_dilation,3,2
0XBD9E3CD3543C2F6.avi,42,1997,1585,412,25.993690851735018,morphological_dilation,3,2
0XBD9E3CD3543C2F6.avi,60,1283,918,365,39.760348583878,morphological_dilation,3,2
0XBDA070FFD92A748.avi,32,1566,1193,373,31.265716680637052,morphological_dilation,3,2
0XBDA070FFD92A748.avi,44,988,692,296,42.77456647398844,morphological_dilation,3,2
0XBDBB1C23E1D4F0D.avi,34,1668,1312,356,27.134146341463417,morphological_dilation,3,2
0XBDBB1C23E1D4F0D.avi,53,1061,757,304,40.158520475561424,morphological_dilation,3,2
0XBDD429854C33D4E.avi,69,1852,1464,388,26.50273224043716,morphological_dilation,3,2
0XBDD429854C33D4E.avi,90,1248,904,344,38.05309734513274,morphological_dilation,3,2
0XBE0391F995D4296.avi,110,3563,3039,524,17.242513984863443,morphological_dilation,3,2
0XBE0391F995D4296.avi,125,2216,1772,444,25.056433408577877,morphological_dilation,3,2
0XBE06F978BB3226D.avi,0,4447,3913,534,13.646818297981088,morphological_dilation,3,2
0XBE06F978BB3226D.avi,16,2952,2420,532,21.983471074380166,morphological_dilation,3,2
0XBE3FBF3D0E9DC64.avi,42,1923,1543,380,24.627349319507452,morphological_dilation,3,2
0XBE3FBF3D0E9DC64.avi,60,1490,1146,344,30.017452006980804,morphological_dilation,3,2
0XBE8A99913E8F6DA.avi,73,2525,2073,452,21.804148576941632,morphological_dilation,3,2
0XBE8A99913E8F6DA.avi,88,1645,1269,376,29.629629629629626,morphological_dilation,3,2
0XBE8C637FF9D9124.avi,26,1105,809,296,36.58838071693449,morphological_dilation,3,2
0XBE8C637FF9D9124.avi,42,607,371,236,63.61185983827493,morphological_dilation,3,2
0XBEB28C9A5DE835.avi,120,1864,1472,392,26.6304347826087,morphological_dilation,3,2
0XBEB28C9A5DE835.avi,137,1241,921,320,34.74484256243214,morphological_dilation,3,2
0XBEFC0BDB0F7405.avi,3,2216,1792,424,23.660714285714285,morphological_dilation,3,2
0XBEFC0BDB0F7405.avi,21,1479,1127,352,31.233362910381544,morphological_dilation,3,2
0XBEFC537F3BF5278.avi,102,2495,1998,497,24.874874874874877,morphological_dilation,3,2
0XBEFC537F3BF5278.avi,117,1730,1279,451,35.26192337763878,morphological_dilation,3,2
0XBF2A250BF36ED1E.avi,56,2919,2423,496,20.470491126702434,morphological_dilation,3,2
0XBF2A250BF36ED1E.avi,78,2013,1589,424,26.68344870988043,morphological_dilation,3,2
0XBF90FC1324AEA2B.avi,118,2021,1633,388,23.759951010410287,morphological_dilation,3,2
0XBF90FC1324AEA2B.avi,135,1304,984,320,32.52032520325203,morphological_dilation,3,2
0XBF9AB1A74DFA6CD.avi,85,2249,1793,456,25.43223647518126,morphological_dilation,3,2
0XBF9AB1A74DFA6CD.avi,103,1453,1089,364,33.42516069788797,morphological_dilation,3,2
0XBFB1DC2891103C.avi,73,967,665,302,45.41353383458647,morphological_dilation,3,2
0XBFB1DC2891103C.avi,88,624,372,252,67.74193548387096,morphological_dilation,3,2
0XBFB290E3C10D76A.avi,110,2308,1884,424,22.505307855626327,morphological_dilation,3,2
0XBFB290E3C10D76A.avi,127,2019,1631,388,23.789086450030656,morphological_dilation,3,2
0XC006D08601D1BFB.avi,67,1530,1174,356,30.3236797274276,morphological_dilation,3,2
0XC006D08601D1BFB.avi,80,941,649,292,44.99229583975347,morphological_dilation,3,2
0XC063D22870F910D.avi,178,1360,1016,344,33.85826771653544,morphological_dilation,3,2
0XC063D22870F910D.avi,192,857,581,276,47.50430292598967,morphological_dilation,3,2
0XC0A98C54ADFEF94.avi,78,1896,1484,412,27.762803234501348,morphological_dilation,3,2
0XC0A98C54ADFEF94.avi,94,1173,833,340,40.816326530612244,morphological_dilation,3,2
0XC0E8792CFD78017.avi,99,2873,2390,483,20.2092050209205,morphological_dilation,3,2
0XC0E8792CFD78017.avi,114,2033,1617,416,25.726654298082867,morphological_dilation,3,2
0XC11611943453836.avi,80,1939,1535,404,26.319218241042346,morphological_dilation,3,2
0XC11611943453836.avi,95,1136,823,313,38.03159173754557,morphological_dilation,3,2
0XC1B491BD7A3D11C.avi,115,1844,1437,407,28.322894919972164,morphological_dilation,3,2
0XC1B491BD7A3D11C.avi,132,1153,833,320,38.41536614645859,morphological_dilation,3,2
0XC1D7945DDDA478A.avi,120,1396,1040,356,34.23076923076923,morphological_dilation,3,2
0XC1D7945DDDA478A.avi,139,873,597,276,46.231155778894475,morphological_dilation,3,2
0XC1DB7C42C35E345.avi,179,2539,2099,440,20.96236303001429,morphological_dilation,3,2
0XC1DB7C42C35E345.avi,200,1987,1583,404,25.521162349968414,morphological_dilation,3,2
0XC1E11233E59181F.avi,92,1990,1566,424,27.07535121328225,morphological_dilation,3,2
0XC1E11233E59181F.avi,112,1377,1025,352,34.34146341463415,morphological_dilation,3,2
0XC2053253DC743F3.avi,72,1736,1368,368,26.900584795321635,morphological_dilation,3,2
0XC2053253DC743F3.avi,88,1037,733,304,41.47339699863574,morphological_dilation,3,2
0XC206AC545831126.avi,164,1583,1227,356,29.013854930725348,morphological_dilation,3,2
0XC206AC545831126.avi,183,1082,782,300,38.36317135549872,morphological_dilation,3,2
0XC21E699429625CD.avi,51,894,626,268,42.81150159744409,morphological_dilation,3,2
0XC21E699429625CD.avi,66,554,330,224,67.87878787878789,morphological_dilation,3,2
0XC244CEC2F500E34.avi,48,2651,2187,464,21.216278006401463,morphological_dilation,3,2
0XC244CEC2F500E34.avi,63,1828,1412,416,29.461756373937675,morphological_dilation,3,2
0XC31605A9D22702E.avi,0,953,677,276,40.76809453471196,morphological_dilation,3,2
0XC31605A9D22702E.avi,24,573,341,232,68.03519061583577,morphological_dilation,3,2
0XC31D77CD4D50FA9.avi,97,1742,1354,388,28.65583456425406,morphological_dilation,3,2
0XC31D77CD4D50FA9.avi,119,1051,743,308,41.4535666218035,morphological_dilation,3,2
0XC3CC9222A4E69E6.avi,112,1704,1316,388,29.48328267477204,morphological_dilation,3,2
0XC3CC9222A4E69E6.avi,130,1043,735,308,41.904761904761905,morphological_dilation,3,2
0XC3D95F0492F6512.avi,48,1214,910,304,33.4065934065934,morphological_dilation,3,2
0XC3D95F0492F6512.avi,62,802,550,252,45.81818181818182,morphological_dilation,3,2
0XC3E8BBE54048886.avi,72,5368,4680,688,14.700854700854702,morphological_dilation,3,2
0XC3E8BBE54048886.avi,89,2812,2324,488,20.998278829604132,morphological_dilation,3,2
0XC42AF46236A2CFD.avi,5,2145,1709,436,25.511995318899945,morphological_dilation,3,2
0XC42AF46236A2CFD.avi,23,1575,1187,388,32.687447346251055,morphological_dilation,3,2
0XC44170E9F907DD2.avi,135,1701,1317,384,29.157175398633257,morphological_dilation,3,2
0XC44170E9F907DD2.avi,159,1157,853,304,35.63892145369285,morphological_dilation,3,2
0XC4565B55DFF191.avi,48,2924,2449,475,19.39567170273581,morphological_dilation,3,2
0XC4565B55DFF191.avi,64,1965,1537,428,27.846454131424853,morphological_dilation,3,2
0XC4BE2CADE35713C.avi,73,2005,1589,416,26.179987413467586,morphological_dilation,3,2
0XC4BE2CADE35713C.avi,89,1320,976,344,35.24590163934426,morphological_dilation,3,2
0XC4D66DC3E1AA6EB.avi,84,1659,1283,376,29.30631332813718,morphological_dilation,3,2
0XC4D66DC3E1AA6EB.avi,102,1054,738,316,42.81842818428184,morphological_dilation,3,2
0XC4F21DA269D2EE9.avi,101,1762,1382,380,27.496382054992765,morphological_dilation,3,2
0XC4F21DA269D2EE9.avi,111,1191,859,332,38.64959254947614,morphological_dilation,3,2
0XC538353E221F3FB.avi,45,2141,1705,436,25.57184750733138,morphological_dilation,3,2
0XC538353E221F3FB.avi,58,1371,1007,364,36.146971201588876,morphological_dilation,3,2
0XC5BF82CA81C2DF.avi,75,1642,1270,372,29.291338582677167,morphological_dilation,3,2
0XC5BF82CA81C2DF.avi,91,945,649,296,45.60862865947612,morphological_dilation,3,2
0XC5EED498D232DC9.avi,1,2246,1810,436,24.08839779005525,morphological_dilation,3,2
0XC5EED498D232DC9.avi,16,1569,1209,360,29.776674937965257,morphological_dilation,3,2
0XC60C5CB61599F8F.avi,149,1873,1457,416,28.551818805765272,morphological_dilation,3,2
0XC60C5CB61599F8F.avi,167,1517,1137,380,33.42128408091469,morphological_dilation,3,2
0XC622E828FE2A648.avi,99,2471,2019,452,22.387320455671126,morphological_dilation,3,2
0XC622E828FE2A648.avi,120,1822,1438,384,26.70375521557719,morphological_dilation,3,2
0XC62BC4D50804187.avi,71,1868,1472,396,26.902173913043477,morphological_dilation,3,2
0XC62BC4D50804187.avi,86,1229,893,336,37.62597984322508,morphological_dilation,3,2
0XC649E4EF24DCAB7.avi,47,1087,795,292,36.72955974842767,morphological_dilation,3,2
0XC649E4EF24DCAB7.avi,61,779,519,260,50.09633911368015,morphological_dilation,3,2
0XC6CE1305C2B28D0.avi,106,1384,1056,328,31.060606060606062,morphological_dilation,3,2
0XC6CE1305C2B28D0.avi,119,815,559,256,45.796064400715565,morphological_dilation,3,2
0XC74B1F99DF2243E.avi,47,1335,995,340,34.17085427135678,morphological_dilation,3,2
0XC74B1F99DF2243E.avi,62,848,560,288,51.42857142857142,morphological_dilation,3,2
0XC76E35532F7EE47.avi,86,1862,1454,408,28.060522696011002,morphological_dilation,3,2
0XC76E35532F7EE47.avi,100,1139,811,328,40.4438964241677,morphological_dilation,3,2
0XC775724BE40EAFD.avi,92,1645,1269,376,29.629629629629626,morphological_dilation,3,2
0XC775724BE40EAFD.avi,108,1002,674,328,48.6646884272997,morphological_dilation,3,2
0XC77F1C717BE6B6D.avi,1,1497,1149,348,30.287206266318538,morphological_dilation,3,2
0XC77F1C717BE6B6D.avi,17,930,650,280,43.07692307692308,morphological_dilation,3,2
0XC781E8B0D3035BD.avi,106,1576,1232,344,27.92207792207792,morphological_dilation,3,2
0XC781E8B0D3035BD.avi,121,1159,847,312,36.835891381345924,morphological_dilation,3,2
0XC8144B9EF1990EF.avi,87,1734,1354,380,28.064992614475624,morphological_dilation,3,2
0XC8144B9EF1990EF.avi,101,1088,749,339,45.26034712950601,morphological_dilation,3,2
0XC824784198003F2.avi,67,1693,1317,376,28.549734244495063,morphological_dilation,3,2
0XC824784198003F2.avi,79,1163,839,324,38.61740166865316,morphological_dilation,3,2
0XC83A970AAC17CA8.avi,149,1659,1283,376,29.30631332813718,morphological_dilation,3,2
0XC83A970AAC17CA8.avi,165,1225,909,316,34.763476347634764,morphological_dilation,3,2
0XC8811E9F9047578.avi,37,1806,1422,384,27.004219409282697,morphological_dilation,3,2
0XC8811E9F9047578.avi,53,1101,777,324,41.6988416988417,morphological_dilation,3,2
0XC89A68BA0AA0A11.avi,22,1896,1500,396,26.400000000000002,morphological_dilation,3,2
0XC89A68BA0AA0A11.avi,33,1040,744,296,39.784946236559136,morphological_dilation,3,2
0XC89BD7836585978.avi,44,2657,2189,468,21.379625399725903,morphological_dilation,3,2
0XC89BD7836585978.avi,59,2016,1596,420,26.31578947368421,morphological_dilation,3,2
0XC8D1B3C80770006.avi,99,2930,2458,472,19.202603742880388,morphological_dilation,3,2
0XC8D1B3C80770006.avi,114,2667,2207,460,20.84277299501586,morphological_dilation,3,2
0XC8DE2D8DB465511.avi,51,1215,887,328,36.97857948139797,morphological_dilation,3,2
0XC8DE2D8DB465511.avi,68,717,433,284,65.58891454965358,morphological_dilation,3,2
0XC9784D72590639A.avi,50,2912,2440,472,19.34426229508197,morphological_dilation,3,2
0XC9784D72590639A.avi,69,1888,1492,396,26.541554959785525,morphological_dilation,3,2
0XC9CD3F156FBCC49.avi,36,844,583,261,44.76843910806175,morphological_dilation,3,2
0XC9CD3F156FBCC49.avi,55,438,254,184,72.44094488188976,morphological_dilation,3,2
0XCA133A9A2B901DB.avi,75,1620,1252,368,29.39297124600639,morphological_dilation,3,2
0XCA133A9A2B901DB.avi,89,1002,710,292,41.12676056338028,morphological_dilation,3,2
0XCA1E6F96A8F0686.avi,39,1218,906,312,34.437086092715234,morphological_dilation,3,2
0XCA1E6F96A8F0686.avi,53,791,531,260,48.96421845574388,morphological_dilation,3,2
0XCA3F1E9BC33DB6E.avi,44,2319,1879,440,23.416711016498137,morphological_dilation,3,2
0XCA3F1E9BC33DB6E.avi,64,1382,1034,348,33.65570599613153,morphological_dilation,3,2
0XCB722F90EEDD431.avi,96,2155,1731,424,24.494511842865396,morphological_dilation,3,2
0XCB722F90EEDD431.avi,112,1758,1370,388,28.32116788321168,morphological_dilation,3,2
0XCBB63C835191B4B.avi,85,2291,1835,456,24.850136239782017,morphological_dilation,3,2
0XCBB63C835191B4B.avi,97,1473,1095,378,34.52054794520548,morphological_dilation,3,2
0XCBBD0FFDB29A321.avi,58,1962,1558,404,25.930680359435172,morphological_dilation,3,2
0XCBBD0FFDB29A321.avi,73,1388,1034,354,34.23597678916828,morphological_dilation,3,2
0XCBC6A16E66E2941.avi,23,1173,869,304,34.982738780207136,morphological_dilation,3,2
0XCBC6A16E66E2941.avi,53,1846,1474,372,25.237449118046136,morphological_dilation,3,2
0XCC0DD4FDDA0EA5B.avi,73,1572,1208,364,30.132450331125828,morphological_dilation,3,2
0XCC0DD4FDDA0EA5B.avi,88,1011,715,296,41.3986013986014,morphological_dilation,3,2
0XCC49D77D8379951.avi,40,1738,1358,380,27.982326951399116,morphological_dilation,3,2
0XCC49D77D8379951.avi,55,1014,714,300,42.016806722689076,morphological_dilation,3,2
0XCC513AC74753096.avi,117,1864,1476,388,26.287262872628723,morphological_dilation,3,2
0XCC513AC74753096.avi,138,1059,759,300,39.52569169960474,morphological_dilation,3,2
0XCC8B5A22926B01A.avi,161,1522,1158,364,31.43350604490501,morphological_dilation,3,2
0XCC8B5A22926B01A.avi,177,982,670,312,46.56716417910447,morphological_dilation,3,2
0XCCB63496DB01277.avi,47,1444,1100,344,31.272727272727273,morphological_dilation,3,2
0XCCB63496DB01277.avi,63,800,531,269,50.65913370998116,morphological_dilation,3,2
0XCCBE81B251BEF37.avi,46,1987,1575,412,26.158730158730158,morphological_dilation,3,2
0XCCBE81B251BEF37.avi,60,1190,847,343,40.49586776859504,morphological_dilation,3,2
0XCCC60B5DC80A516.avi,53,1497,1159,338,29.163071613459877,morphological_dilation,3,2
0XCCC60B5DC80A516.avi,73,981,689,292,42.380261248185775,morphological_dilation,3,2
0XCCF1BD71411C2EE.avi,41,1359,1011,348,34.42136498516321,morphological_dilation,3,2
0XCCF1BD71411C2EE.avi,62,878,592,286,48.310810810810814,morphological_dilation,3,2
0XCD3FC9BB91227E0.avi,0,1477,1129,348,30.823737821080606,morphological_dilation,3,2
0XCD3FC9BB91227E0.avi,19,866,602,264,43.85382059800664,morphological_dilation,3,2
0XCDA061FD0F030DC.avi,119,1593,1217,376,30.895645028759244,morphological_dilation,3,2
0XCDA061FD0F030DC.avi,136,1158,838,320,38.18615751789976,morphological_dilation,3,2
0XCDC194CB936209F.avi,31,4004,3404,600,17.62632197414806,morphological_dilation,3,2
0XCDC194CB936209F.avi,47,2460,1944,516,26.543209876543212,morphological_dilation,3,2
0XCDD2820A5F430A1.avi,49,3037,2505,532,21.2375249500998,morphological_dilation,3,2
0XCDD2820A5F430A1.avi,67,1746,1291,455,35.243996901626645,morphological_dilation,3,2
0XCDD502705AC6FCC.avi,52,1916,1524,392,25.72178477690289,morphological_dilation,3,2
0XCDD502705AC6FCC.avi,69,1177,853,324,37.98358733880422,morphological_dilation,3,2
0XCEAEC183EA7E7E6.avi,68,2166,1746,420,24.054982817869416,morphological_dilation,3,2
0XCEAEC183EA7E7E6.avi,85,1411,1055,356,33.74407582938389,morphological_dilation,3,2
0XCEC174C2D88B511.avi,3,4526,3906,620,15.873015873015872,morphological_dilation,3,2
0XCEC174C2D88B511.avi,18,3060,2536,524,20.66246056782334,morphological_dilation,3,2
0XCEEA1EA058DA6C0.avi,39,1992,1576,416,26.39593908629442,morphological_dilation,3,2
0XCEEA1EA058DA6C0.avi,54,1266,910,356,39.120879120879124,morphological_dilation,3,2
0XCF0F0C58A0F4639.avi,100,1786,1394,392,28.120516499282637,morphological_dilation,3,2
0XCF0F0C58A0F4639.avi,118,1167,843,324,38.43416370106761,morphological_dilation,3,2
0XCF22B2C72A7CE6C.avi,56,1592,1237,355,28.698464025869036,morphological_dilation,3,2
0XCF22B2C72A7CE6C.avi,70,1020,717,303,42.25941422594142,morphological_dilation,3,2
0XCF341C5F3A273CD.avi,51,1467,1088,379,34.83455882352941,morphological_dilation,3,2
0XCF341C5F3A273CD.avi,71,1224,875,349,39.885714285714286,morphological_dilation,3,2
0XCF4E414163EBF98.avi,42,2688,2204,484,21.960072595281307,morphological_dilation,3,2
0XCF4E414163EBF98.avi,66,1675,1267,408,32.202052091554854,morphological_dilation,3,2
0XCF92B5177AEC06F.avi,184,1232,908,324,35.68281938325991,morphological_dilation,3,2
0XCF92B5177AEC06F.avi,200,825,553,272,49.186256781193485,morphological_dilation,3,2
0XCFA60F0B3CF1782.avi,44,1558,1202,356,29.61730449251248,morphological_dilation,3,2
0XCFA60F0B3CF1782.avi,62,972,684,288,42.10526315789473,morphological_dilation,3,2
0XCFC029F53F6CD42.avi,75,2513,2049,464,22.64519277696437,morphological_dilation,3,2
0XCFC029F53F6CD42.avi,91,1428,1051,377,35.87059942911513,morphological_dilation,3,2
0XD0070C7CDF75456.avi,56,3560,3008,552,18.351063829787233,morphological_dilation,3,2
0XD0070C7CDF75456.avi,73,2043,1615,428,26.501547987616096,morphological_dilation,3,2
0XD00B14807A0FA2B.avi,41,1019,743,276,37.14670255720054,morphological_dilation,3,2
0XD00B14807A0FA2B.avi,51,897,625,272,43.519999999999996,morphological_dilation,3,2
0XD032E3D5A853578.avi,74,1467,1091,376,34.46379468377635,morphological_dilation,3,2
0XD032E3D5A853578.avi,90,999,693,306,44.15584415584416,morphological_dilation,3,2
0XD05D93184B12092.avi,0,1959,1551,408,26.305609284332686,morphological_dilation,3,2
0XD05D93184B12092.avi,13,1114,753,361,47.941567065073045,morphological_dilation,3,2
0XD06D90B22BC11CE.avi,54,1627,1255,372,29.64143426294821,morphological_dilation,3,2
0XD06D90B22BC11CE.avi,72,1200,852,348,40.845070422535215,morphological_dilation,3,2
0XD07ABCAC62F4FF7.avi,123,2512,2056,456,22.17898832684825,morphological_dilation,3,2
0XD07ABCAC62F4FF7.avi,146,1466,1122,344,30.65953654188948,morphological_dilation,3,2
0XD0955B01F39FD0C.avi,117,1473,1113,360,32.34501347708895,morphological_dilation,3,2
0XD0955B01F39FD0C.avi,134,946,646,300,46.43962848297213,morphological_dilation,3,2
0XD0B87FA30CDF547.avi,75,1974,1472,502,34.10326086956522,morphological_dilation,3,2
0XD0B87FA30CDF547.avi,90,1143,806,337,41.811414392059554,morphological_dilation,3,2
0XD0BD0330D1F1A00.avi,46,1900,1488,412,27.688172043010752,morphological_dilation,3,2
0XD0BD0330D1F1A00.avi,68,1373,1017,356,35.004916420845625,morphological_dilation,3,2
0XD0BE4647858725A.avi,47,1931,1544,387,25.064766839378237,morphological_dilation,3,2
0XD0BE4647858725A.avi,67,1055,755,300,39.735099337748345,morphological_dilation,3,2
0XD0DC210BA3C1C9E.avi,75,1809,1405,404,28.75444839857651,morphological_dilation,3,2
0XD0DC210BA3C1C9E.avi,93,1191,851,340,39.9529964747356,morphological_dilation,3,2
0XD0DDB39727C76C.avi,59,1601,1245,356,28.594377510040157,morphological_dilation,3,2
0XD0DDB39727C76C.avi,76,984,692,292,42.19653179190752,morphological_dilation,3,2
0XD0E1375CD861EDC.avi,41,2299,1875,424,22.613333333333333,morphological_dilation,3,2
0XD0E1375CD861EDC.avi,57,1638,1258,380,30.206677265500797,morphological_dilation,3,2
0XD11D1E980723BE1.avi,76,2220,1778,442,24.85939257592801,morphological_dilation,3,2
0XD11D1E980723BE1.avi,93,1413,1037,376,36.25843780135005,morphological_dilation,3,2
0XD1A496DBFB3FC4F.avi,79,1254,934,320,34.26124197002141,morphological_dilation,3,2
0XD1A496DBFB3FC4F.avi,95,956,664,292,43.97590361445783,morphological_dilation,3,2
0XD1D122C0AFC006C.avi,4,3258,2702,556,20.577350111028867,morphological_dilation,3,2
0XD1D122C0AFC006C.avi,23,2148,1668,480,28.776978417266186,morphological_dilation,3,2
0XD2023E03A8C566C.avi,142,1464,1104,360,32.608695652173914,morphological_dilation,3,2
0XD2023E03A8C566C.avi,165,825,561,264,47.05882352941176,morphological_dilation,3,2
0XD25783B49EB1FE6.avi,37,1517,1165,352,30.21459227467811,morphological_dilation,3,2
0XD25783B49EB1FE6.avi,53,925,637,288,45.211930926216645,morphological_dilation,3,2
0XD299E490ECC3438.avi,83,1757,1369,388,28.341855368882396,morphological_dilation,3,2
0XD299E490ECC3438.avi,98,1164,832,332,39.90384615384615,morphological_dilation,3,2
0XD2B1CAD149853FE.avi,101,2678,2218,460,20.73940486925158,morphological_dilation,3,2
0XD2B1CAD149853FE.avi,129,1800,1393,407,29.21751615218952,morphological_dilation,3,2
0XD2C12F10DD2C98F.avi,50,1546,1202,344,28.618968386023298,morphological_dilation,3,2
0XD2C12F10DD2C98F.avi,64,1011,719,292,40.61196105702364,morphological_dilation,3,2
0XD3015B502E070B2.avi,117,1369,1021,348,34.084231145935355,morphological_dilation,3,2
0XD3015B502E070B2.avi,136,940,656,284,43.292682926829265,morphological_dilation,3,2
0XD348D272B89F1A6.avi,35,1937,1541,396,25.697598961713176,morphological_dilation,3,2
0XD348D272B89F1A6.avi,58,1202,878,324,36.90205011389522,morphological_dilation,3,2
0XD37F085443DAC1A.avi,137,1844,1444,400,27.70083102493075,morphological_dilation,3,2
0XD37F085443DAC1A.avi,151,1085,761,324,42.57555847568988,morphological_dilation,3,2
0XD3B557874B91D0D.avi,91,2532,2076,456,21.965317919075144,morphological_dilation,3,2
0XD3B557874B91D0D.avi,109,1730,1338,392,29.297458893871447,morphological_dilation,3,2
0XD3CF6D354ACF645.avi,48,1476,1110,366,32.972972972972975,morphological_dilation,3,2
0XD3CF6D354ACF645.avi,65,950,642,308,47.97507788161994,morphological_dilation,3,2
0XD4659C3A1FA9518.avi,42,1523,1179,344,29.17726887192536,morphological_dilation,3,2
0XD4659C3A1FA9518.avi,57,1284,956,328,34.30962343096235,morphological_dilation,3,2
0XD486D3C28ECF7F2.avi,173,3022,2554,468,18.324197337509787,morphological_dilation,3,2
0XD486D3C28ECF7F2.avi,192,2269,1857,412,22.186322024771137,morphological_dilation,3,2
0XD51E16EDF0F45F2.avi,49,1865,1481,384,25.928426738690074,morphological_dilation,3,2
0XD51E16EDF0F45F2.avi,62,1087,799,288,36.0450563204005,morphological_dilation,3,2
0XD537CD5A04B8C43.avi,98,1660,1252,408,32.587859424920126,morphological_dilation,3,2
0XD537CD5A04B8C43.avi,115,1238,878,360,41.00227790432802,morphological_dilation,3,2
0XD578E2221A216DD.avi,0,1915,1531,384,25.081645983017637,morphological_dilation,3,2
0XD578E2221A216DD.avi,17,1605,1241,364,29.331184528605963,morphological_dilation,3,2
0XD5ED87EECABCE2F.avi,61,2383,1935,448,23.152454780361754,morphological_dilation,3,2
0XD5ED87EECABCE2F.avi,79,1412,1052,360,34.22053231939163,morphological_dilation,3,2
0XD5F2509FE1D0C20.avi,127,2873,2370,503,21.223628691983123,morphological_dilation,3,2
0XD5F2509FE1D0C20.avi,168,1722,1330,392,29.47368421052631,morphological_dilation,3,2
0XD604065881A87A3.avi,53,1404,1060,344,32.45283018867924,morphological_dilation,3,2
0XD604065881A87A3.avi,66,899,615,284,46.17886178861789,morphological_dilation,3,2
0XD6240C89679865D.avi,99,1855,1451,404,27.842866988283944,morphological_dilation,3,2
0XD6240C89679865D.avi,120,1198,866,332,38.33718244803695,morphological_dilation,3,2
0XD65A5E3BEE1A26B.avi,59,1489,1149,340,29.590948651000872,morphological_dilation,3,2
0XD65A5E3BEE1A26B.avi,74,936,656,280,42.68292682926829,morphological_dilation,3,2
0XD69093EEA9EE1CD.avi,58,2470,2030,440,21.67487684729064,morphological_dilation,3,2
0XD69093EEA9EE1CD.avi,78,2166,1758,408,23.208191126279864,morphological_dilation,3,2
0XD6975BAB837093B.avi,79,2552,2068,484,23.404255319148938,morphological_dilation,3,2
0XD6975BAB837093B.avi,93,1880,1452,428,29.476584022038566,morphological_dilation,3,2
0XD70CB948FBEE927.avi,91,1755,1362,393,28.854625550660796,morphological_dilation,3,2
0XD70CB948FBEE927.avi,108,1195,855,340,39.76608187134503,morphological_dilation,3,2
0XD77D667D3BD5EAE.avi,46,1514,1154,360,31.195840554592717,morphological_dilation,3,2
0XD77D667D3BD5EAE.avi,61,959,675,284,42.074074074074076,morphological_dilation,3,2
0XD782AF8BF68556F.avi,124,1661,1299,362,27.867590454195536,morphological_dilation,3,2
0XD782AF8BF68556F.avi,140,1214,910,304,33.4065934065934,morphological_dilation,3,2
0XD79C49C010950C7.avi,52,1478,1122,356,31.72905525846702,morphological_dilation,3,2
0XD79C49C010950C7.avi,68,833,561,272,48.484848484848484,morphological_dilation,3,2
0XD7ACD0FDE9C8A69.avi,52,2093,1673,420,25.10460251046025,morphological_dilation,3,2
0XD7ACD0FDE9C8A69.avi,70,1478,1130,348,30.796460176991154,morphological_dilation,3,2
0XD7B885364948E9B.avi,45,1279,939,340,36.2087326943557,morphological_dilation,3,2
0XD7B885364948E9B.avi,73,763,489,274,56.032719836400815,morphological_dilation,3,2
0XD807B969AAB4A1B.avi,90,1508,1140,368,32.280701754385966,morphological_dilation,3,2
0XD807B969AAB4A1B.avi,109,970,670,300,44.776119402985074,morphological_dilation,3,2
0XD82A46274BA199D.avi,178,2160,1724,436,25.290023201856147,morphological_dilation,3,2
0XD82A46274BA199D.avi,197,1355,1007,348,34.55809334657398,morphological_dilation,3,2
0XD84BF2C72859828.avi,73,1728,1324,404,30.513595166163142,morphological_dilation,3,2
0XD84BF2C72859828.avi,89,1060,736,324,44.02173913043478,morphological_dilation,3,2
0XD88810A8041349B.avi,40,1782,1394,388,27.83357245337159,morphological_dilation,3,2
0XD88810A8041349B.avi,55,1228,892,336,37.66816143497758,morphological_dilation,3,2
0XD931DD5F6E68BB.avi,93,1695,1303,392,30.084420567920183,morphological_dilation,3,2
0XD931DD5F6E68BB.avi,111,1097,768,329,42.83854166666667,morphological_dilation,3,2
0XDA3A603964AF0D3.avi,102,1848,1448,400,27.624309392265197,morphological_dilation,3,2
0XDA3A603964AF0D3.avi,121,1159,843,316,37.48517200474496,morphological_dilation,3,2
0XDA3CBEA102E1D11.avi,83,2197,1785,412,23.0812324929972,morphological_dilation,3,2
0XDA3CBEA102E1D11.avi,102,1864,1464,400,27.322404371584703,morphological_dilation,3,2
0XDA9164EAE828591.avi,86,2965,2061,904,43.86220281416788,morphological_dilation,3,2
0XDA9164EAE828591.avi,108,3616,2608,1008,38.65030674846626,morphological_dilation,3,2
0XDAA38BE7DD4D8F6.avi,2,1449,1081,368,34.04255319148936,morphological_dilation,3,2
0XDAA38BE7DD4D8F6.avi,19,844,560,284,50.71428571428571,morphological_dilation,3,2
0XDAC9597CA49DF0A.avi,44,1498,1151,347,30.14769765421373,morphological_dilation,3,2
0XDAC9597CA49DF0A.avi,61,1015,709,306,43.15937940761636,morphological_dilation,3,2
0XDB100B9990F3EB.avi,2,3988,3433,555,16.16661811826391,morphological_dilation,3,2
0XDB100B9990F3EB.avi,21,2367,1848,519,28.084415584415584,morphological_dilation,3,2
0XDB4C8F64C55982E.avi,149,1548,1180,368,31.186440677966104,morphological_dilation,3,2
0XDB4C8F64C55982E.avi,169,955,637,318,49.92150706436421,morphological_dilation,3,2
0XDBB48C48A226A5.avi,84,1711,1347,364,27.023014105419453,morphological_dilation,3,2
0XDBB48C48A226A5.avi,99,1031,731,300,41.03967168262654,morphological_dilation,3,2
0XDC1CE3355BA3CD9.avi,46,2272,1836,436,23.74727668845316,morphological_dilation,3,2
0XDC1CE3355BA3CD9.avi,67,1354,1002,352,35.12974051896208,morphological_dilation,3,2
0XDC754C50E00D543.avi,107,2772,2292,480,20.94240837696335,morphological_dilation,3,2
0XDC754C50E00D543.avi,126,1650,1270,380,29.92125984251969,morphological_dilation,3,2
0XDC9457A479390F4.avi,53,1781,1385,396,28.592057761732853,morphological_dilation,3,2
0XDC9457A479390F4.avi,69,1132,820,312,38.048780487804876,morphological_dilation,3,2
0XDCAB490130919DE.avi,34,1366,1042,324,31.09404990403071,morphological_dilation,3,2
0XDCAB490130919DE.avi,46,1183,883,300,33.975084937712346,morphological_dilation,3,2
0XDD3291A30BBAB09.avi,99,1911,1527,384,25.147347740667975,morphological_dilation,3,2
0XDD3291A30BBAB09.avi,114,1143,843,300,35.587188612099645,morphological_dilation,3,2
0XDD4F7361041731C.avi,70,1853,1441,412,28.591256072172104,morphological_dilation,3,2
0XDD4F7361041731C.avi,86,1593,1213,380,31.327287716405607,morphological_dilation,3,2
0XDD95EC509482D69.avi,0,2590,2119,471,22.227465785747995,morphological_dilation,3,2
0XDD95EC509482D69.avi,16,1589,1229,360,29.292107404393814,morphological_dilation,3,2
0XDDE8C09C893992.avi,92,1875,1483,392,26.43290627107215,morphological_dilation,3,2
0XDDE8C09C893992.avi,108,1250,914,336,36.76148796498906,morphological_dilation,3,2
0XDDF6CD002C13FAB.avi,41,1596,1236,360,29.126213592233007,morphological_dilation,3,2
0XDDF6CD002C13FAB.avi,58,1330,998,332,33.26653306613226,morphological_dilation,3,2
0XDE2B520A16EB881.avi,33,1671,1307,364,27.850038255547055,morphological_dilation,3,2
0XDE2B520A16EB881.avi,49,1012,720,292,40.55555555555556,morphological_dilation,3,2
0XDE352D911F0C6DD.avi,95,1791,1423,368,25.8608573436402,morphological_dilation,3,2
0XDE352D911F0C6DD.avi,110,1071,779,292,37.48395378690629,morphological_dilation,3,2
0XDE3F9D01F78FA74.avi,88,2612,2136,476,22.284644194756552,morphological_dilation,3,2
0XDE3F9D01F78FA74.avi,105,1632,1256,376,29.936305732484076,morphological_dilation,3,2
0XDE61FD9522E5852.avi,34,1381,1049,332,31.649189704480456,morphological_dilation,3,2
0XDE61FD9522E5852.avi,47,863,591,272,46.02368866328257,morphological_dilation,3,2
0XDE9310288F4FBFC.avi,0,1317,965,352,36.476683937823836,morphological_dilation,3,2
0XDE9310288F4FBFC.avi,15,828,536,292,54.47761194029851,morphological_dilation,3,2
0XDEC72212622926F.avi,52,1744,1360,384,28.235294117647058,morphological_dilation,3,2
0XDEC72212622926F.avi,64,1006,698,308,44.126074498567334,morphological_dilation,3,2
0XDEE3C5434E5B289.avi,86,2826,2318,508,21.91544434857636,morphological_dilation,3,2
0XDEE3C5434E5B289.avi,101,1809,1397,412,29.49176807444524,morphological_dilation,3,2
0XDEEF6DE6F4A8F45.avi,120,1945,1533,412,26.875407697325503,morphological_dilation,3,2
0XDEEF6DE6F4A8F45.avi,140,1170,834,336,40.28776978417266,morphological_dilation,3,2
0XDF1FD388B6166A2.avi,2,1376,1040,336,32.30769230769231,morphological_dilation,3,2
0XDF1FD388B6166A2.avi,18,891,623,268,43.01765650080257,morphological_dilation,3,2
0XDFDC37EE52B138D.avi,93,1814,1450,364,25.103448275862068,morphological_dilation,3,2
0XDFDC37EE52B138D.avi,107,1510,1186,324,27.318718381112983,morphological_dilation,3,2
0XDFF3A318962AD77.avi,99,1764,1360,404,29.705882352941178,morphological_dilation,3,2
0XDFF3A318962AD77.avi,115,1159,835,324,38.80239520958084,morphological_dilation,3,2
0XE01EA3914250B74.avi,61,1740,1356,384,28.31858407079646,morphological_dilation,3,2
0XE01EA3914250B74.avi,73,999,699,300,42.91845493562232,morphological_dilation,3,2
0XE025360AE5D6B9.avi,125,2136,1704,432,25.352112676056336,morphological_dilation,3,2
0XE025360AE5D6B9.avi,151,1381,1007,374,37.14001986097319,morphological_dilation,3,2
0XE09693AED1032C0.avi,21,1063,751,312,41.54460719041278,morphological_dilation,3,2
0XE09693AED1032C0.avi,57,1904,1502,402,26.764314247669773,morphological_dilation,3,2
0XE0A06BBB5417202.avi,121,1485,1118,367,32.826475849731665,morphological_dilation,3,2
0XE0A06BBB5417202.avi,142,786,518,268,51.737451737451735,morphological_dilation,3,2
0XE0CD11D3F5C69DB.avi,60,1043,767,276,35.98435462842243,morphological_dilation,3,2
0XE0CD11D3F5C69DB.avi,72,621,405,216,53.333333333333336,morphological_dilation,3,2
0XE0DFD3845CCF80F.avi,62,2064,1668,396,23.741007194244602,morphological_dilation,3,2
0XE0DFD3845CCF80F.avi,73,1833,1469,364,24.778761061946902,morphological_dilation,3,2
0XE12521DF3EDF68A.avi,65,2255,1783,472,26.472237801458213,morphological_dilation,3,2
0XE12521DF3EDF68A.avi,80,1233,889,344,38.69516310461192,morphological_dilation,3,2
0XE264FF9B06BFDB1.avi,65,2488,2028,460,22.682445759368836,morphological_dilation,3,2
0XE264FF9B06BFDB1.avi,82,1471,1115,356,31.928251121076233,morphological_dilation,3,2
0XE27AFFCA94F6E3D.avi,151,1718,1346,372,27.637444279346212,morphological_dilation,3,2
0XE27AFFCA94F6E3D.avi,166,1015,719,296,41.1682892906815,morphological_dilation,3,2
0XE2F1E54DEFDF46F.avi,40,1760,1346,414,30.75780089153046,morphological_dilation,3,2
0XE2F1E54DEFDF46F.avi,58,1267,910,357,39.23076923076923,morphological_dilation,3,2
0XE315B0A3C5BAC9E.avi,46,1510,1166,344,29.50257289879931,morphological_dilation,3,2
0XE315B0A3C5BAC9E.avi,62,964,684,280,40.93567251461988,morphological_dilation,3,2
0XE31E2DCAFB19A01.avi,59,1389,1037,352,33.94406943105111,morphological_dilation,3,2
0XE31E2DCAFB19A01.avi,73,1029,667,362,54.27286356821589,morphological_dilation,3,2
0XE354EF700E4B992.avi,106,2352,1908,444,23.270440251572328,morphological_dilation,3,2
0XE354EF700E4B992.avi,123,1524,1160,364,31.379310344827587,morphological_dilation,3,2
0XE3634D73CD76145.avi,31,1818,1434,384,26.778242677824267,morphological_dilation,3,2
0XE3634D73CD76145.avi,47,1052,744,308,41.39784946236559,morphological_dilation,3,2
0XE39993045DB612C.avi,48,2702,2230,472,21.16591928251121,morphological_dilation,3,2
0XE39993045DB612C.avi,70,1953,1525,428,28.065573770491802,morphological_dilation,3,2
0XE3ACAE78E81F9E0.avi,57,1609,1237,372,30.072756669361354,morphological_dilation,3,2
0XE3ACAE78E81F9E0.avi,72,1195,867,328,37.831603229527104,morphological_dilation,3,2
0XE3B9242BC8DEE40.avi,118,1893,1505,388,25.780730897009967,morphological_dilation,3,2
0XE3B9242BC8DEE40.avi,141,1256,936,320,34.18803418803419,morphological_dilation,3,2
0XE3D4128C7719147.avi,0,2156,1748,408,23.340961098398168,morphological_dilation,3,2
0XE3D4128C7719147.avi,16,1424,1080,344,31.851851851851855,morphological_dilation,3,2
0XE3DED926B92A91B.avi,132,2303,1851,452,24.41923284710967,morphological_dilation,3,2
0XE3DED926B92A91B.avi,148,1535,1151,384,33.362293657688966,morphological_dilation,3,2
0XE3F034EA28509F5.avi,61,1832,1441,391,27.133934767522554,morphological_dilation,3,2
0XE3F034EA28509F5.avi,79,1050,742,308,41.509433962264154,morphological_dilation,3,2
0XE416C6A721DD00C.avi,133,1633,1261,372,29.50039651070579,morphological_dilation,3,2
0XE416C6A721DD00C.avi,152,965,669,296,44.24514200298953,morphological_dilation,3,2
0XE4299054391C4B.avi,47,1508,1152,356,30.90277777777778,morphological_dilation,3,2
0XE4299054391C4B.avi,69,994,688,306,44.47674418604651,morphological_dilation,3,2
0XE473560DC3BF6D6.avi,111,1308,984,324,32.926829268292686,morphological_dilation,3,2
0XE473560DC3BF6D6.avi,127,914,638,276,43.260188087774296,morphological_dilation,3,2
0XE476D1873283160.avi,78,1213,869,344,39.58573072497123,morphological_dilation,3,2
0XE476D1873283160.avi,91,720,439,281,64.00911161731207,morphological_dilation,3,2
0XE4DFE0DCBEFEF10.avi,3,1347,1015,332,32.70935960591133,morphological_dilation,3,2
0XE4DFE0DCBEFEF10.avi,16,953,669,284,42.45142002989537,morphological_dilation,3,2
0XE52CB1441F60EAF.avi,97,2499,2047,452,22.081094284318514,morphological_dilation,3,2
0XE52CB1441F60EAF.avi,110,1915,1535,380,24.7557003257329,morphological_dilation,3,2
0XE5A9B465EB444E.avi,73,1160,844,316,37.44075829383886,morphological_dilation,3,2
0XE5A9B465EB444E.avi,90,754,490,264,53.87755102040816,morphological_dilation,3,2
0XE5E5BCE6C2D200C.avi,127,2015,1591,424,26.64990571967316,morphological_dilation,3,2
0XE5E5BCE6C2D200C.avi,140,1383,1011,372,36.795252225519285,morphological_dilation,3,2
0XE5F70C3C553E989.avi,145,3023,2531,492,19.438956934018176,morphological_dilation,3,2
0XE5F70C3C553E989.avi,168,1781,1393,388,27.85355348169419,morphological_dilation,3,2
0XE62926359A7E033.avi,0,2455,2011,444,22.07856787667827,morphological_dilation,3,2
0XE62926359A7E033.avi,15,1934,1542,392,25.421530479896237,morphological_dilation,3,2
0XE6F5061C12D9083.avi,68,2135,1723,412,23.91178177597214,morphological_dilation,3,2
0XE6F5061C12D9083.avi,92,1291,967,324,33.50568769389866,morphological_dilation,3,2
0XE727DA95C7D9B46.avi,90,2429,1981,448,22.614840989399294,morphological_dilation,3,2
0XE727DA95C7D9B46.avi,110,1516,1144,372,32.51748251748251,morphological_dilation,3,2
0XE72812337BCB4A7.avi,40,1359,1027,332,32.327166504381694,morphological_dilation,3,2
0XE72812337BCB4A7.avi,54,815,547,268,48.9945155393053,morphological_dilation,3,2
0XE763608A3EFEF2.avi,39,1498,1162,336,28.915662650602407,morphological_dilation,3,2
0XE763608A3EFEF2.avi,57,1107,815,292,35.828220858895705,morphological_dilation,3,2
0XE7677B39DB66752.avi,83,2900,2377,523,22.002524190155658,morphological_dilation,3,2
0XE7677B39DB66752.avi,99,1817,1389,428,30.813534917206624,morphological_dilation,3,2
0XE778DAE0B378968.avi,158,4100,3528,572,16.213151927437643,morphological_dilation,3,2
0XE778DAE0B378968.avi,175,2361,1901,460,24.1977906365071,morphological_dilation,3,2
0XE7A4FB78DA40B1C.avi,121,3517,2985,532,17.822445561139027,morphological_dilation,3,2
0XE7A4FB78DA40B1C.avi,135,2132,1696,436,25.707547169811324,morphological_dilation,3,2
0XE826F3A93E97AB4.avi,0,1475,1137,338,29.7273526824978,morphological_dilation,3,2
0XE826F3A93E97AB4.avi,14,919,639,280,43.81846635367762,morphological_dilation,3,2
0XE837871E0ED1EB7.avi,54,1950,1534,416,27.11864406779661,morphological_dilation,3,2
0XE837871E0ED1EB7.avi,73,1361,1013,348,34.35340572556762,morphological_dilation,3,2
0XE855B147551A51.avi,50,1407,1049,358,34.127740705433744,morphological_dilation,3,2
0XE855B147551A51.avi,77,1077,777,300,38.61003861003861,morphological_dilation,3,2
0XE871BC36704A97B.avi,49,1483,1135,348,30.66079295154185,morphological_dilation,3,2
0XE871BC36704A97B.avi,62,917,641,276,43.05772230889235,morphological_dilation,3,2
0XE88650E3BA9E287.avi,18,1035,743,292,39.300134589502015,morphological_dilation,3,2
0XE88650E3BA9E287.avi,38,669,433,236,54.50346420323326,morphological_dilation,3,2
0XE8894DCC98CCF57.avi,52,1461,1113,348,31.266846361185983,morphological_dilation,3,2
0XE8894DCC98CCF57.avi,73,874,606,268,44.224422442244226,morphological_dilation,3,2
0XE8B85E5538EF26A.avi,147,2024,1624,400,24.63054187192118,morphological_dilation,3,2
0XE8B85E5538EF26A.avi,161,1327,991,336,33.90514631685166,morphological_dilation,3,2
0XE8BB14C66E3BAC9.avi,81,3139,2635,504,19.127134724857687,morphological_dilation,3,2
0XE8BB14C66E3BAC9.avi,108,1876,1469,407,27.705922396187884,morphological_dilation,3,2
0XE8CF3F4838C0ACF.avi,2,1764,1388,376,27.089337175792505,morphological_dilation,3,2
0XE8CF3F4838C0ACF.avi,14,1270,932,338,36.26609442060086,morphological_dilation,3,2
0XE8DC347D390EE90.avi,199,1909,1501,408,27.181878747501663,morphological_dilation,3,2
0XE8DC347D390EE90.avi,226,1177,849,328,38.6336866902238,morphological_dilation,3,2
0XE8E30696E3AF198.avi,46,1157,853,304,35.63892145369285,morphological_dilation,3,2
0XE8E30696E3AF198.avi,73,767,531,236,44.44444444444444,morphological_dilation,3,2
0XE92064595CE5305.avi,91,2048,1648,400,24.271844660194176,morphological_dilation,3,2
0XE92064595CE5305.avi,105,1313,985,328,33.2994923857868,morphological_dilation,3,2
0XE9217FEF2BCB4B1.avi,32,1833,1425,408,28.631578947368418,morphological_dilation,3,2
0XE9217FEF2BCB4B1.avi,44,1167,827,340,41.112454655380894,morphological_dilation,3,2
0XE92C294577144FC.avi,41,1387,1043,344,32.98178331735379,morphological_dilation,3,2
0XE92C294577144FC.avi,55,683,417,266,63.78896882494005,morphological_dilation,3,2
0XE9315FA2FA71674.avi,58,1347,1019,328,32.18842001962708,morphological_dilation,3,2
0XE9315FA2FA71674.avi,74,734,446,288,64.57399103139014,morphological_dilation,3,2
0XE96D228DFDC48DC.avi,153,1634,1258,376,29.88871224165342,morphological_dilation,3,2
0XE96D228DFDC48DC.avi,167,986,682,304,44.57478005865102,morphological_dilation,3,2
0XE9F5A4FD690EDB3.avi,62,2957,2465,492,19.959432048681542,morphological_dilation,3,2
0XE9F5A4FD690EDB3.avi,81,1775,1403,372,26.514611546685675,morphological_dilation,3,2
0XEA049B76C9061E7.avi,138,2863,2375,488,20.54736842105263,morphological_dilation,3,2
0XEA049B76C9061E7.avi,154,1657,1265,392,30.988142292490117,morphological_dilation,3,2
0XEA4EAF062F7A21D.avi,49,1655,1219,436,35.767022149302704,morphological_dilation,3,2
0XEA4EAF062F7A21D.avi,58,1276,826,450,54.47941888619855,morphological_dilation,3,2
0XEA6482986918798.avi,62,2264,1812,452,24.944812362030905,morphological_dilation,3,2
0XEA6482986918798.avi,86,1357,987,370,37.48733535967578,morphological_dilation,3,2
0XEBBF9242B09E964.avi,41,1547,1195,352,29.456066945606697,morphological_dilation,3,2
0XEBBF9242B09E964.avi,53,875,607,268,44.15156507413509,morphological_dilation,3,2
0XEBD5D5C0824B2A7.avi,81,1491,1135,356,31.365638766519822,morphological_dilation,3,2
0XEBD5D5C0824B2A7.avi,92,1222,894,328,36.68903803131991,morphological_dilation,3,2
0XEC02C6EDC625DCE.avi,266,1206,898,308,34.29844097995546,morphological_dilation,3,2
0XEC02C6EDC625DCE.avi,294,787,527,260,49.33586337760911,morphological_dilation,3,2
0XEC0CCE39DC396D0.avi,47,2102,1690,412,24.378698224852073,morphological_dilation,3,2
0XEC0CCE39DC396D0.avi,63,1377,1037,340,32.78688524590164,morphological_dilation,3,2
0XEC1374DBAE71116.avi,2,1797,1405,392,27.900355871886124,morphological_dilation,3,2
0XEC1374DBAE71116.avi,22,1167,843,324,38.43416370106761,morphological_dilation,3,2
0XEC16D98451B6B28.avi,97,1429,1073,356,33.178005591798694,morphological_dilation,3,2
0XEC16D98451B6B28.avi,115,785,521,264,50.67178502879079,morphological_dilation,3,2
0XEC245307B5E2E0.avi,61,1874,1498,376,25.100133511348467,morphological_dilation,3,2
0XEC245307B5E2E0.avi,81,1280,960,320,33.33333333333333,morphological_dilation,3,2
0XEC2F65B0B9EFB90.avi,45,1372,1032,340,32.945736434108525,morphological_dilation,3,2
0XEC2F65B0B9EFB90.avi,57,928,628,300,47.77070063694268,morphological_dilation,3,2
0XEC340BEA3298AE3.avi,39,1675,1307,368,28.15608263198164,morphological_dilation,3,2
0XEC340BEA3298AE3.avi,56,1103,803,300,37.359900373599004,morphological_dilation,3,2
0XEC49B9CFE28F619.avi,54,1368,1056,312,29.545454545454547,morphological_dilation,3,2
0XEC49B9CFE28F619.avi,64,1212,916,296,32.314410480349345,morphological_dilation,3,2
0XEC5FB56F6EA00B8.avi,130,1290,970,320,32.98969072164948,morphological_dilation,3,2
0XEC5FB56F6EA00B8.avi,145,766,522,244,46.74329501915709,morphological_dilation,3,2
0XECC497B16591984.avi,73,1459,1115,344,30.852017937219735,morphological_dilation,3,2
0XECC497B16591984.avi,94,903,615,288,46.82926829268293,morphological_dilation,3,2
0XECF82DC9301EE77.avi,91,2192,1752,440,25.11415525114155,morphological_dilation,3,2
0XECF82DC9301EE77.avi,111,1330,970,360,37.11340206185567,morphological_dilation,3,2
0XECFAD2E2BAB2AC8.avi,59,1920,1508,412,27.320954907161806,morphological_dilation,3,2
0XECFAD2E2BAB2AC8.avi,72,1211,887,324,36.52762119503946,morphological_dilation,3,2
0XED290312C1390F6.avi,55,3803,3259,544,16.69223688247929,morphological_dilation,3,2
0XED290312C1390F6.avi,72,2290,1850,440,23.783783783783786,morphological_dilation,3,2
0XED603B8278C5196.avi,52,2528,2060,468,22.718446601941746,morphological_dilation,3,2
0XED603B8278C5196.avi,68,1433,1073,360,33.550792171481824,morphological_dilation,3,2
0XED72DAE2E8CAF4F.avi,49,1943,1507,436,28.931652289316524,morphological_dilation,3,2
0XED72DAE2E8CAF4F.avi,67,1520,1115,405,36.32286995515695,morphological_dilation,3,2
0XED8409F1DA4738A.avi,142,1791,1407,384,27.292110874200425,morphological_dilation,3,2
0XED8409F1DA4738A.avi,157,1085,769,316,41.0923276983095,morphological_dilation,3,2
0XEE3CCD3E808313C.avi,119,1150,846,304,35.9338061465721,morphological_dilation,3,2
0XEE3CCD3E808313C.avi,135,780,524,256,48.854961832061065,morphological_dilation,3,2
0XEE433DBDBEAF37A.avi,53,1380,1040,340,32.69230769230769,morphological_dilation,3,2
0XEE433DBDBEAF37A.avi,63,974,662,312,47.129909365558916,morphological_dilation,3,2
0XEE630F143F0414D.avi,84,2120,1692,428,25.295508274231675,morphological_dilation,3,2
0XEE630F143F0414D.avi,102,1437,1073,364,33.92357875116495,morphological_dilation,3,2
0XEE7E2A3E141E060.avi,65,1486,1150,336,29.217391304347828,morphological_dilation,3,2
0XEE7E2A3E141E060.avi,81,1235,923,312,33.80281690140845,morphological_dilation,3,2
0XEF7D675329600E9.avi,139,2344,1896,448,23.628691983122362,morphological_dilation,3,2
0XEF7D675329600E9.avi,156,1872,1464,408,27.86885245901639,morphological_dilation,3,2
0XEF9B5520CAA14AA.avi,49,1371,1031,340,32.97769156159069,morphological_dilation,3,2
0XEF9B5520CAA14AA.avi,66,833,553,280,50.63291139240506,morphological_dilation,3,2
0XEFA2FC13E63C9C5.avi,48,1583,1199,384,32.02668890742285,morphological_dilation,3,2
0XEFA2FC13E63C9C5.avi,67,1060,752,308,40.95744680851064,morphological_dilation,3,2
0XEFDBFDCA164AB94.avi,100,1698,1326,372,28.054298642533936,morphological_dilation,3,2
0XEFDBFDCA164AB94.avi,122,1384,1044,340,32.56704980842912,morphological_dilation,3,2
0XF01B4470872E293.avi,39,2039,1639,400,24.405125076266014,morphological_dilation,3,2
0XF01B4470872E293.avi,61,1490,1146,344,30.017452006980804,morphological_dilation,3,2
0XF046816394513C6.avi,85,2641,2185,456,20.869565217391305,morphological_dilation,3,2
0XF046816394513C6.avi,99,2282,1850,432,23.35135135135135,morphological_dilation,3,2
0XF057D2ED95035D.avi,90,2590,2142,448,20.915032679738562,morphological_dilation,3,2
0XF057D2ED95035D.avi,103,2193,1781,412,23.13307130825379,morphological_dilation,3,2
0XF0645E6834100AC.avi,39,3096,2580,516,20.0,morphological_dilation,3,2
0XF0645E6834100AC.avi,51,2054,1622,432,26.63378545006165,morphological_dilation,3,2
0XF072F7A9791B060.avi,33,2191,1751,440,25.1284980011422,morphological_dilation,3,2
0XF072F7A9791B060.avi,52,1944,1532,412,26.89295039164491,morphological_dilation,3,2
0XF09019B7B99872B.avi,88,1716,1332,384,28.82882882882883,morphological_dilation,3,2
0XF09019B7B99872B.avi,99,847,575,272,47.30434782608695,morphological_dilation,3,2
0XF0B7D7CD42C001E.avi,45,1472,1112,360,32.37410071942446,morphological_dilation,3,2
0XF0B7D7CD42C001E.avi,61,949,657,292,44.44444444444444,morphological_dilation,3,2
0XF0EFF8B5A19D1A1.avi,80,2010,1606,404,25.155666251556664,morphological_dilation,3,2
0XF0EFF8B5A19D1A1.avi,95,1227,887,340,38.331454340473506,morphological_dilation,3,2
0XF145A7B0E6F417E.avi,40,1399,1071,328,30.62558356676004,morphological_dilation,3,2
0XF145A7B0E6F417E.avi,57,889,617,272,44.08427876823339,morphological_dilation,3,2
0XF1640FC4E35A73E.avi,33,818,554,264,47.65342960288809,morphological_dilation,3,2
0XF1640FC4E35A73E.avi,43,556,324,232,71.60493827160494,morphological_dilation,3,2
0XF1D850CC908573F.avi,51,1345,1009,336,33.30029732408325,morphological_dilation,3,2
0XF1D850CC908573F.avi,68,813,545,268,49.174311926605505,morphological_dilation,3,2
0XF2A168FEF29C6E1.avi,5,1476,1148,328,28.57142857142857,morphological_dilation,3,2
0XF2A168FEF29C6E1.avi,18,983,711,272,38.25597749648382,morphological_dilation,3,2
0XF30FA224240FF8C.avi,50,3243,2713,530,19.53556948028013,morphological_dilation,3,2
0XF30FA224240FF8C.avi,73,1941,1509,432,28.628230616302186,morphological_dilation,3,2
0XF342DDFE30C0980.avi,54,2860,2380,480,20.168067226890756,morphological_dilation,3,2
0XF342DDFE30C0980.avi,77,1842,1434,408,28.451882845188287,morphological_dilation,3,2
0XF46CF63A2A1FA90.avi,58,1375,1043,332,31.831255992329815,morphological_dilation,3,2
0XF46CF63A2A1FA90.avi,73,955,662,293,44.259818731117825,morphological_dilation,3,2
0XF4CA716E61ECD9F.avi,77,2424,1956,468,23.92638036809816,morphological_dilation,3,2
0XF4CA716E61ECD9F.avi,95,1385,1013,372,36.72260612043436,morphological_dilation,3,2
0XF526937B72090A6.avi,60,1698,1326,372,28.054298642533936,morphological_dilation,3,2
0XF526937B72090A6.avi,75,1002,710,292,41.12676056338028,morphological_dilation,3,2
0XF53FF3E3EDF0470.avi,52,1690,1307,383,29.303749043611322,morphological_dilation,3,2
0XF53FF3E3EDF0470.avi,69,1095,779,316,40.564826700898585,morphological_dilation,3,2
0XF54528219E80770.avi,51,2283,1827,456,24.958949096880133,morphological_dilation,3,2
0XF54528219E80770.avi,65,1503,1147,356,31.03748910200523,morphological_dilation,3,2
0XF557EF658FD13D0.avi,0,1659,1295,364,28.10810810810811,morphological_dilation,3,2
0XF557EF658FD13D0.avi,20,1102,806,296,36.72456575682382,morphological_dilation,3,2
0XF599A765E273E17.avi,52,1254,946,308,32.55813953488372,morphological_dilation,3,2
0XF599A765E273E17.avi,67,978,706,272,38.52691218130311,morphological_dilation,3,2
0XF5F0335B42366C5.avi,84,1498,1118,380,33.98926654740608,morphological_dilation,3,2
0XF5F0335B42366C5.avi,106,1060,728,332,45.604395604395606,morphological_dilation,3,2
0XF60BBEC9C303C98.avi,98,2145,1701,444,26.102292768959433,morphological_dilation,3,2
0XF60BBEC9C303C98.avi,113,1370,1010,360,35.64356435643564,morphological_dilation,3,2
0XF61C0F562AA75BB.avi,0,1588,1244,344,27.652733118971064,morphological_dilation,3,2
0XF61C0F562AA75BB.avi,18,947,673,274,40.713224368499255,morphological_dilation,3,2
0XF66173D1894718C.avi,94,1277,945,332,35.13227513227513,morphological_dilation,3,2
0XF66173D1894718C.avi,112,851,587,264,44.97444633730835,morphological_dilation,3,2
0XF6661AF354401A5.avi,93,1963,1563,400,25.591810620601407,morphological_dilation,3,2
0XF6661AF354401A5.avi,111,1150,830,320,38.55421686746988,morphological_dilation,3,2
0XF6B57AC096CADD4.avi,3,2425,1961,464,23.661397246302908,morphological_dilation,3,2
0XF6B57AC096CADD4.avi,19,1409,1045,364,34.83253588516747,morphological_dilation,3,2
0XF6D483170E23D92.avi,4,1547,1203,344,28.595178719866997,morphological_dilation,3,2
0XF6D483170E23D92.avi,18,932,652,280,42.944785276073624,morphological_dilation,3,2
0XF70A3F712E03D87.avi,48,1120,816,304,37.254901960784316,morphological_dilation,3,2
0XF70A3F712E03D87.avi,60,719,463,256,55.291576673866096,morphological_dilation,3,2
0XF72EB7E520F126E.avi,45,1467,1091,376,34.46379468377635,morphological_dilation,3,2
0XF72EB7E520F126E.avi,63,849,553,296,53.52622061482821,morphological_dilation,3,2
0XF7373FB1CFBE827.avi,0,1797,1429,368,25.75227431770469,morphological_dilation,3,2
0XF7373FB1CFBE827.avi,17,1177,868,309,35.59907834101382,morphological_dilation,3,2
0XF760A47D31AE457.avi,47,3442,2894,548,18.935729094678646,morphological_dilation,3,2
0XF760A47D31AE457.avi,61,2651,2163,488,22.561257512713823,morphological_dilation,3,2
0XF7AF4EDD2224855.avi,48,2738,2254,484,21.472937000887313,morphological_dilation,3,2
0XF7AF4EDD2224855.avi,62,1571,1207,364,30.15741507870754,morphological_dilation,3,2
0XF829F634971A0F7.avi,48,1698,1314,384,29.22374429223744,morphological_dilation,3,2
0XF829F634971A0F7.avi,66,1010,710,300,42.25352112676056,morphological_dilation,3,2
0XF92E2B74A04BBC4.avi,72,2016,1600,416,26.0,morphological_dilation,3,2
0XF92E2B74A04BBC4.avi,88,1251,915,336,36.721311475409834,morphological_dilation,3,2
0XF96230565BFF1D2.avi,98,3180,2672,508,19.01197604790419,morphological_dilation,3,2
0XF96230565BFF1D2.avi,109,2825,2357,468,19.85574883326262,morphological_dilation,3,2
0XF99271B5D3D9AE3.avi,50,1704,1320,384,29.09090909090909,morphological_dilation,3,2
0XF99271B5D3D9AE3.avi,68,1028,732,296,40.43715846994536,morphological_dilation,3,2
0XF9A94878A64F70B.avi,78,2826,2326,500,21.496130696474637,morphological_dilation,3,2
0XF9A94878A64F70B.avi,100,1675,1272,403,31.68238993710692,morphological_dilation,3,2
0XF9B19F076482852.avi,51,985,700,285,40.714285714285715,morphological_dilation,3,2
0XF9B19F076482852.avi,73,672,421,251,59.61995249406176,morphological_dilation,3,2
0XF9CA1C6A7687A8D.avi,155,1469,1110,359,32.34234234234235,morphological_dilation,3,2
0XF9CA1C6A7687A8D.avi,170,1057,749,308,41.1214953271028,morphological_dilation,3,2
0XF9E698E7CE7FEB1.avi,29,2638,2174,464,21.34314627414903,morphological_dilation,3,2
0XF9E698E7CE7FEB1.avi,43,1866,1474,392,26.594301221166894,morphological_dilation,3,2
0XF9E859F93775E1F.avi,2,2248,1816,432,23.788546255506606,morphological_dilation,3,2
0XF9E859F93775E1F.avi,17,1685,1305,380,29.118773946360154,morphological_dilation,3,2
0XFA2F04D15D5D222.avi,51,1687,1311,376,28.680396643783375,morphological_dilation,3,2
0XFA2F04D15D5D222.avi,64,1094,776,318,40.97938144329897,morphological_dilation,3,2
0XFA9EA2F22209920.avi,76,2146,1715,431,25.131195335276967,morphological_dilation,3,2
0XFA9EA2F22209920.avi,94,1305,937,368,39.27427961579509,morphological_dilation,3,2
0XFAE70080273B8AD.avi,88,1390,1042,348,33.397312859884835,morphological_dilation,3,2
0XFAE70080273B8AD.avi,103,894,593,301,50.75885328836425,morphological_dilation,3,2
0XFB550573BDD938A.avi,54,1172,844,328,38.862559241706165,morphological_dilation,3,2
0XFB550573BDD938A.avi,65,714,458,256,55.895196506550214,morphological_dilation,3,2
0XFBA686750D879E6.avi,54,2415,1963,452,23.025980641874682,morphological_dilation,3,2
0XFBA686750D879E6.avi,72,1339,967,372,38.46949327817994,morphological_dilation,3,2
0XFBAA07C60AF61C2.avi,41,3372,2836,536,18.899858956276447,morphological_dilation,3,2
0XFBAA07C60AF61C2.avi,59,2261,1821,440,24.162548050521693,morphological_dilation,3,2
0XFBC3E8226CE1D25.avi,76,1627,1263,364,28.820269200316705,morphological_dilation,3,2
0XFBC3E8226CE1D25.avi,89,926,642,284,44.23676012461059,morphological_dilation,3,2
0XFBD22BB93EE05C1.avi,39,1878,1466,412,28.10368349249659,morphological_dilation,3,2
0XFBD22BB93EE05C1.avi,56,1216,860,356,41.3953488372093,morphological_dilation,3,2
0XFC193B557F698B6.avi,45,2087,1687,400,23.710729104919974,morphological_dilation,3,2
0XFC193B557F698B6.avi,65,1673,1313,360,27.418126428027417,morphological_dilation,3,2
0XFC2F8325071BDC2.avi,45,1847,1463,384,26.247436773752565,morphological_dilation,3,2
0XFC2F8325071BDC2.avi,59,1114,802,312,38.90274314214464,morphological_dilation,3,2
0XFC6499D603B9E1E.avi,116,1715,1335,380,28.46441947565543,morphological_dilation,3,2
0XFC6499D603B9E1E.avi,136,1244,912,332,36.40350877192983,morphological_dilation,3,2
0XFCB2810C93F7F5D.avi,81,1816,1444,372,25.761772853185594,morphological_dilation,3,2
0XFCB2810C93F7F5D.avi,90,1550,1202,348,28.95174708818636,morphological_dilation,3,2
0XFCC2AF8E23AFBA8.avi,41,1891,1503,388,25.815036593479707,morphological_dilation,3,2
0XFCC2AF8E23AFBA8.avi,57,1165,841,324,38.525564803805,morphological_dilation,3,2
0XFCDC29AA6B8E83B.avi,75,1707,1335,372,27.86516853932584,morphological_dilation,3,2
0XFCDC29AA6B8E83B.avi,89,1568,1216,352,28.947368421052634,morphological_dilation,3,2
0XFCF860A2A9C211.avi,47,1682,1294,388,29.984544049459043,morphological_dilation,3,2
0XFCF860A2A9C211.avi,63,1087,751,336,44.74034620505992,morphological_dilation,3,2
0XFD06AD51C6DA6E5.avi,47,1631,1275,356,27.92156862745098,morphological_dilation,3,2
0XFD06AD51C6DA6E5.avi,62,1088,780,308,39.48717948717949,morphological_dilation,3,2
0XFD513BE6D49349F.avi,43,2126,1678,448,26.6984505363528,morphological_dilation,3,2
0XFD513BE6D49349F.avi,59,1416,1033,383,37.07647628267183,morphological_dilation,3,2
0XFD9464CF9E40B66.avi,106,1665,1317,348,26.42369020501139,morphological_dilation,3,2
0XFD9464CF9E40B66.avi,121,863,599,264,44.073455759599334,morphological_dilation,3,2
0XFDB874C30A9C923.avi,53,1930,1530,400,26.143790849673206,morphological_dilation,3,2
0XFDB874C30A9C923.avi,73,1699,1327,372,28.03315749811605,morphological_dilation,3,2
0XFDC39A88895DE1E.avi,42,1526,1162,364,31.32530120481928,morphological_dilation,3,2
0XFDC39A88895DE1E.avi,63,1023,715,308,43.07692307692308,morphological_dilation,3,2
0XFDFBA5702E94ABF.avi,100,2091,1680,411,24.46428571428571,morphological_dilation,3,2
0XFDFBA5702E94ABF.avi,117,1403,1061,342,32.23374175306315,morphological_dilation,3,2
0XFDFD17B7CCFE5AF.avi,66,1545,1177,368,31.265930331350894,morphological_dilation,3,2
0XFDFD17B7CCFE5AF.avi,85,965,665,300,45.11278195488722,morphological_dilation,3,2
0XFE6E32991136338.avi,31,1644,1284,360,28.037383177570092,morphological_dilation,3,2
0XFE6E32991136338.avi,45,1306,974,332,34.08624229979466,morphological_dilation,3,2
0XFE83FF3D3B13C3A.avi,49,1205,889,316,35.54555680539933,morphological_dilation,3,2
0XFE83FF3D3B13C3A.avi,67,791,508,283,55.70866141732284,morphological_dilation,3,2
0XFEBEEFF93F6FEB9.avi,25,1407,1071,336,31.372549019607842,morphological_dilation,3,2
0XFEBEEFF93F6FEB9.avi,38,1213,893,320,35.83426651735722,morphological_dilation,3,2
